   ,合约,日期,前收盘价,前结算价,开盘价,最高价,最低价,收盘价,结算价,涨跌1,涨跌2,成交量,成交金额,持仓量
1,m1301,20130104,3840,3842,3850,3850,3750,3781,3813,-61,-29,5554,211803280,16164
2,m1301,20130107,3781,3813,3750,3780,3745,3749,3760,-64,-53,3348,125894240,12876
3,m1301,20130108,3749,3760,3738,3791,3738,3774,3757,14,-3,1200,45093460,11812
4,m1301,20130109,3774,3757,3620,3804,3620,3768,3779,11,22,2358,89128900,10634
5,m1301,20130110,3768,3779,3796,3800,3751,3765,3761,-14,-18,1810,68089960,10636
6,m1301,20130111,3765,3761,3720,3750,3700,3750,3745,-11,-16,4364,163467100,7722
7,m1301,20130114,3750,3745,3680,3800,3680,3755,3718,10,-27,538,20005300,7234
8,m1301,20130115,3755,3718,3789,3810,3789,3800,3800,82,82,5320,202192980,1958
9,m1301,20130116,3800,3800,3775,3800,3772,3800,3797,0,-3,1866,70852960,92
10,m1301,20130117,3800,3797,3800,3800,3800,3800,3780,3,-17,92,3496000,0
11,m1303,20130104,3533,3548,3526,3526,3463,3509,3500,-39,-48,198,6930820,1016
12,m1303,20130107,3509,3500,3479,3524,3475,3512,3507,12,7,230,8067480,992
13,m1303,20130108,3512,3507,3520,3530,3506,3530,3518,23,11,156,5489420,966
14,m1303,20130109,3530,3518,3525,3548,3505,3508,3531,-10,13,168,5932660,956
15,m1303,20130110,3508,3531,3520,3527,3501,3504,3518,-27,-13,60,2110860,970
16,m1303,20130111,3504,3518,3499,3518,3499,3510,3505,-8,-13,92,3224820,946
17,m1303,20130114,3510,3505,3560,3572,3552,3572,3560,67,55,164,5839660,892
18,m1303,20130115,3572,3560,3603,3626,3586,3613,3611,53,51,292,10545600,832
19,m1303,20130116,3613,3611,3626,3650,3605,3650,3624,39,13,64,2319400,834
20,m1303,20130117,3650,3624,3679,3680,3619,3622,3649,-2,25,152,5546880,766
21,m1303,20130118,3622,3649,3630,3641,3627,3630,3634,-19,-15,70,2544200,754
22,m1303,20130121,3630,3634,3623,3656,3620,3638,3642,4,8,68,2476960,748
23,m1303,20130122,3638,3642,3643,3670,3643,3670,3651,28,9,22,803420,744
24,m1303,20130123,3670,3651,3667,3682,3664,3679,3672,28,21,54,1983320,732
25,m1303,20130124,3679,3672,3651,3668,3622,3636,3650,-36,-22,76,2774580,736
26,m1303,20130125,3636,3650,3645,3692,3639,3647,3656,-3,6,60,2194160,732
27,m1303,20130128,3647,3656,3690,3719,3680,3719,3695,63,39,112,4138700,708
28,m1303,20130129,3719,3695,3701,3717,3701,3702,3707,7,12,74,2743880,698
29,m1303,20130130,3702,3707,3720,3780,3720,3780,3759,73,52,226,8495860,712
30,m1303,20130131,3780,3759,3815,3827,3791,3810,3809,51,50,86,3276460,718
31,m1303,20130201,3810,3809,3798,3827,3793,3827,3804,18,-5,66,2510920,708
32,m1303,20130204,3827,3804,3836,3839,3835,3835,3838,31,34,88,3378040,630
33,m1303,20130205,3835,3838,3831,3879,3831,3857,3863,19,25,62,2395160,620
34,m1303,20130206,3857,3863,3869,3897,3869,3881,3886,18,23,60,2332000,582
35,m1303,20130207,3881,3886,3920,3923,3853,3875,3875,-11,-11,142,5503200,480
36,m1303,20130208,3875,3875,3920,3920,3862,3862,3894,-13,19,24,934680,460
37,m1303,20130218,3862,3894,3760,3870,3760,3829,3828,-65,-66,48,1837540,440
38,m1303,20130219,3829,3828,3810,3850,3804,3817,3814,-11,-14,136,5187660,378
39,m1303,20130220,3817,3814,3817,3850,3817,3850,3843,36,29,26,999180,366
40,m1303,20130221,3850,3843,3869,3869,3816,3864,3840,21,-3,80,3072540,326
41,m1303,20130222,3864,3840,3846,3940,3846,3939,3901,99,61,72,2809280,278
42,m1303,20130225,3939,3901,3879,3929,3849,3903,3881,2,-20,78,3027620,248
43,m1303,20130226,3903,3881,3923,3944,3873,3873,3900,-8,19,158,6162440,154
44,m1303,20130227,3873,3900,3919,3969,3863,3863,3880,-37,-20,172,6674780,38
45,m1303,20130228,3863,3880,3920,3929,3802,3802,3914,-78,34,38,1487540,6
46,m1303,20130301,3802,3914,3821,4148,3821,3822,3930,-92,16,6,235820,0
47,m1303,20130304,3822,3930,0,0,0,3930,3930,0,0,0,0,0
48,m1303,20130305,3930,3930,0,0,0,3930,3930,0,0,0,0,0
49,m1303,20130306,3930,3930,0,0,0,3930,3930,0,0,0,0,0
50,m1303,20130307,3930,3930,0,0,0,3930,3930,0,0,0,0,0
51,m1303,20130308,3930,3930,0,0,0,3930,3930,0,0,0,0,0
52,m1303,20130311,3930,3930,0,0,0,3930,3930,0,0,0,0,0
53,m1303,20130312,3930,3930,0,0,0,3930,3930,0,0,0,0,0
54,m1303,20130313,3930,3930,0,0,0,3930,3930,0,0,0,0,0
55,m1303,20130314,3930,3930,0,0,0,3930,3930,0,0,0,0,0
56,m1305,20130104,3276,3308,3240,3257,3220,3248,3241,-60,-67,1311346,42510284860,1201284
57,m1305,20130107,3248,3241,3215,3285,3206,3267,3253,26,12,1810436,58894413560,1100488
58,m1305,20130108,3267,3253,3279,3303,3260,3291,3279,38,26,1351690,44329920060,1102430
59,m1305,20130109,3291,3279,3296,3325,3270,3272,3299,-7,20,1728826,57039462140,1120312
60,m1305,20130110,3272,3299,3275,3295,3258,3268,3273,-31,-26,1051954,34440307180,1118922
61,m1305,20130111,3268,3273,3268,3281,3247,3258,3261,-15,-12,1067110,34804280880,1088094
62,m1305,20130114,3258,3261,3302,3365,3302,3361,3338,100,77,1560488,52097626780,1074458
63,m1305,20130115,3361,3338,3386,3396,3354,3368,3377,30,39,1293644,43698168540,1044622
64,m1305,20130116,3368,3377,3376,3410,3358,3405,3384,28,7,1477564,50012584840,1136056
65,m1305,20130117,3405,3384,3425,3433,3374,3381,3408,-3,24,1498464,51068120440,1040358
66,m1305,20130118,3381,3408,3400,3400,3370,3376,3384,-32,-24,1466602,49643456400,1034664
67,m1305,20130121,3376,3384,3373,3412,3373,3388,3392,4,8,1052006,35688288060,1064476
68,m1305,20130122,3388,3392,3390,3432,3386,3426,3407,34,15,1179240,40181227280,1096274
69,m1305,20130123,3426,3407,3435,3440,3419,3432,3429,25,22,852302,29226629520,1050194
70,m1305,20130124,3432,3429,3403,3407,3353,3358,3377,-71,-52,1062920,35904302540,971170
71,m1305,20130125,3358,3377,3383,3395,3375,3383,3386,6,9,717742,24308422820,979808
72,m1305,20130128,3383,3386,3407,3436,3405,3429,3421,43,35,734794,25141158680,1006064
73,m1305,20130129,3429,3421,3425,3430,3411,3419,3419,-2,-2,435944,14909154160,974552
74,m1305,20130130,3419,3419,3415,3492,3415,3484,3464,65,45,1067268,36970566580,1043732
75,m1305,20130131,3484,3464,3520,3532,3498,3508,3514,44,50,896800,31516788940,983882
76,m1305,20130201,3508,3514,3500,3526,3473,3521,3496,7,-18,804300,28121301260,974548
77,m1305,20130204,3521,3496,3531,3531,3501,3503,3512,7,16,508602,17866185560,927216
78,m1305,20130205,3503,3512,3517,3537,3503,3512,3518,0,6,537878,18924639840,898308
79,m1305,20130206,3512,3518,3526,3543,3518,3532,3530,14,12,519326,18337050640,894070
80,m1305,20130207,3532,3530,3531,3533,3503,3519,3513,-11,-17,324298,11395402940,827840
81,m1305,20130208,3519,3513,3527,3574,3527,3553,3552,40,39,486200,17270434680,774042
82,m1305,20130218,3553,3552,3450,3502,3438,3493,3480,-59,-72,374670,13040151260,754188
83,m1305,20130219,3493,3480,3495,3523,3495,3520,3513,40,33,385012,13529117660,807658
84,m1305,20130220,3520,3513,3552,3594,3550,3589,3576,76,63,651286,23296339320,861510
85,m1305,20130221,3589,3576,3580,3643,3553,3615,3592,39,16,1182820,42496401780,889792
86,m1305,20130222,3615,3592,3625,3735,3613,3696,3684,104,92,1612966,59427339220,860092
87,m1305,20130225,3696,3684,3650,3666,3557,3639,3629,-45,-55,1030124,37389823800,795356
88,m1305,20130226,3639,3629,3621,3678,3571,3573,3615,-56,-14,1168496,42247606280,741750
89,m1305,20130227,3573,3615,3600,3614,3573,3587,3592,-28,-23,550094,19760818880,735292
90,m1305,20130228,3587,3592,3619,3636,3602,3617,3619,25,27,676946,24501515580,731668
91,m1305,20130301,3617,3619,3634,3677,3619,3671,3652,52,33,693918,25343355040,771600
92,m1305,20130304,3671,3652,3661,3683,3650,3659,3664,7,12,542166,19867673960,781096
93,m1305,20130305,3659,3664,3699,3706,3674,3686,3691,22,27,507056,18719373100,768378
94,m1305,20130306,3686,3691,3690,3702,3672,3691,3683,0,-8,345116,12713642580,762388
95,m1305,20130307,3691,3683,3696,3696,3681,3693,3688,10,5,236892,8736981920,771240
96,m1305,20130308,3693,3688,3700,3738,3700,3725,3719,37,31,384544,14302256920,764784
97,m1305,20130311,3725,3719,3730,3755,3725,3730,3741,11,22,487322,18232231380,789708
98,m1305,20130312,3730,3741,3740,3746,3683,3687,3701,-54,-40,626020,23169427820,784576
99,m1305,20130313,3687,3701,3692,3697,3655,3685,3676,-16,-25,464224,17065619640,767918
100,m1305,20130314,3685,3676,3659,3662,3621,3638,3640,-38,-36,449722,16371374400,733276
101,m1305,20130315,3638,3640,3640,3672,3638,3651,3654,11,14,339442,12404882000,715858
102,m1305,20130318,3651,3654,3609,3609,3534,3574,3569,-80,-85,506460,18076118300,679704
103,m1305,20130319,3574,3569,3590,3604,3578,3589,3585,20,16,217504,7799565260,671526
104,m1305,20130320,3589,3585,3580,3664,3577,3662,3638,77,53,599312,21804139460,688626
105,m1305,20130321,3662,3638,3670,3708,3655,3663,3678,25,40,488476,17968640120,651066
106,m1305,20130322,3663,3678,3680,3693,3663,3673,3675,-5,-3,281796,10358251520,642124
107,m1305,20130325,3673,3675,3673,3679,3656,3659,3663,-16,-12,149458,5475724700,625200
108,m1305,20130326,3659,3663,3665,3676,3649,3676,3663,13,0,158984,5824555300,610616
109,m1305,20130327,3676,3663,3690,3708,3676,3696,3689,33,26,176266,6503743840,609180
110,m1305,20130328,3696,3689,3702,3714,3690,3695,3701,6,12,214342,7934464460,592834
111,m1305,20130329,3695,3701,3610,3657,3601,3649,3637,-52,-64,265338,9652098580,567796
112,m1305,20130401,3649,3637,3637,3645,3599,3600,3624,-37,-13,221542,8030379660,509182
113,m1305,20130402,3600,3624,3605,3628,3571,3586,3603,-38,-21,333638,12021349760,446198
114,m1305,20130403,3586,3603,3550,3560,3518,3529,3536,-74,-67,330834,11700440420,364068
115,m1305,20130408,3529,3536,3460,3511,3455,3498,3488,-38,-48,268344,9362166640,305858
116,m1305,20130409,3498,3488,3490,3518,3464,3472,3489,-16,1,220340,7688012460,284920
117,m1305,20130410,3472,3489,3491,3518,3482,3503,3499,14,10,202882,7099336480,256028
118,m1305,20130411,3503,3499,3496,3501,3473,3483,3485,-16,-14,136250,4748623220,227374
119,m1305,20130412,3483,3485,3503,3516,3489,3516,3502,31,17,95564,3346809620,193142
120,m1305,20130415,3516,3502,3510,3510,3479,3504,3495,2,-7,101060,3532841340,160900
121,m1305,20130416,3504,3495,3480,3543,3466,3540,3505,45,10,88286,3094554220,130258
122,m1305,20130417,3540,3505,3580,3580,3550,3571,3568,66,63,41994,1498628460,120712
123,m1305,20130418,3571,3568,3570,3600,3542,3591,3583,23,15,32540,1166075020,109162
124,m1305,20130419,3591,3583,3598,3611,3578,3579,3591,-4,8,24668,886011300,101096
125,m1305,20130422,3579,3591,3571,3579,3556,3571,3569,-20,-22,21376,763046160,92204
126,m1305,20130423,3571,3569,3573,3605,3573,3588,3589,19,20,27990,1004711400,77836
127,m1305,20130424,3588,3589,3587,3595,3580,3589,3584,0,-5,28062,1005977820,58332
128,m1305,20130425,3589,3584,3583,3643,3576,3643,3619,59,35,31724,1148183240,47666
129,m1305,20130426,3643,3619,3650,3682,3600,3613,3655,-6,36,30296,1107525200,28528
130,m1305,20130502,3613,3655,3649,3700,3621,3690,3680,35,25,4766,175402220,23870
131,m1305,20130503,3690,3680,3695,3708,3680,3693,3697,13,17,8488,313838660,16326
132,m1305,20130506,3693,3697,3691,3749,3686,3740,3701,43,4,3574,132301700,12826
133,m1305,20130507,3740,3701,3700,3700,3690,3695,3699,-6,-2,1270,46978000,11556
134,m1305,20130508,3695,3699,3720,3720,3718,3718,3718,19,19,156,5801200,11400
135,m1305,20130509,3718,3718,3729,3730,3729,3730,3729,12,11,144,5370160,11256
136,m1305,20130510,3730,3729,3700,3778,3700,3740,3735,11,6,320,11954260,11056
137,m1305,20130513,3740,3735,3849,3849,3681,3697,3716,-38,-19,1060,39394680,10112
138,m1305,20130514,3697,3716,3750,3780,3750,3780,3763,64,47,4232,159263600,8012
139,m1305,20130515,3780,3763,3780,3800,3750,3800,3709,37,-54,630,23713000,0
140,m1307,20130104,3263,3295,3207,3274,3207,3229,3230,-66,-65,52,1680080,422
141,m1307,20130107,3229,3230,3214,3269,3186,3249,3235,19,5,128,4141540,448
142,m1307,20130108,3249,3235,3263,3280,3250,3268,3259,33,24,178,5801060,446
143,m1307,20130109,3268,3259,3278,3299,3250,3250,3278,-9,19,84,2754080,448
144,m1307,20130110,3250,3278,3270,3276,3243,3245,3257,-33,-21,96,3127200,452
145,m1307,20130111,3245,3257,3243,3263,3232,3255,3252,-2,-5,280,9108260,504
146,m1307,20130114,3255,3252,3269,3333,3269,3333,3308,81,56,104,3440380,470
147,m1307,20130115,3333,3308,3348,3375,3314,3328,3339,20,31,158,5276900,512
148,m1307,20130116,3328,3339,3325,3328,3305,3328,3318,-11,-21,688,22832920,518
149,m1307,20130117,3328,3318,3402,3402,3303,3303,3360,-15,42,400,13441840,520
150,m1307,20130118,3303,3360,3253,3323,3253,3322,3309,-38,-51,118,3904980,516
151,m1307,20130121,3322,3309,3316,3362,3316,3362,3332,53,23,140,4665680,530
152,m1307,20130122,3362,3332,3362,3362,3350,3359,3358,27,26,50,1679280,510
153,m1307,20130123,3359,3358,3355,3363,3352,3353,3356,-5,-2,54,1812300,490
154,m1307,20130124,3353,3356,3334,3376,3295,3295,3318,-61,-38,90,2986700,524
155,m1307,20130125,3295,3318,3311,3313,3300,3308,3306,-10,-12,94,3108560,496
156,m1307,20130128,3308,3306,3326,3340,3313,3329,3326,23,20,78,2594400,506
157,m1307,20130129,3329,3326,3326,3330,3326,3326,3326,0,0,38,1264100,488
158,m1307,20130130,3326,3326,3343,3382,3341,3375,3359,49,33,102,3426760,488
159,m1307,20130131,3375,3359,3370,3411,3370,3393,3396,34,37,148,5027180,494
160,m1307,20130201,3393,3396,3382,3418,3374,3409,3389,13,-7,42,1423540,490
161,m1307,20130204,3409,3389,3413,3417,3403,3417,3409,28,20,42,1432160,494
162,m1307,20130205,3417,3409,3420,3423,3403,3403,3413,-6,4,82,2799120,490
163,m1307,20130206,3403,3413,3413,3417,3407,3413,3411,0,-2,16,545860,496
164,m1307,20130207,3413,3411,3390,3390,3319,3390,3376,-21,-35,46,1553320,482
165,m1307,20130208,3390,3376,3371,3405,3350,3388,3390,12,14,68,2305620,464
166,m1307,20130218,3388,3390,3300,3361,3300,3326,3327,-64,-63,66,2196060,458
167,m1307,20130219,3326,3327,3335,3350,3335,3343,3345,16,18,34,1137540,468
168,m1307,20130220,3343,3345,3380,3409,3380,3409,3393,64,48,216,7329720,536
169,m1307,20130221,3409,3393,3408,3411,3383,3402,3392,9,-1,246,8346700,590
170,m1307,20130222,3402,3392,3422,3527,3420,3494,3495,102,103,342,11954540,608
171,m1307,20130225,3494,3495,3457,3457,3367,3437,3411,-58,-84,262,8937700,662
172,m1307,20130226,3437,3411,3458,3474,3400,3400,3433,-11,22,260,8928040,628
173,m1307,20130227,3400,3433,3428,3428,3400,3418,3412,-15,-21,106,3616820,580
174,m1307,20130228,3418,3412,3437,3438,3423,3423,3434,11,22,70,2404140,578
175,m1307,20130301,3423,3434,3435,3467,3428,3467,3450,33,16,128,4416400,574
176,m1307,20130304,3467,3450,3470,3479,3458,3458,3468,8,18,66,2289340,594
177,m1307,20130305,3458,3468,3510,3531,3497,3514,3518,46,50,492,17312840,340
178,m1307,20130306,3514,3518,3492,3518,3492,3516,3504,-2,-14,26,911280,342
179,m1307,20130307,3516,3504,3515,3520,3505,3515,3512,11,8,38,1334820,324
180,m1307,20130308,3515,3512,3516,3557,3516,3541,3529,29,17,134,4729660,346
181,m1307,20130311,3541,3529,3541,3569,3541,3556,3556,27,27,236,8393740,420
182,m1307,20130312,3556,3556,3550,3550,3521,3522,3532,-34,-24,262,9254440,458
183,m1307,20130313,3522,3532,3518,3538,3497,3520,3512,-12,-20,206,7236540,486
184,m1307,20130314,3520,3512,3492,3493,3439,3462,3463,-50,-49,232,8035120,552
185,m1307,20130315,3462,3463,3492,3515,3480,3491,3494,28,31,328,11462080,668
186,m1307,20130318,3491,3494,3444,3448,3411,3434,3435,-60,-59,282,9689460,660
187,m1307,20130319,3434,3435,3447,3447,3432,3439,3440,4,5,66,2270940,660
188,m1307,20130320,3439,3440,3480,3489,3437,3470,3466,30,26,114,3951760,684
189,m1307,20130321,3470,3466,3498,3524,3485,3492,3504,26,38,120,4205020,684
190,m1307,20130322,3492,3504,3507,3513,3502,3505,3506,1,2,130,4558580,702
191,m1307,20130325,3505,3506,3491,3497,3487,3487,3492,-19,-14,62,2165280,694
192,m1307,20130326,3487,3492,3493,3503,3492,3501,3498,9,6,86,3008720,730
193,m1307,20130327,3501,3498,3522,3527,3515,3527,3519,29,21,64,2252560,762
194,m1307,20130328,3527,3519,3541,3552,3532,3532,3542,13,23,122,4321700,790
195,m1307,20130329,3532,3542,3459,3495,3454,3490,3483,-52,-59,124,4318980,818
196,m1307,20130401,3490,3483,3490,3490,3473,3473,3482,-10,-1,106,3690920,836
197,m1307,20130402,3473,3482,3493,3494,3460,3479,3481,-3,-1,72,2506780,840
198,m1307,20130403,3479,3481,3479,3479,3421,3422,3442,-59,-39,314,10809000,738
199,m1307,20130408,3422,3442,3378,3381,3333,3367,3364,-75,-78,220,7401640,752
200,m1307,20130409,3367,3364,3375,3395,3359,3359,3385,-5,21,88,2979440,752
201,m1307,20130410,3359,3385,3360,3390,3360,3385,3377,0,-8,28,945680,752
202,m1307,20130411,3385,3377,3364,3366,3348,3348,3353,-29,-24,128,4292480,754
203,m1307,20130412,3348,3353,3385,3385,3363,3383,3377,30,24,76,2567200,750
204,m1307,20130415,3383,3377,3348,3369,3346,3367,3356,-10,-21,72,2416680,756
205,m1307,20130416,3367,3356,3330,3383,3322,3383,3357,27,1,156,5237860,768
206,m1307,20130417,3383,3357,3395,3423,3370,3380,3394,23,37,104,3530140,770
207,m1307,20130418,3380,3394,3380,3420,3380,3418,3415,24,21,62,2117380,764
208,m1307,20130419,3418,3415,3411,3439,3411,3413,3431,-2,16,88,3019720,768
209,m1307,20130422,3413,3431,3389,3416,3368,3371,3375,-60,-56,472,15933060,1076
210,m1307,20130423,3371,3375,3348,3369,3345,3365,3362,-10,-13,434,14593260,1342
211,m1307,20130424,3365,3362,3346,3360,3310,3324,3325,-38,-37,612,20353420,1634
212,m1307,20130425,3324,3325,3325,3357,3314,3357,3339,32,14,184,6144820,1706
213,m1307,20130426,3357,3339,3390,3390,3372,3372,3378,33,39,66,2230020,1710
214,m1307,20130502,3372,3378,3399,3546,3375,3485,3439,107,61,690,23733300,1956
215,m1307,20130503,3485,3439,3469,3489,3468,3471,3477,32,38,1440,50069320,3094
216,m1307,20130506,3471,3477,3476,3479,3461,3466,3472,-11,-5,290,10070320,3138
217,m1307,20130507,3466,3472,3460,3463,3443,3452,3449,-20,-23,134,4621680,3204
218,m1307,20130508,3452,3449,3466,3486,3466,3476,3474,27,25,258,8964760,3226
219,m1307,20130509,3476,3474,3478,3493,3466,3480,3480,6,6,750,26102080,3642
220,m1307,20130510,3480,3480,3495,3496,3477,3489,3488,9,8,214,7465100,3666
221,m1307,20130513,3489,3488,3475,3493,3461,3466,3476,-22,-12,178,6188400,3620
222,m1307,20130514,3466,3476,3524,3524,3475,3484,3487,8,11,406,14157400,3644
223,m1307,20130515,3484,3487,3490,3490,3465,3475,3478,-12,-9,172,5983240,3600
224,m1307,20130516,3475,3478,3470,3520,3435,3479,3479,1,1,310,10787200,3606
225,m1307,20130517,3479,3479,3493,3495,3476,3480,3485,1,6,418,14569240,3566
226,m1307,20130520,3480,3485,3495,3507,3490,3503,3496,18,11,590,20630300,3290
227,m1307,20130521,3503,3496,3501,3535,3501,3521,3518,25,22,470,16535760,3272
228,m1307,20130522,3521,3518,3519,3526,3510,3510,3517,-8,-1,1472,51772220,2534
229,m1307,20130523,3510,3517,3543,3543,3518,3525,3527,8,10,844,29771160,2244
230,m1307,20130524,3525,3527,3516,3537,3516,3537,3529,10,2,274,9669600,2226
231,m1307,20130527,3537,3529,3529,3537,3526,3532,3531,3,2,178,6285720,2306
232,m1307,20130528,3532,3531,3534,3536,3528,3536,3531,5,0,176,6215360,2326
233,m1307,20130529,3536,3531,3572,3622,3555,3594,3589,63,58,570,20462500,2210
234,m1307,20130530,3594,3589,3599,3599,3588,3595,3594,6,5,264,9489620,2174
235,m1307,20130531,3595,3594,3600,3687,3591,3639,3615,45,21,612,22129060,1846
236,m1307,20130603,3639,3615,3679,3749,3633,3737,3709,122,94,1046,38801740,1376
237,m1307,20130604,3737,3709,3716,3746,3713,3719,3724,10,15,270,10057000,1356
238,m1307,20130605,3719,3724,3729,3777,3729,3773,3762,49,38,414,15575460,1274
239,m1307,20130606,3773,3762,3751,3785,3735,3777,3764,15,2,362,13627360,1134
240,m1307,20130607,3777,3764,3789,3791,3769,3774,3781,10,17,102,3857260,1134
241,m1307,20130613,3774,3781,3798,3800,3773,3784,3789,3,8,174,6593220,1114
242,m1307,20130614,3784,3789,3752,3758,3745,3755,3752,-34,-37,594,22290880,1198
243,m1307,20130617,3755,3752,3730,3783,3718,3767,3759,15,7,438,16468200,896
244,m1307,20130618,3767,3759,3785,3795,3759,3776,3779,17,20,156,5895300,870
245,m1307,20130619,3776,3779,3779,3800,3760,3795,3778,16,-1,168,6347800,782
246,m1307,20130620,3795,3778,3820,3820,3776,3797,3799,19,21,182,6915820,802
247,m1307,20130621,3797,3799,3786,3789,3742,3747,3767,-52,-32,228,8589220,822
248,m1307,20130624,3747,3767,3723,3745,3713,3722,3731,-45,-36,124,4627140,776
249,m1307,20130625,3722,3731,3731,3751,3731,3749,3742,18,11,162,6062400,846
250,m1307,20130626,3749,3742,3741,3749,3673,3688,3707,-54,-35,92,3410440,818
251,m1307,20130627,3688,3707,3717,3717,3621,3639,3647,-68,-60,292,10650980,792
252,m1307,20130628,3639,3647,3600,3619,3588,3590,3599,-57,-48,404,14540220,730
253,m1307,20130701,3590,3599,3498,3558,3498,3550,3547,-49,-52,28,993180,712
254,m1307,20130702,3550,3547,3550,3550,3550,3550,3550,3,3,52,1846000,660
255,m1307,20130703,3550,3550,3612,3618,3612,3618,3617,68,67,130,4702960,530
256,m1307,20130704,3618,3617,3645,3747,3640,3738,3670,121,53,66,2422400,470
257,m1307,20130705,3738,3670,3859,3859,3859,3859,3859,189,189,2,77180,470
258,m1307,20130708,3859,3859,0,0,0,3859,3859,0,0,0,0,470
259,m1307,20130709,3859,3859,3628,3767,3628,3767,3700,-92,-159,82,3034320,408
260,m1307,20130710,3767,3700,0,0,0,3750,3750,50,50,0,0,408
261,m1307,20130711,3750,3750,3922,3922,3800,3800,3861,50,111,4,154440,406
262,m1307,20130712,3800,3861,3810,3810,3810,3810,3739,-51,-122,540,20574000,0
263,m1308,20130104,3261,3281,3444,3444,3209,3228,3231,-53,-50,78,2520360,110
264,m1308,20130107,3228,3231,3180,3266,3180,3236,3239,5,8,64,2073560,112
265,m1308,20130108,3236,3239,3264,3264,3231,3242,3238,3,-1,26,842120,106
266,m1308,20130109,3242,3238,3264,3267,3240,3242,3257,4,19,62,2019580,128
267,m1308,20130110,3242,3257,3232,3232,3232,3232,3232,-25,-25,2,64640,130
268,m1308,20130111,3232,3232,3221,3222,3217,3219,3220,-13,-12,46,1481580,114
269,m1308,20130114,3219,3220,3274,3285,3263,3285,3270,65,50,28,915840,98
270,m1308,20130115,3285,3270,3346,3346,3290,3302,3321,32,51,40,1328560,102
271,m1308,20130116,3302,3321,3333,3333,3300,3309,3308,-12,-13,168,5557980,126
272,m1308,20130117,3309,3308,3317,3325,3290,3295,3311,-13,3,22,728480,132
273,m1308,20130118,3295,3311,3300,3301,3290,3301,3295,-10,-16,14,461380,130
274,m1308,20130121,3301,3295,3301,3319,3283,3314,3304,19,9,50,1652280,120
275,m1308,20130122,3314,3304,3313,3320,3313,3317,3316,13,12,20,663220,114
276,m1308,20130123,3317,3316,3327,3333,3327,3330,3330,14,14,40,1332320,132
277,m1308,20130124,3330,3330,3288,3289,3251,3251,3275,-79,-55,18,589560,128
278,m1308,20130125,3251,3275,3271,3287,3271,3281,3278,6,3,82,2688620,122
279,m1308,20130128,3281,3278,3299,3311,3299,3309,3303,31,25,20,660760,132
280,m1308,20130129,3309,3303,3303,3331,3303,3313,3315,10,12,48,1591260,128
281,m1308,20130130,3313,3315,3262,3363,3262,3363,3326,48,11,26,865000,126
282,m1308,20130131,3363,3326,3367,3391,3367,3388,3381,62,55,38,1284980,136
283,m1308,20130201,3388,3381,3370,3397,3360,3397,3378,16,-3,22,743160,128
284,m1308,20130204,3397,3378,3413,3417,3394,3400,3406,22,28,34,1158220,134
285,m1308,20130205,3400,3406,3401,3421,3389,3403,3404,-3,-2,40,1361680,130
286,m1308,20130206,3403,3404,3409,3416,3402,3402,3406,-2,2,30,1021880,138
287,m1308,20130207,3402,3406,3388,3400,3379,3385,3386,-21,-20,14,474160,132
288,m1308,20130208,3385,3386,3402,3410,3395,3400,3404,14,18,28,953360,120
289,m1308,20130218,3400,3404,3362,3362,3296,3327,3330,-77,-74,52,1732060,128
290,m1308,20130219,3327,3330,3342,3351,3334,3351,3341,21,11,12,401000,128
291,m1308,20130220,3351,3341,3370,3393,3370,3381,3379,40,38,24,810980,128
292,m1308,20130221,3381,3379,3364,3386,3349,3386,3360,7,-19,108,3629520,142
293,m1308,20130222,3386,3360,3399,3494,3398,3494,3458,134,98,58,2005720,146
294,m1308,20130225,3494,3458,3400,3439,3334,3363,3391,-95,-67,104,3526840,126
295,m1308,20130226,3363,3391,3405,3425,3350,3355,3389,-36,-2,92,3118620,130
296,m1308,20130227,3355,3389,3370,3385,3254,3382,3336,-7,-53,616,20555400,114
297,m1308,20130228,3382,3336,3393,3404,3376,3376,3391,40,55,110,3730800,110
298,m1308,20130301,3376,3391,3392,3435,3392,3426,3419,35,28,206,7044340,126
299,m1308,20130304,3426,3419,3426,3431,3408,3408,3419,-11,0,64,2188240,140
300,m1308,20130305,3408,3419,3434,3465,3434,3454,3454,35,35,210,7253400,228
301,m1308,20130306,3454,3454,3451,3460,3436,3448,3446,-6,-8,58,1999040,246
302,m1308,20130307,3448,3446,3426,3459,3426,3446,3450,0,4,48,1656400,246
303,m1308,20130308,3446,3450,3460,3491,3460,3485,3477,35,27,244,8484140,310
304,m1308,20130311,3485,3477,3485,3527,3485,3491,3503,14,26,226,7916780,434
305,m1308,20130312,3491,3503,3486,3486,3457,3457,3469,-46,-34,186,6453960,508
306,m1308,20130313,3457,3469,3544,3544,3439,3465,3456,-4,-13,136,4701480,506
307,m1308,20130314,3465,3456,3408,3428,3396,3406,3410,-50,-46,210,7161360,522
308,m1308,20130315,3406,3410,3380,3430,3380,3411,3414,1,4,182,6213980,544
309,m1308,20130318,3411,3414,3336,3359,3330,3341,3343,-73,-71,174,5818540,546
310,m1308,20130319,3341,3343,3320,3352,3320,3349,3344,6,1,98,3277300,554
311,m1308,20130320,3349,3344,3359,3380,3336,3372,3371,28,27,76,2562260,584
312,m1308,20130321,3372,3371,3407,3415,3389,3389,3399,18,28,142,4827900,578
313,m1308,20130322,3389,3399,3419,3419,3393,3403,3406,4,7,144,4905160,584
314,m1308,20130325,3403,3406,3372,3398,3372,3393,3388,-13,-18,136,4609000,588
315,m1308,20130326,3393,3388,3406,3406,3395,3403,3398,15,10,42,1427480,578
316,m1308,20130327,3403,3398,3400,3422,3400,3422,3412,24,14,24,818920,576
317,m1308,20130328,3422,3412,3411,3443,3411,3430,3433,18,21,94,3227540,578
318,m1308,20130329,3430,3433,3361,3394,3356,3392,3384,-41,-49,110,3722440,584
319,m1308,20130401,3392,3384,3356,3396,3356,3378,3385,-6,1,92,3114480,576
320,m1308,20130402,3378,3385,3385,3407,3371,3383,3387,-2,2,86,2912820,590
321,m1308,20130403,3383,3387,3362,3362,3314,3326,3330,-61,-57,154,5128840,598
322,m1308,20130408,3326,3330,3237,3289,3237,3266,3268,-64,-62,166,5426480,596
323,m1308,20130409,3266,3268,3255,3292,3251,3253,3269,-15,1,140,4576980,574
324,m1308,20130410,3253,3269,3265,3285,3226,3277,3274,8,5,96,3143600,580
325,m1308,20130411,3277,3274,3255,3268,3241,3248,3257,-26,-17,106,3452620,576
326,m1308,20130412,3248,3257,3250,3281,3250,3279,3270,22,13,88,2877920,564
327,m1308,20130415,3279,3270,3279,3290,3254,3266,3270,-4,0,108,3532340,558
328,m1308,20130416,3266,3270,3227,3298,3227,3289,3271,19,1,136,4448980,578
329,m1308,20130417,3289,3271,3300,3307,3290,3294,3300,23,29,90,2970280,562
330,m1308,20130418,3294,3300,3292,3335,3292,3335,3319,35,19,72,2389920,556
331,m1308,20130419,3335,3319,3335,3353,3333,3336,3343,17,24,56,1872620,550
332,m1308,20130422,3336,3343,3329,3329,3291,3291,3307,-52,-36,350,11577680,550
333,m1308,20130423,3291,3307,3297,3307,3295,3306,3300,-1,-7,80,2640700,550
334,m1308,20130424,3306,3300,3307,3307,3255,3263,3273,-37,-27,114,3731720,552
335,m1308,20130425,3263,3273,3295,3296,3279,3296,3280,23,7,38,1246680,558
336,m1308,20130426,3296,3280,3297,3315,3272,3291,3296,11,16,82,2703480,554
337,m1308,20130502,3291,3296,3313,3347,3312,3340,3324,44,28,92,3058540,584
338,m1308,20130503,3340,3324,3346,3357,3334,3347,3344,23,20,178,5953760,556
339,m1308,20130506,3347,3344,3340,3356,3333,3353,3346,9,2,34,1137800,560
340,m1308,20130507,3353,3346,3334,3344,3334,3338,3339,-8,-7,24,801560,564
341,m1308,20130508,3338,3339,3364,3392,3349,3391,3377,52,38,42,1418340,580
342,m1308,20130509,3391,3377,3377,3386,3377,3384,3381,7,4,8,270480,580
343,m1308,20130510,3384,3381,3381,3403,3380,3395,3385,14,4,28,947880,580
344,m1308,20130513,3395,3385,3360,3377,3360,3361,3365,-24,-20,16,538460,576
345,m1308,20130514,3361,3365,3389,3389,3382,3382,3384,17,19,64,2166240,556
346,m1308,20130515,3382,3384,3393,3393,3368,3375,3380,-9,-4,68,2298580,556
347,m1308,20130516,3375,3380,3371,3385,3365,3381,3376,1,-4,24,810280,550
348,m1308,20130517,3381,3376,3393,3407,3393,3393,3399,17,23,30,1019960,558
349,m1308,20130520,3393,3399,0,0,0,3401,3401,2,2,0,0,558
350,m1308,20130521,3401,3401,3414,3417,3405,3407,3411,6,10,38,1296540,560
351,m1308,20130522,3407,3411,3410,3427,3408,3412,3415,1,4,144,4918140,550
352,m1308,20130523,3412,3415,3433,3446,3433,3446,3441,31,26,78,2684580,546
353,m1308,20130524,3446,3441,3435,3443,3416,3416,3432,-25,-9,34,1166960,552
354,m1308,20130527,3416,3432,3421,3429,3418,3418,3422,-14,-10,36,1232160,558
355,m1308,20130528,3418,3422,0,0,0,3426,3426,4,4,0,0,558
356,m1308,20130529,3426,3426,3453,3538,3453,3501,3494,75,68,48,1677480,554
357,m1308,20130530,3501,3494,3492,3508,3489,3508,3493,14,-1,26,908380,558
358,m1308,20130531,3508,3493,3507,3523,3496,3523,3513,30,20,34,1194440,560
359,m1308,20130603,3523,3513,3523,3639,3523,3639,3608,126,95,520,18765180,574
360,m1308,20130604,3639,3608,3617,3634,3605,3614,3617,6,9,50,1808940,578
361,m1308,20130605,3614,3617,3614,3675,3614,3665,3655,48,38,88,3216940,556
362,m1308,20130606,3665,3655,3660,3662,3654,3654,3656,-1,1,16,585060,558
363,m1308,20130607,3654,3656,3675,3710,3628,3635,3644,-21,-12,80,2915240,544
364,m1308,20130613,3635,3644,3601,3665,3601,3640,3640,-4,-4,192,6990360,484
365,m1308,20130614,3640,3640,3611,3642,3611,3641,3628,1,-12,76,2757280,504
366,m1308,20130617,3641,3628,3577,3647,3577,3633,3629,5,1,216,7838760,564
367,m1308,20130618,3633,3629,3629,3679,3629,3652,3665,23,36,196,7183500,616
368,m1308,20130619,3652,3665,3631,3662,3621,3658,3653,-7,-12,66,2411000,638
369,m1308,20130620,3658,3653,3653,3674,3653,3660,3668,7,15,92,3374600,652
370,m1308,20130621,3660,3668,3666,3707,3611,3645,3655,-23,-13,224,8188160,662
371,m1308,20130624,3645,3655,3617,3653,3616,3619,3633,-36,-22,172,6249520,618
372,m1308,20130625,3619,3633,3697,3697,3637,3650,3658,17,25,86,3146260,620
373,m1308,20130626,3650,3658,3636,3669,3636,3656,3657,-2,-1,104,3804020,626
374,m1308,20130627,3656,3657,3676,3681,3637,3653,3650,-4,-7,208,7592500,624
375,m1308,20130628,3653,3650,3655,3658,3623,3625,3632,-25,-18,304,11043660,606
376,m1308,20130701,3625,3632,3599,3620,3584,3604,3602,-28,-30,82,2953700,582
377,m1308,20130702,3604,3602,3592,3609,3584,3604,3603,2,1,160,5765540,556
378,m1308,20130703,3604,3603,3618,3618,3597,3614,3610,11,7,66,2383080,530
379,m1308,20130704,3614,3610,3610,3621,3605,3615,3611,5,1,62,2239280,522
380,m1308,20130705,3615,3611,3625,3652,3625,3640,3628,29,17,74,2684840,520
381,m1308,20130708,3640,3628,3618,3651,3618,3626,3625,-2,-3,74,2682780,518
382,m1308,20130709,3626,3625,3626,3677,3626,3677,3667,52,42,166,6088420,412
383,m1308,20130710,3677,3667,3680,3680,3670,3672,3678,5,11,48,1765840,376
384,m1308,20130711,3672,3678,3686,3699,3686,3699,3696,21,18,12,443620,366
385,m1308,20130712,3699,3696,3720,3741,3700,3701,3718,5,22,232,8626480,250
386,m1308,20130715,3701,3718,3670,3675,3670,3670,3671,-48,-47,12,440540,248
387,m1308,20130716,3670,3671,3758,3762,3660,3762,3747,91,76,272,10192840,312
388,m1308,20130717,3762,3747,3795,3795,3761,3781,3778,34,31,20,755780,318
389,m1308,20130718,3781,3778,3779,3825,3771,3822,3802,44,24,50,1901260,298
390,m1308,20130719,3822,3802,3821,3860,3784,3811,3822,9,20,60,2293680,266
391,m1308,20130722,3811,3822,3796,3796,3777,3788,3785,-34,-37,22,832740,252
392,m1308,20130723,3788,3785,0,0,0,3825,3825,40,40,0,0,252
393,m1308,20130724,3825,3825,3791,3859,3791,3859,3825,34,0,4,153000,248
394,m1308,20130725,3859,3825,3767,3784,3767,3784,3778,-41,-47,6,226700,246
395,m1308,20130726,3784,3778,3700,3728,3640,3703,3673,-75,-105,226,8302360,108
396,m1308,20130729,3703,3673,3780,3780,3747,3747,3758,74,85,44,1653920,86
397,m1308,20130730,3747,3758,3829,3830,3780,3780,3809,22,51,10,380960,80
398,m1308,20130731,3780,3809,3820,3850,3820,3820,3842,11,33,100,3842180,44
399,m1308,20130801,3820,3842,0,0,0,3840,3840,-2,-2,0,0,44
400,m1308,20130802,3840,3840,0,0,0,3840,3840,0,0,0,0,44
401,m1308,20130805,3840,3840,3700,3700,3700,3700,3700,-140,-140,36,1332000,8
402,m1308,20130806,3700,3700,3700,3700,3700,3700,3700,0,0,6,222000,2
403,m1308,20130807,3700,3700,0,0,0,3700,3700,0,0,0,0,2
404,m1308,20130808,3700,3700,0,0,0,3700,3700,0,0,0,0,2
405,m1308,20130809,3700,3700,0,0,0,3700,3700,0,0,0,0,2
406,m1308,20130812,3700,3700,0,0,0,3700,3700,0,0,0,0,2
407,m1308,20130813,3700,3700,0,0,0,3700,3700,0,0,0,0,2
408,m1308,20130814,3700,3700,0,0,0,3700,3700,0,0,0,0,0
409,m1309,20130104,3226,3261,3194,3206,3164,3197,3187,-64,-74,451186,14379739520,432736
410,m1309,20130107,3197,3187,3156,3245,3155,3202,3203,15,16,931922,29850680760,576354
411,m1309,20130108,3202,3203,3217,3222,3188,3214,3204,11,1,549590,17610497400,549966
412,m1309,20130109,3214,3204,3210,3227,3184,3185,3209,-19,5,465396,14938576800,586002
413,m1309,20130110,3185,3209,3195,3205,3169,3178,3188,-31,-21,449206,14322367000,596950
414,m1309,20130111,3178,3188,3177,3186,3163,3168,3174,-20,-14,384292,12200178980,591052
415,m1309,20130114,3168,3174,3205,3249,3205,3247,3225,73,51,584112,18841806440,584906
416,m1309,20130115,3247,3225,3278,3280,3231,3235,3253,10,28,471292,15332940320,610980
417,m1309,20130116,3235,3253,3245,3261,3230,3259,3244,6,-9,439210,14252088460,600874
418,m1309,20130117,3259,3244,3279,3280,3232,3236,3257,-8,13,476032,15507380300,598316
419,m1309,20130118,3236,3257,3243,3267,3235,3259,3250,2,-7,532932,17323962560,607826
420,m1309,20130121,3259,3250,3258,3300,3255,3288,3279,38,29,738222,24212384880,702020
421,m1309,20130122,3288,3279,3296,3303,3279,3297,3290,18,11,558708,18382744080,700308
422,m1309,20130123,3297,3290,3300,3309,3288,3291,3296,1,6,398902,13151634460,695302
423,m1309,20130124,3291,3296,3270,3270,3206,3217,3232,-79,-64,807512,26100895160,754018
424,m1309,20130125,3217,3232,3245,3253,3232,3234,3244,2,12,448596,14555744240,711582
425,m1309,20130128,3234,3244,3258,3276,3246,3276,3260,32,16,423444,13807429880,707534
426,m1309,20130129,3276,3260,3266,3272,3250,3261,3260,1,0,448672,14629452820,732196
427,m1309,20130130,3261,3260,3261,3331,3260,3324,3297,64,37,824934,27202552600,778050
428,m1309,20130131,3324,3297,3350,3370,3341,3354,3355,57,58,973150,32652251520,831646
429,m1309,20130201,3354,3355,3349,3389,3325,3383,3354,28,-1,1203380,40369977420,910662
430,m1309,20130204,3383,3354,3392,3400,3368,3372,3382,18,28,1160924,39273488260,885958
431,m1309,20130205,3372,3382,3382,3406,3369,3371,3383,-11,1,1247134,42198163420,861594
432,m1309,20130206,3371,3383,3385,3394,3372,3376,3384,-7,1,815700,27605608340,820554
433,m1309,20130207,3376,3384,3377,3378,3349,3357,3360,-27,-24,634972,21335273320,812568
434,m1309,20130208,3357,3360,3366,3398,3360,3374,3378,14,18,599632,20258843580,778724
435,m1309,20130218,3374,3378,3270,3295,3236,3286,3277,-92,-101,674566,22106688260,835164
436,m1309,20130219,3286,3277,3290,3314,3290,3307,3304,30,27,932602,30821931120,896256
437,m1309,20130220,3307,3304,3338,3363,3327,3344,3344,40,40,1259694,42125508240,924068
438,m1309,20130221,3344,3344,3335,3357,3307,3351,3330,7,-14,1683078,56061307060,996568
439,m1309,20130222,3351,3330,3359,3463,3356,3452,3418,122,88,3155576,1.07882E+11,1334340
440,m1309,20130225,3452,3418,3401,3411,3290,3360,3358,-58,-60,3839042,1.28952E+11,1185340
441,m1309,20130226,3360,3358,3346,3410,3313,3317,3356,-41,-2,4639790,1.55713E+11,1130848
442,m1309,20130227,3317,3356,3347,3368,3322,3337,3343,-19,-13,2795144,93463155720,1153572
443,m1309,20130228,3337,3343,3364,3377,3336,3349,3358,6,15,2226056,74760417280,1137710
444,m1309,20130301,3349,3358,3358,3401,3352,3388,3377,30,19,3009618,1.01656E+11,1214038
445,m1309,20130304,3388,3377,3373,3392,3358,3365,3376,-12,-1,1920954,64852296940,1135876
446,m1309,20130305,3365,3376,3400,3431,3390,3413,3413,37,37,2839936,96936797400,1240040
447,m1309,20130306,3413,3413,3400,3418,3377,3398,3395,-15,-18,2393520,81268184540,1255170
448,m1309,20130307,3398,3395,3398,3412,3386,3402,3397,7,2,1722716,58536552840,1257368
449,m1309,20130308,3402,3397,3411,3435,3409,3422,3421,25,24,2087168,71422696300,1307800
450,m1309,20130311,3422,3421,3421,3429,3386,3387,3410,-34,-11,2058170,70201296900,1335808
451,m1309,20130312,3387,3410,3404,3405,3340,3343,3363,-67,-47,2685556,90338960080,1394408
452,m1309,20130313,3343,3363,3351,3356,3314,3343,3337,-20,-26,2447658,81693945360,1431964
453,m1309,20130314,3343,3337,3310,3310,3261,3273,3283,-64,-54,2995566,98370096640,1539114
454,m1309,20130315,3273,3283,3290,3314,3276,3288,3290,5,7,2203366,72494019480,1475724
455,m1309,20130318,3288,3290,3233,3236,3177,3202,3204,-88,-86,2283918,73191238060,1564496
456,m1309,20130319,3202,3204,3216,3224,3200,3210,3210,6,6,1302418,41808654280,1465724
457,m1309,20130320,3210,3210,3201,3257,3200,3253,3236,43,26,2141134,69302429560,1519196
458,m1309,20130321,3253,3236,3268,3298,3258,3272,3279,36,43,1741200,57094246020,1399310
459,m1309,20130322,3272,3279,3290,3298,3262,3267,3276,-12,-3,1442772,47274275220,1428132
460,m1309,20130325,3267,3276,3260,3275,3242,3258,3259,-18,-17,1322614,43108196240,1481918
461,m1309,20130326,3258,3259,3265,3282,3258,3275,3270,16,11,1214116,39710054900,1448038
462,m1309,20130327,3275,3270,3286,3296,3274,3291,3283,21,13,1124606,36930794120,1438246
463,m1309,20130328,3291,3283,3305,3312,3281,3285,3296,2,13,1733102,57136163660,1412718
464,m1309,20130329,3285,3296,3188,3233,3180,3229,3215,-67,-81,2116848,68068727600,1506092
465,m1309,20130401,3229,3215,3218,3230,3189,3195,3208,-20,-7,1516670,48664917920,1506912
466,m1309,20130402,3195,3208,3202,3224,3172,3205,3200,-3,-8,1901296,60843106040,1498228
467,m1309,20130403,3205,3200,3178,3178,3123,3130,3138,-70,-62,3072066,96415066100,1803160
468,m1309,20130408,3130,3138,3060,3117,3051,3113,3088,-25,-50,2581546,79743572560,1876026
469,m1309,20130409,3113,3088,3110,3146,3106,3114,3124,26,36,2227414,69600707880,1961982
470,m1309,20130410,3114,3124,3131,3145,3118,3138,3132,14,8,1757420,55052450400,1932160
471,m1309,20130411,3138,3132,3120,3129,3092,3114,3110,-18,-22,2491442,77505780160,2018508
472,m1309,20130412,3114,3110,3128,3158,3121,3157,3137,47,27,2015636,63244000740,1869714
473,m1309,20130415,3157,3137,3135,3144,3105,3133,3119,-4,-18,2317544,72303910880,1950120
474,m1309,20130416,3133,3119,3098,3143,3076,3138,3113,19,-6,2359718,73476188620,1910324
475,m1309,20130417,3138,3113,3150,3171,3139,3167,3156,54,43,1855232,58553131780,1865892
476,m1309,20130418,3167,3156,3155,3206,3141,3196,3179,40,23,2532340,80520838440,1917902
477,m1309,20130419,3196,3179,3193,3227,3184,3186,3208,7,29,2286224,73348798560,1885714
478,m1309,20130422,3186,3208,3172,3180,3140,3143,3163,-65,-45,1673838,52946652860,1835314
479,m1309,20130423,3143,3163,3143,3157,3126,3155,3144,-8,-19,1759494,55331652680,1794166
480,m1309,20130424,3155,3144,3140,3157,3097,3107,3123,-37,-21,2292500,71600771280,1780408
481,m1309,20130425,3107,3123,3099,3150,3093,3149,3124,26,1,1707264,53338112960,1744654
482,m1309,20130426,3149,3124,3180,3194,3153,3172,3173,48,49,1483428,47072498500,1586396
483,m1309,20130502,3172,3173,3161,3214,3156,3212,3190,39,17,1592878,50815641340,1707692
484,m1309,20130503,3212,3190,3205,3222,3190,3193,3205,3,15,1720054,55144534060,1688942
485,m1309,20130506,3193,3205,3193,3215,3175,3206,3198,1,-7,1964374,62820821860,1645906
486,m1309,20130507,3206,3198,3178,3195,3176,3190,3187,-8,-11,947798,30208804540,1638082
487,m1309,20130508,3190,3187,3196,3256,3196,3243,3235,56,48,2036290,65880282480,1740700
488,m1309,20130509,3243,3235,3240,3247,3230,3246,3239,11,4,1053548,34125073740,1693570
489,m1309,20130510,3246,3239,3269,3278,3247,3263,3259,24,20,1322426,43110523180,1593204
490,m1309,20130513,3263,3259,3245,3282,3216,3217,3254,-42,-5,1906218,62028403700,1643470
491,m1309,20130514,3217,3254,3249,3272,3239,3265,3258,11,4,1905386,62093551940,1643648
492,m1309,20130515,3265,3258,3268,3278,3238,3249,3255,-9,-3,1307728,42572509400,1574936
493,m1309,20130516,3249,3255,3246,3269,3223,3249,3248,-6,-7,1350096,43862356040,1552522
494,m1309,20130517,3249,3248,3275,3295,3267,3282,3282,34,34,1308260,42947787520,1532900
495,m1309,20130520,3282,3282,3320,3322,3297,3303,3308,21,26,1077270,35643006860,1439342
496,m1309,20130521,3303,3308,3323,3334,3303,3319,3320,11,12,1200702,39870579540,1464884
497,m1309,20130522,3319,3320,3326,3327,3306,3321,3318,1,-2,912298,30275051460,1494406
498,m1309,20130523,3321,3318,3345,3356,3335,3336,3345,18,27,1331846,44558208160,1484426
499,m1309,20130524,3336,3345,3324,3342,3315,3333,3330,-12,-15,1084594,36119946540,1468752
500,m1309,20130527,3333,3330,3303,3323,3303,3320,3316,-10,-14,711058,23580968760,1465700
501,m1309,20130528,3320,3316,3328,3330,3310,3328,3320,12,4,567304,18837909480,1484298
502,m1309,20130529,3328,3320,3358,3427,3350,3387,3396,67,76,2393114,81291842080,1387368
503,m1309,20130530,3387,3396,3396,3404,3378,3400,3390,4,-6,951108,32248181100,1341050
504,m1309,20130531,3400,3390,3403,3435,3396,3434,3417,44,27,1077488,36820929300,1358140
505,m1309,20130603,3434,3417,3455,3550,3452,3540,3506,123,89,2125374,74526363740,1322154
506,m1309,20130604,3540,3506,3548,3548,3504,3527,3524,21,18,1790312,63105335760,1285696
507,m1309,20130605,3527,3524,3536,3600,3529,3583,3572,59,48,2157862,77094418700,1291216
508,m1309,20130606,3583,3572,3556,3580,3535,3551,3558,-21,-14,1362282,48475752360,1182708
509,m1309,20130607,3551,3558,3565,3587,3510,3527,3542,-31,-16,1258638,44592150820,1076036
510,m1309,20130613,3527,3542,3549,3572,3512,3534,3539,-8,-3,723756,25620223320,1075752
511,m1309,20130614,3534,3539,3505,3534,3495,3533,3514,-6,-25,618228,21724649580,1109768
512,m1309,20130617,3533,3514,3498,3519,3462,3495,3497,-19,-17,961400,33621367260,1085488
513,m1309,20130618,3495,3497,3508,3539,3495,3503,3514,6,17,803920,28253993180,1046854
514,m1309,20130619,3503,3514,3498,3508,3486,3506,3498,-8,-16,482106,16866636000,1035552
515,m1309,20130620,3506,3498,3500,3520,3481,3487,3499,-11,1,446304,15620191260,1004640
516,m1309,20130621,3487,3499,3459,3480,3423,3426,3449,-73,-50,777940,26837889500,894600
517,m1309,20130624,3426,3449,3405,3436,3402,3412,3417,-37,-32,408708,13969133760,854138
518,m1309,20130625,3412,3417,3440,3486,3431,3479,3453,62,36,634840,21923005340,843260
519,m1309,20130626,3479,3453,3480,3498,3460,3481,3477,28,24,627616,21826983120,828186
520,m1309,20130627,3481,3477,3488,3530,3472,3488,3500,11,23,841528,29455331820,823932
521,m1309,20130628,3488,3500,3495,3512,3455,3460,3478,-40,-22,519734,18078746580,784354
522,m1309,20130701,3460,3478,3430,3462,3424,3457,3448,-21,-30,319426,11016731440,766074
523,m1309,20130702,3457,3448,3436,3461,3432,3456,3449,8,1,224610,7747375160,763214
524,m1309,20130703,3456,3449,3456,3483,3452,3479,3472,30,23,361420,12550120320,737854
525,m1309,20130704,3479,3472,3476,3483,3461,3469,3470,-3,-2,188604,6545856540,734596
526,m1309,20130705,3469,3470,3479,3497,3464,3492,3483,22,13,255648,8905751480,726660
527,m1309,20130708,3492,3483,3476,3483,3456,3471,3467,-12,-16,227504,7889070140,692022
528,m1309,20130709,3471,3467,3507,3561,3498,3555,3535,88,68,409256,14468327560,635130
529,m1309,20130710,3555,3535,3580,3588,3551,3573,3568,38,33,292260,10429311500,644262
530,m1309,20130711,3573,3568,3590,3606,3555,3590,3583,22,15,267734,9593118980,636104
531,m1309,20130712,3590,3583,3609,3650,3600,3634,3636,51,53,410734,14935118520,621848
532,m1309,20130715,3634,3636,3585,3606,3571,3590,3590,-46,-46,242380,8703519560,599388
533,m1309,20130716,3590,3590,3613,3630,3608,3626,3621,36,31,198016,7170393520,584678
534,m1309,20130717,3626,3621,3666,3673,3646,3650,3659,29,38,251294,9196272560,580650
535,m1309,20130718,3650,3659,3640,3688,3636,3687,3667,28,8,206052,7557720020,585336
536,m1309,20130719,3687,3667,3682,3697,3673,3680,3683,13,16,209616,7722117940,581276
537,m1309,20130722,3680,3683,3699,3704,3632,3649,3662,-34,-21,299864,10981281320,537234
538,m1309,20130723,3649,3662,3680,3708,3664,3702,3689,40,27,285564,10535476440,503894
539,m1309,20130724,3702,3689,3660,3676,3639,3667,3662,-22,-27,219810,8049716660,463574
540,m1309,20130725,3667,3662,3600,3623,3590,3591,3607,-71,-55,274994,9920390380,433196
541,m1309,20130726,3591,3607,3520,3544,3490,3525,3520,-82,-87,474184,16692920760,424758
542,m1309,20130729,3525,3520,3523,3566,3523,3555,3549,35,29,239804,8510887360,397472
543,m1309,20130730,3555,3549,3579,3596,3556,3557,3579,8,30,228638,8183784780,366588
544,m1309,20130731,3557,3579,3540,3586,3530,3569,3564,-10,-15,197008,7021413020,362072
545,m1309,20130801,3569,3564,3559,3584,3559,3572,3572,8,8,91254,3260453800,337970
546,m1309,20130802,3572,3572,3560,3573,3551,3561,3562,-11,-10,64438,2295640960,323596
547,m1309,20130805,3561,3562,3550,3552,3531,3550,3543,-12,-19,75932,2690974300,311482
548,m1309,20130806,3550,3543,3546,3579,3529,3576,3557,33,14,127848,4548642880,297248
549,m1309,20130807,3576,3557,3576,3584,3562,3569,3571,12,14,93090,3324525160,278840
550,m1309,20130808,3569,3571,3580,3622,3575,3618,3606,47,35,119038,4293165100,257250
551,m1309,20130809,3618,3606,3628,3659,3624,3626,3641,20,35,114968,4186600800,222372
552,m1309,20130812,3626,3641,3630,3650,3613,3649,3635,8,-6,69598,2530029020,194672
553,m1309,20130813,3649,3635,3686,3704,3678,3700,3690,65,55,95036,3507419080,143550
554,m1309,20130814,3700,3690,3699,3736,3683,3729,3709,39,19,63338,2349403560,123826
555,m1309,20130815,3729,3709,3763,3810,3763,3785,3782,76,73,68566,2593471760,105768
556,m1309,20130816,3785,3782,3838,3838,3800,3822,3815,40,33,31226,1191476800,92314
557,m1309,20130819,3822,3815,3840,3879,3838,3861,3856,46,41,28500,1099231260,80606
558,m1309,20130820,3861,3856,3889,3904,3862,3873,3873,17,17,32376,1254033000,63310
559,m1309,20130821,3873,3873,3866,3886,3863,3875,3875,2,2,12972,502743220,57072
560,m1309,20130822,3875,3875,3875,3895,3871,3894,3880,19,5,9216,357640260,52302
561,m1309,20130823,3894,3880,3871,3880,3842,3858,3859,-22,-21,15284,589827260,45386
562,m1309,20130826,3858,3859,3920,4013,3920,4013,3996,154,137,21636,864671460,39172
563,m1309,20130827,4013,3996,4026,4044,3986,4005,4003,9,7,18102,724712120,29388
564,m1309,20130828,4005,4003,3993,4003,3964,3969,3985,-34,-18,8560,341136460,24430
565,m1309,20130829,3969,3985,3985,3988,3893,3907,3941,-78,-44,8338,328620020,19894
566,m1309,20130830,3907,3941,3882,3941,3820,3932,3874,-9,-67,9306,360536020,17266
567,m1309,20130902,3932,3874,3980,3995,3899,3978,3928,104,54,2830,111182200,18798
568,m1309,20130903,3978,3928,3960,4000,3960,4000,3969,72,41,1022,40570980,18556
569,m1309,20130904,4000,3969,3994,4002,3981,3981,3994,12,25,518,20693800,18158
570,m1309,20130905,3981,3994,3985,4000,3961,3971,3980,-23,-14,514,20459660,18128
571,m1309,20130906,3971,3980,4150,4150,3993,4035,4012,55,32,844,33867620,18100
572,m1309,20130909,4035,4012,4021,4030,4021,4030,4028,18,16,44,1772700,18080
573,m1309,20130910,4030,4028,4130,4130,4020,4040,4081,12,53,64,2611920,18070
574,m1309,20130911,4040,4081,4129,4140,4052,4083,4086,2,5,130,5311900,18028
575,m1309,20130912,4083,4086,4021,4140,4000,4100,4033,14,-53,1174,47354700,18000
576,m1309,20130913,4100,4033,4190,4190,4000,4150,3977,117,-56,244,9870240,0
577,m1311,20130104,3232,3257,3209,3222,3177,3205,3200,-52,-57,194,6208740,380
578,m1311,20130107,3205,3200,3195,3240,3182,3224,3212,24,12,112,3598500,434
579,m1311,20130108,3224,3212,3202,3234,3202,3234,3216,22,4,116,3731200,374
580,m1311,20130109,3234,3216,3228,3232,3191,3191,3224,-25,8,122,3933520,334
581,m1311,20130110,3191,3224,3205,3207,3183,3191,3196,-33,-28,32,1023000,342
582,m1311,20130111,3191,3196,3179,3195,3178,3183,3183,-13,-13,40,1273320,348
583,m1311,20130114,3183,3183,3225,3258,3221,3257,3232,74,49,170,5495100,312
584,m1311,20130115,3257,3232,3261,3289,3239,3239,3260,7,28,84,2739000,328
585,m1311,20130116,3239,3260,3240,3255,3236,3255,3244,-5,-16,110,3569360,322
586,m1311,20130117,3255,3244,3265,3268,3238,3244,3257,0,13,108,3517680,334
587,m1311,20130118,3244,3257,3232,3250,3222,3250,3230,-7,-27,136,4393000,318
588,m1311,20130121,3250,3230,3248,3359,3243,3266,3276,36,46,172,5635100,308
589,m1311,20130122,3266,3276,3281,3284,3266,3277,3275,1,-1,154,5043800,316
590,m1311,20130123,3277,3275,3278,3284,3274,3275,3276,0,1,32,1048320,294
591,m1311,20130124,3275,3276,3252,3255,3207,3208,3233,-68,-43,108,3492020,330
592,m1311,20130125,3208,3233,3234,3249,3234,3241,3242,8,9,24,778240,326
593,m1311,20130128,3241,3242,3255,3259,3244,3258,3254,16,12,54,1757420,336
594,m1311,20130129,3258,3254,3240,3252,3240,3252,3248,-2,-6,6,194880,334
595,m1311,20130130,3252,3248,3263,3312,3261,3296,3285,48,37,26,854180,326
596,m1311,20130131,3296,3285,3330,3334,3303,3330,3322,45,37,202,6711980,246
597,m1311,20130201,3330,3322,3312,3350,3312,3350,3322,28,0,50,1661200,268
598,m1311,20130204,3350,3322,3321,3368,3321,3350,3350,28,28,106,3551720,218
599,m1311,20130205,3350,3350,3332,3348,3329,3329,3336,-21,-14,120,4003360,170
600,m1311,20130206,3329,3336,3350,3350,3339,3348,3344,12,8,14,468280,162
601,m1311,20130207,3348,3344,3317,3339,3310,3319,3319,-25,-25,48,1593380,134
602,m1311,20130208,3319,3319,3335,3368,3335,3346,3349,27,30,18,602940,126
603,m1311,20130218,3346,3349,3263,3270,3257,3257,3262,-92,-87,60,1957320,154
604,m1311,20130219,3257,3262,3288,3288,3269,3277,3276,15,14,14,458760,150
605,m1311,20130220,3277,3276,3277,3321,3277,3316,3305,40,29,68,2248020,180
606,m1311,20130221,3316,3305,3302,3318,3283,3316,3298,11,-7,118,3892440,172
607,m1311,20130222,3316,3298,3324,3419,3320,3399,3399,101,101,182,6187900,260
608,m1311,20130225,3399,3399,3323,3370,3264,3305,3303,-94,-96,308,10173620,204
609,m1311,20130226,3305,3303,3324,3333,3270,3270,3296,-33,-7,100,3296800,232
610,m1311,20130227,3270,3296,3296,3321,3282,3300,3298,4,2,98,3232940,244
611,m1311,20130228,3300,3298,3311,3322,3288,3297,3310,-1,12,142,4700560,254
612,m1311,20130301,3297,3310,3314,3328,3290,3318,3319,8,9,114,3783800,272
613,m1311,20130304,3318,3319,3312,3316,3294,3302,3309,-17,-10,122,4037040,254
614,m1311,20130305,3302,3309,3320,3352,3301,3346,3326,37,17,2360,78512220,480
615,m1311,20130306,3346,3326,3335,3343,3321,3335,3331,9,5,134,4464080,464
616,m1311,20130307,3335,3331,3335,3345,3329,3340,3335,9,4,84,2801680,432
617,m1311,20130308,3340,3335,3347,3355,3336,3342,3343,7,8,234,7823040,450
618,m1311,20130311,3342,3343,3342,3346,3323,3331,3339,-12,-4,540,18035920,638
619,m1311,20130312,3331,3339,3329,3329,3289,3292,3300,-47,-39,126,4158980,640
620,m1311,20130313,3292,3300,3254,3299,3254,3290,3274,-10,-26,306,10020280,630
621,m1311,20130314,3290,3274,3257,3269,3230,3249,3244,-25,-30,154,4996740,654
622,m1311,20130315,3249,3244,3254,3278,3236,3236,3253,-8,9,80,2602500,670
623,m1311,20130318,3236,3253,3180,3190,3153,3162,3173,-91,-80,242,7680580,768
624,m1311,20130319,3162,3173,3218,3218,3158,3168,3168,-5,-5,288,9126100,876
625,m1311,20130320,3168,3168,3200,3229,3162,3205,3204,37,36,4276,137027180,920
626,m1311,20130321,3205,3204,3217,3219,3200,3206,3209,2,5,240,7702500,878
627,m1311,20130322,3206,3209,3221,3221,3197,3209,3210,0,1,92,2953400,858
628,m1311,20130325,3209,3210,3166,3248,3166,3194,3210,-16,0,112,3595500,850
629,m1311,20130326,3194,3210,3186,3217,3186,3211,3208,1,-2,28,898240,848
630,m1311,20130327,3211,3208,3203,3215,3201,3210,3212,2,4,150,4818880,736
631,m1311,20130328,3210,3212,3219,3225,3205,3206,3218,-6,6,92,2960680,680
632,m1311,20130329,3206,3218,3113,3178,3113,3163,3157,-55,-61,76,2400020,680
633,m1311,20130401,3163,3157,3170,3170,3150,3151,3161,-6,4,36,1138180,692
634,m1311,20130402,3151,3161,3160,3169,3136,3157,3154,-4,-7,80,2523560,690
635,m1311,20130403,3157,3154,3121,3121,3088,3092,3100,-62,-54,150,4650740,670
636,m1311,20130408,3092,3100,3096,3096,3035,3077,3060,-23,-40,84,2570880,670
637,m1311,20130409,3077,3060,3078,3101,3077,3078,3091,18,31,120,3709440,690
638,m1311,20130410,3078,3091,3099,3103,3093,3103,3097,12,6,70,2168520,678
639,m1311,20130411,3103,3097,3062,3088,3062,3080,3074,-17,-23,38,1168260,686
640,m1311,20130412,3080,3074,3091,3107,3081,3095,3094,21,20,112,3465880,688
641,m1311,20130415,3095,3094,3092,3092,3066,3076,3075,-18,-19,60,1845380,684
642,m1311,20130416,3076,3075,3048,3080,3037,3076,3053,1,-22,74,2259500,704
643,m1311,20130417,3076,3053,3100,3100,3092,3097,3099,44,46,82,2541380,636
644,m1311,20130418,3097,3099,3081,3125,3081,3125,3102,26,3,72,2233700,640
645,m1311,20130419,3125,3102,3112,3142,3112,3135,3128,33,26,32,1001080,626
646,m1311,20130422,3135,3128,3135,3135,3098,3098,3110,-30,-18,106,3297340,624
647,m1311,20130423,3098,3110,3106,3106,3081,3089,3093,-21,-17,24,742500,628
648,m1311,20130424,3089,3093,3093,3093,3031,3043,3055,-50,-38,188,5744740,652
649,m1311,20130425,3043,3055,3044,3069,3032,3061,3058,6,3,40,1223360,668
650,m1311,20130426,3061,3058,3079,3110,3079,3089,3095,31,37,32,990400,658
651,m1311,20130502,3089,3095,3091,3128,3091,3128,3105,33,10,48,1490460,662
652,m1311,20130503,3128,3105,3134,3140,3128,3135,3135,30,30,322,10097040,650
653,m1311,20130506,3135,3135,3136,3156,3123,3154,3138,19,3,100,3138040,626
654,m1311,20130507,3154,3138,3132,3145,3128,3137,3136,-1,-2,48,1505340,630
655,m1311,20130508,3137,3136,3149,3184,3149,3182,3176,46,40,104,3303780,654
656,m1311,20130509,3182,3176,3173,3178,3170,3174,3173,-2,-3,10,317380,654
657,m1311,20130510,3174,3173,3210,3210,3183,3197,3190,24,17,28,893220,634
658,m1311,20130513,3197,3190,3177,3195,3161,3161,3181,-29,-9,94,2990460,642
659,m1311,20130514,3161,3181,3183,3195,3183,3186,3190,5,9,88,2807560,660
660,m1311,20130515,3186,3190,3196,3196,3173,3173,3181,-17,-9,44,1399640,678
661,m1311,20130516,3173,3181,3161,3187,3160,3174,3178,-7,-3,48,1525880,688
662,m1311,20130517,3174,3178,3195,3201,3189,3195,3196,17,18,64,2045480,672
663,m1311,20130520,3195,3196,3195,3222,3195,3210,3213,14,17,78,2506260,660
664,m1311,20130521,3210,3213,3215,3220,3203,3203,3211,-10,-2,46,1477080,654
665,m1311,20130522,3203,3211,3200,3239,3200,3239,3208,28,-3,50,1604120,668
666,m1311,20130523,3239,3208,3225,3233,3212,3213,3221,5,13,76,2448340,674
667,m1311,20130524,3213,3221,3209,3321,3206,3231,3278,10,57,280,9179760,832
668,m1311,20130527,3231,3278,3214,3234,3214,3234,3228,-44,-50,38,1226820,828
669,m1311,20130528,3234,3228,3248,3294,3235,3244,3253,16,25,264,8589040,796
670,m1311,20130529,3244,3253,3280,3349,3125,3290,3279,37,26,1030,33780980,686
671,m1311,20130530,3290,3279,3295,3321,3282,3301,3293,22,14,74,2437300,712
672,m1311,20130531,3301,3293,3292,3325,3292,3318,3313,25,20,250,8283820,708
673,m1311,20130603,3318,3313,3364,3439,3358,3439,3398,126,85,228,7748500,618
674,m1311,20130604,3439,3398,3427,3427,3381,3382,3408,-16,10,142,4839780,650
675,m1311,20130605,3382,3408,3391,3431,3391,3422,3418,14,10,122,4169980,626
676,m1311,20130606,3422,3418,3372,3398,3333,3356,3361,-62,-57,318,10688960,772
677,m1311,20130607,3356,3361,3387,3387,3344,3366,3354,5,-7,222,7447180,664
678,m1311,20130613,3366,3354,3372,3373,3341,3368,3361,14,7,118,3967020,604
679,m1311,20130614,3368,3361,3331,3375,3331,3375,3356,14,-5,20,671260,602
680,m1311,20130617,3375,3356,3371,3371,3325,3359,3339,3,-17,374,12491180,696
681,m1311,20130618,3359,3339,3363,3376,3359,3359,3372,20,33,200,6744460,652
682,m1311,20130619,3359,3372,3359,3369,3359,3360,3361,-12,-11,8,268940,650
683,m1311,20130620,3360,3361,3385,3392,3360,3365,3372,4,11,94,3170360,634
684,m1311,20130621,3365,3372,3351,3365,3332,3345,3347,-27,-25,36,1205240,646
685,m1311,20130624,3345,3347,3313,3329,3313,3317,3320,-30,-27,56,1859560,636
686,m1311,20130625,3317,3320,3339,3351,3339,3351,3341,31,21,10,334140,636
687,m1311,20130626,3351,3341,3360,3368,3355,3362,3359,21,18,52,1747080,664
688,m1311,20130627,3362,3359,3375,3385,3355,3382,3372,23,13,82,2765540,634
689,m1311,20130628,3382,3372,3372,3372,3345,3345,3361,-27,-11,48,1613280,620
690,m1311,20130701,3345,3361,3329,3346,3321,3339,3335,-22,-26,38,1267520,618
691,m1311,20130702,3339,3335,3341,3351,3337,3351,3345,16,10,24,803000,626
692,m1311,20130703,3351,3345,3361,3374,3361,3367,3362,22,17,34,1143320,636
693,m1311,20130704,3367,3362,3370,3372,3365,3371,3369,9,7,12,404320,632
694,m1311,20130705,3371,3369,3378,3380,3374,3374,3376,5,7,88,2970960,624
695,m1311,20130708,3374,3376,3366,3370,3251,3369,3336,-7,-40,1594,53181460,744
696,m1311,20130709,3369,3336,3395,3423,3395,3422,3416,86,80,248,8471960,662
697,m1311,20130710,3422,3416,3424,3453,3420,3443,3443,27,27,138,4752100,556
698,m1311,20130711,3443,3443,3479,3479,3443,3463,3459,20,16,72,2490920,534
699,m1311,20130712,3463,3459,3490,3501,3461,3461,3481,2,22,74,2576320,554
700,m1311,20130715,3461,3481,3403,3440,3403,3437,3428,-44,-53,86,2948140,534
701,m1311,20130716,3437,3428,3460,3476,3452,3469,3460,41,32,52,1799700,550
702,m1311,20130717,3469,3460,3485,3490,3472,3473,3475,13,15,128,4449080,482
703,m1311,20130718,3473,3475,3457,3486,3457,3486,3465,11,-10,60,2079360,476
704,m1311,20130719,3486,3465,3493,3520,3452,3482,3493,17,28,152,5310120,464
705,m1311,20130722,3482,3493,3490,3491,3465,3473,3476,-20,-17,56,1946780,460
706,m1311,20130723,3473,3476,3487,3599,3487,3551,3516,75,40,476,16738460,472
707,m1311,20130724,3551,3516,3510,3538,3510,3523,3523,7,7,66,2325760,472
708,m1311,20130725,3523,3523,3498,3518,3482,3504,3510,-19,-13,146,5125100,482
709,m1311,20130726,3504,3510,3451,3451,3411,3422,3428,-88,-82,540,18513980,792
710,m1311,20130729,3422,3428,3433,3438,3418,3438,3427,10,-1,120,4113420,762
711,m1311,20130730,3438,3427,3437,3460,3437,3457,3449,30,22,216,7450660,754
712,m1311,20130731,3457,3449,3415,3453,3405,3453,3426,4,-23,256,8771980,592
713,m1311,20130801,3453,3426,3439,3471,3439,3468,3463,42,37,48,1662620,586
714,m1311,20130802,3468,3463,3455,3490,3455,3465,3471,2,8,40,1388560,584
715,m1311,20130805,3465,3471,3458,3458,3429,3442,3442,-29,-29,314,10809680,612
716,m1311,20130806,3442,3442,3420,3445,3408,3431,3425,-11,-17,132,4521000,614
717,m1311,20130807,3431,3425,3305,3433,3305,3400,3401,-25,-24,466,15852820,600
718,m1311,20130808,3400,3401,3430,3445,3430,3445,3434,44,33,14,480820,596
719,m1311,20130809,3445,3434,3458,3474,3445,3445,3461,11,27,100,3461680,596
720,m1311,20130812,3445,3461,3456,3465,3450,3465,3458,4,-3,14,484200,588
721,m1311,20130813,3465,3458,3522,3522,3495,3502,3502,44,44,240,8406340,450
722,m1311,20130814,3502,3502,3498,3539,3382,3470,3459,-32,-43,474,16396780,422
723,m1311,20130815,3470,3459,3491,3517,3491,3499,3500,40,41,498,17433920,516
724,m1311,20130816,3499,3500,3510,3555,3510,3539,3543,39,43,274,9709760,518
725,m1311,20130819,3539,3543,3550,3593,3550,3593,3574,50,31,106,3789180,524
726,m1311,20130820,3593,3574,3626,3626,3580,3592,3595,18,21,142,5105180,530
727,m1311,20130821,3592,3595,3581,3602,3581,3594,3593,-1,-2,132,4743600,524
728,m1311,20130822,3594,3593,3594,3623,3594,3615,3602,22,9,152,5476280,532
729,m1311,20130823,3615,3602,3604,3607,3584,3607,3599,5,-3,96,3455080,536
730,m1311,20130826,3607,3599,3696,3742,3696,3742,3729,143,130,214,7980140,572
731,m1311,20130827,3742,3729,3751,3835,3751,3813,3781,84,52,292,11042240,554
732,m1311,20130828,3813,3781,3802,3814,3781,3787,3800,6,19,282,10716900,498
733,m1311,20130829,3787,3800,3800,3800,3740,3760,3772,-40,-28,150,5658360,460
734,m1311,20130830,3760,3772,3745,3747,3696,3728,3716,-44,-56,184,6838880,488
735,m1311,20130902,3728,3716,3690,3800,3690,3800,3773,84,57,176,6642100,450
736,m1311,20130903,3800,3773,3803,3803,3758,3783,3781,10,8,204,7713260,404
737,m1311,20130904,3783,3781,3745,3764,3730,3752,3744,-29,-37,118,4418080,378
738,m1311,20130905,3752,3744,3705,3769,3705,3727,3734,-17,-10,126,4705980,364
739,m1311,20130906,3727,3734,3764,3788,3758,3788,3773,54,39,182,6867580,424
740,m1311,20130909,3788,3773,3829,3829,3774,3774,3792,1,19,66,2502720,404
741,m1311,20130910,3774,3792,3760,3765,3740,3742,3751,-50,-41,80,3001020,382
742,m1311,20130911,3742,3751,3780,3818,3770,3818,3794,67,43,456,17301900,616
743,m1311,20130912,3818,3794,3847,3920,3811,3892,3868,98,74,804,31104460,944
744,m1311,20130913,3892,3868,3925,3997,3925,3990,3985,122,117,1194,47588480,1258
745,m1311,20130916,3990,3985,3960,3979,3913,3939,3943,-46,-42,1062,41882300,1162
746,m1311,20130917,3939,3943,3921,3942,3910,3927,3920,-16,-23,706,27680620,1330
747,m1311,20130918,3927,3920,3896,3930,3896,3925,3917,5,-3,786,30790240,1608
748,m1311,20130923,3925,3917,3835,3892,3835,3885,3875,-32,-42,740,28681260,1902
749,m1311,20130924,3885,3875,3885,3906,3885,3901,3897,26,22,500,19486900,1956
750,m1311,20130925,3901,3897,3902,3934,3893,3915,3917,18,20,836,32747600,1862
751,m1311,20130926,3915,3917,3914,3934,3910,3928,3921,11,4,608,23842540,1770
752,m1311,20130927,3928,3921,3924,3948,3910,3943,3929,22,8,614,24128240,1458
753,m1311,20130930,3943,3929,3925,3955,3917,3955,3933,26,4,392,15417780,1274
754,m1311,20131008,3955,3933,3955,3999,3955,3995,3985,62,52,710,28297880,842
755,m1311,20131009,3995,3985,3920,4023,3920,4019,3991,34,6,788,31449360,934
756,m1311,20131010,4019,3991,4020,4065,4003,4007,4035,16,44,882,35589400,960
757,m1311,20131011,4007,4035,4000,4028,3998,4005,4011,-30,-24,608,24390980,1036
758,m1311,20131014,4005,4011,4011,4030,4000,4016,4016,5,5,292,11727760,1034
759,m1311,20131015,4016,4016,4016,4023,3990,3993,4004,-23,-12,358,14334940,964
760,m1311,20131016,3993,4004,3995,4011,3995,4011,4003,7,-1,290,11611420,844
761,m1311,20131017,4011,4003,4027,4046,3955,3972,4010,-31,7,364,14598280,870
762,m1311,20131018,3972,4010,3980,4000,3975,3994,3981,-16,-29,144,5732940,862
763,m1311,20131021,3994,3981,3982,4024,3975,3983,3991,2,10,150,5986840,882
764,m1311,20131022,3983,3991,3994,3995,3970,3976,3982,-15,-9,38,1513300,876
765,m1311,20131023,3976,3982,3988,3988,3970,3988,3983,6,1,34,1354380,872
766,m1311,20131024,3988,3983,3988,3988,3900,3936,3944,-47,-39,154,6073960,846
767,m1311,20131025,3936,3944,3905,3940,3905,3914,3920,-30,-24,92,3606720,820
768,m1311,20131028,3914,3920,3841,3897,3800,3805,3820,-115,-100,190,7258480,760
769,m1311,20131029,3805,3820,3790,3800,3750,3800,3773,-20,-47,302,11394660,784
770,m1311,20131030,3800,3773,3796,3850,3796,3835,3828,62,55,82,3139620,764
771,m1311,20131031,3835,3828,3900,3972,3800,3900,3903,72,75,450,17566140,794
772,m1311,20131101,3900,3903,3900,3960,3900,3960,3950,57,47,54,2133080,756
773,m1311,20131104,3960,3950,0,0,0,3950,3950,0,0,0,0,756
774,m1311,20131105,3950,3950,0,0,0,3950,3950,0,0,0,0,756
775,m1311,20131106,3950,3950,3920,3920,3920,3920,3920,-30,-30,750,29400000,750
776,m1311,20131107,3920,3920,3902,3902,3901,3901,3901,-19,-19,6,234080,744
777,m1311,20131108,3901,3901,3822,3822,3800,3800,3814,-101,-87,6,228860,744
778,m1311,20131111,3800,3814,3850,3850,3850,3850,3850,36,36,2,77000,744
779,m1311,20131112,3850,3850,3871,3900,3870,3870,3880,20,30,12,465640,744
780,m1311,20131113,3870,3880,3900,4000,3900,3901,3919,21,39,46,1802860,744
781,m1311,20131114,3901,3919,3850,3990,3805,3820,3919,-99,0,68,2659420,0
782,m1312,20130104,3238,3243,3200,3200,3173,3199,3195,-44,-48,142,4537420,214
783,m1312,20130107,3199,3195,3191,3236,3191,3212,3217,17,22,52,1672900,244
784,m1312,20130108,3212,3217,3225,3231,3205,3220,3218,3,1,44,1415980,234
785,m1312,20130109,3220,3218,3220,3230,3211,3215,3221,-3,3,30,966500,244
786,m1312,20130110,3215,3221,3201,3205,3186,3190,3195,-31,-26,48,1533720,270
787,m1312,20130111,3190,3195,3189,3193,3180,3181,3185,-14,-10,44,1401620,294
788,m1312,20130114,3181,3185,3183,3266,3183,3256,3230,71,45,106,3424080,262
789,m1312,20130115,3256,3230,3260,3276,3238,3243,3261,13,31,96,3130560,278
790,m1312,20130116,3243,3261,3248,3254,3241,3251,3247,-10,-14,34,1104080,276
791,m1312,20130117,3251,3247,3234,3296,3234,3240,3264,-7,17,98,3198800,288
792,m1312,20130118,3240,3264,3236,3243,3217,3243,3230,-21,-34,236,7623740,310
793,m1312,20130121,3243,3230,3243,3271,3243,3261,3256,31,26,132,4298640,240
794,m1312,20130122,3261,3256,3234,3268,3234,3261,3256,5,0,64,2083940,252
795,m1312,20130123,3261,3256,3272,3275,3241,3261,3264,5,8,78,2546300,256
796,m1312,20130124,3261,3264,3254,3254,3205,3219,3220,-45,-44,132,4251480,292
797,m1312,20130125,3219,3220,3236,3243,3236,3236,3239,16,19,34,1101420,280
798,m1312,20130128,3236,3239,3242,3260,3237,3260,3243,21,4,42,1362320,252
799,m1312,20130129,3260,3243,3244,3249,3237,3249,3243,6,0,12,389200,250
800,m1312,20130130,3249,3243,3253,3285,3253,3285,3268,42,25,94,3071980,216
801,m1312,20130131,3285,3268,3295,3309,3287,3291,3296,23,28,100,3296540,206
802,m1312,20130201,3291,3296,3297,3319,3284,3319,3293,23,-3,66,2173660,202
803,m1312,20130204,3319,3293,3309,3323,3303,3318,3316,25,23,76,2520880,188
804,m1312,20130205,3318,3316,3244,3328,3244,3308,3306,-8,-10,84,2777360,182
805,m1312,20130206,3308,3306,3303,3314,3303,3312,3309,6,3,14,463380,180
806,m1312,20130207,3312,3309,3281,3295,3276,3288,3281,-21,-28,30,984440,170
807,m1312,20130208,3288,3281,3297,3297,3276,3276,3287,-5,6,14,460240,168
808,m1312,20130218,3276,3287,3220,3231,3213,3219,3222,-68,-65,84,2706900,192
809,m1312,20130219,3219,3222,3230,3236,3224,3233,3229,11,7,66,2131320,204
810,m1312,20130220,3233,3229,3239,3260,3238,3252,3250,23,21,60,1950440,192
811,m1312,20130221,3252,3250,3238,3247,3218,3244,3228,-6,-22,56,1807800,178
812,m1312,20130222,3244,3228,3236,3349,3236,3320,3298,92,70,308,10158700,182
813,m1312,20130225,3320,3298,3233,3278,3183,3260,3248,-38,-50,598,19425100,384
814,m1312,20130226,3260,3248,3268,3305,3233,3248,3272,0,24,130,4253820,386
815,m1312,20130227,3248,3272,3278,3279,3258,3270,3269,-2,-3,96,3138240,396
816,m1312,20130228,3270,3269,3274,3279,3260,3260,3271,-9,2,220,7196860,444
817,m1312,20130301,3260,3271,3270,3294,3266,3294,3278,23,7,102,3343960,420
818,m1312,20130304,3294,3278,3284,3302,3268,3275,3283,-3,5,94,3086480,398
819,m1312,20130305,3275,3283,3292,3307,3292,3303,3300,20,17,102,3366680,404
820,m1312,20130306,3303,3300,3295,3295,3283,3292,3290,-8,-10,78,2566240,426
821,m1312,20130307,3292,3290,3287,3296,3283,3290,3288,0,-2,20,657640,420
822,m1312,20130308,3290,3288,3302,3310,3287,3304,3299,16,11,110,3629040,384
823,m1312,20130311,3304,3299,3300,3300,3285,3290,3293,-9,-6,158,5203240,466
824,m1312,20130312,3290,3293,3273,3280,3244,3244,3266,-49,-27,60,1960040,464
825,m1312,20130313,3244,3266,3236,3259,3236,3254,3246,-12,-20,22,714280,460
826,m1312,20130314,3254,3246,3221,3247,3220,3228,3230,-18,-16,100,3230840,460
827,m1312,20130315,3228,3230,3245,3253,3236,3236,3244,6,14,90,2920260,446
828,m1312,20130318,3236,3244,3190,3201,3138,3156,3165,-88,-79,164,5192160,468
829,m1312,20130319,3156,3165,3164,3168,3154,3161,3161,-4,-4,114,3603780,460
830,m1312,20130320,3161,3161,3170,3197,3164,3181,3184,20,23,148,4712320,450
831,m1312,20130321,3181,3184,3199,3208,3189,3195,3197,11,13,52,1662900,452
832,m1312,20130322,3195,3197,3203,3203,3192,3195,3195,-2,-2,16,511320,462
833,m1312,20130325,3195,3195,3183,3192,3183,3190,3189,-5,-6,10,318920,456
834,m1312,20130326,3190,3189,3199,3199,3194,3196,3195,7,6,16,511280,452
835,m1312,20130327,3196,3195,3197,3198,3188,3198,3192,3,-3,66,2107180,418
836,m1312,20130328,3198,3192,3204,3222,3195,3195,3209,3,17,40,1283820,394
837,m1312,20130329,3195,3209,3130,3156,3130,3153,3149,-56,-60,98,3086620,382
838,m1312,20130401,3153,3149,3155,3155,3155,3155,3155,6,6,2,63100,382
839,m1312,20130402,3155,3155,3155,3156,3140,3153,3147,-2,-8,28,881420,390
840,m1312,20130403,3153,3147,3091,3101,3091,3091,3093,-56,-54,14,433020,380
841,m1312,20130408,3091,3093,3059,3059,3059,3059,3059,-34,-34,6,183540,380
842,m1312,20130409,3059,3059,3072,3118,3054,3059,3083,0,24,160,4933560,388
843,m1312,20130410,3059,3083,3079,3080,3068,3077,3075,-6,-8,78,2398920,386
844,m1312,20130411,3077,3075,3040,3070,3040,3067,3063,-8,-12,44,1347840,386
845,m1312,20130412,3067,3063,3085,3090,3068,3090,3079,27,16,34,1047140,390
846,m1312,20130415,3090,3079,3064,3077,3032,3045,3053,-34,-26,72,2198540,378
847,m1312,20130416,3045,3053,3055,3055,2967,3027,3023,-26,-30,66,1995260,352
848,m1312,20130417,3027,3023,3060,3060,3037,3055,3052,32,29,12,366320,352
849,m1312,20130418,3055,3052,3055,3081,3055,3081,3073,29,21,10,307380,344
850,m1312,20130419,3081,3073,3098,3106,3082,3082,3095,9,22,20,619180,332
851,m1312,20130422,3082,3095,3052,3052,3051,3051,3051,-44,-44,4,122060,330
852,m1312,20130423,3051,3051,3038,3056,3038,3050,3045,-1,-6,12,365480,330
853,m1312,20130424,3050,3045,3041,3045,3003,3007,3014,-38,-31,50,1507220,340
854,m1312,20130425,3007,3014,3016,3026,3013,3013,3019,-1,5,10,301960,334
855,m1312,20130426,3013,3019,3048,3050,3037,3037,3044,18,25,54,1643880,340
856,m1312,20130502,3037,3044,3053,3074,3053,3067,3063,23,19,14,428860,332
857,m1312,20130503,3067,3063,3071,3078,3071,3078,3074,15,11,24,737820,318
858,m1312,20130506,3078,3074,3059,3083,3002,3083,3063,9,-11,42,1286540,328
859,m1312,20130507,3083,3063,3093,3093,3072,3079,3075,16,12,26,799740,324
860,m1312,20130508,3079,3075,3097,3115,3090,3115,3106,40,31,42,1304840,316
861,m1312,20130509,3115,3106,3077,3114,3077,3100,3094,-6,-12,38,1175940,306
862,m1312,20130510,3100,3094,3142,3142,3103,3106,3124,12,30,442,13808720,316
863,m1312,20130513,3106,3124,3083,3120,3071,3075,3101,-49,-23,78,2419500,268
864,m1312,20130514,3075,3101,3100,3107,3099,3106,3103,5,2,22,682820,260
865,m1312,20130515,3106,3103,3106,3106,3099,3100,3100,-3,-3,22,682000,260
866,m1312,20130516,3100,3100,3100,3116,3100,3116,3102,16,2,14,434320,252
867,m1312,20130517,3116,3102,3124,3135,3124,3135,3132,33,30,38,1190220,272
868,m1312,20130520,3135,3132,3060,3153,3060,3145,3116,13,-16,256,7978500,280
869,m1312,20130521,3145,3116,0,0,0,3119,3119,3,3,0,0,280
870,m1312,20130522,3119,3119,3126,3135,3123,3123,3129,4,10,38,1189320,286
871,m1312,20130523,3123,3129,3124,3144,3124,3134,3134,5,5,52,1630140,266
872,m1312,20130524,3134,3134,3131,3131,3129,3130,3130,-4,-4,14,438220,258
873,m1312,20130527,3130,3130,3128,3139,3128,3131,3131,1,1,14,438440,254
874,m1312,20130528,3131,3131,3142,3154,3138,3154,3145,23,14,40,1258080,240
875,m1312,20130529,3154,3145,3198,3270,3198,3246,3247,101,102,216,7013660,196
876,m1312,20130530,3246,3247,3262,3274,3250,3268,3263,21,16,48,1566600,188
877,m1312,20130531,3268,3263,3268,3294,3268,3294,3280,31,17,26,852840,186
878,m1312,20130603,3294,3280,3337,3397,3337,3397,3365,117,85,78,2624780,168
879,m1312,20130604,3397,3365,3371,3377,3343,3343,3362,-22,-3,96,3227760,162
880,m1312,20130605,3343,3362,3385,3399,3366,3383,3383,21,21,90,3045080,172
881,m1312,20130606,3383,3383,3320,3349,3320,3340,3341,-43,-42,186,6214580,192
882,m1312,20130607,3340,3341,3342,3342,3326,3330,3329,-11,-12,50,1664860,208
883,m1312,20130613,3330,3329,3338,3338,3319,3338,3328,9,-1,44,1464660,200
884,m1312,20130614,3338,3328,3311,3338,3305,3338,3322,10,-6,44,1462060,208
885,m1312,20130617,3338,3322,3296,3314,3242,3311,3287,-11,-35,16,526020,212
886,m1312,20130618,3311,3287,3344,3344,3326,3328,3330,41,43,12,399640,210
887,m1312,20130619,3328,3330,3290,3325,3290,3319,3319,-11,-11,40,1327820,224
888,m1312,20130620,3319,3319,3329,3349,3324,3327,3335,8,16,90,3001740,226
889,m1312,20130621,3327,3335,3299,3345,3260,3260,3296,-75,-39,66,2175480,252
890,m1312,20130624,3260,3296,3257,3264,3225,3256,3252,-40,-44,28,910640,246
891,m1312,20130625,3256,3252,3325,3325,3270,3280,3284,28,32,16,525500,244
892,m1312,20130626,3280,3284,3280,3304,3280,3288,3294,4,10,12,395320,242
893,m1312,20130627,3288,3294,3299,3325,3299,3325,3315,31,21,10,331520,244
894,m1312,20130628,3325,3315,3340,3340,3293,3293,3318,-22,3,88,2919900,234
895,m1312,20130701,3293,3318,3231,3277,3214,3275,3260,-43,-58,50,1630080,238
896,m1312,20130702,3275,3260,3271,3297,3271,3286,3286,26,26,44,1446000,222
897,m1312,20130703,3286,3286,3296,3305,3296,3305,3298,19,12,8,263860,222
898,m1312,20130704,3305,3298,3314,3314,3301,3301,3305,3,7,12,396680,220
899,m1312,20130705,3301,3305,3350,3350,3350,3350,3350,45,45,4,134000,224
900,m1312,20130708,3350,3350,3284,3296,3268,3272,3282,-78,-68,34,1115960,218
901,m1312,20130709,3272,3282,3335,3352,3315,3332,3330,50,48,180,5995700,186
902,m1312,20130710,3332,3330,3350,3359,3334,3344,3344,14,14,32,1070380,174
903,m1312,20130711,3344,3344,3354,3367,3354,3366,3361,22,17,26,873940,178
904,m1312,20130712,3366,3361,3397,3398,3371,3380,3383,19,22,58,1962440,170
905,m1312,20130715,3380,3383,3336,3342,3300,3340,3330,-43,-53,48,1598840,168
906,m1312,20130716,3340,3330,3340,3406,3331,3406,3357,76,27,46,1544520,164
907,m1312,20130717,3406,3357,3397,3397,3391,3393,3394,36,37,14,475180,158
908,m1312,20130718,3393,3394,3369,3418,3369,3418,3401,24,7,34,1156580,184
909,m1312,20130719,3418,3401,3380,3414,3363,3363,3402,-38,1,156,5307400,182
910,m1312,20130722,3363,3402,3399,3450,3390,3396,3400,-6,-2,186,6325340,308
911,m1312,20130723,3396,3400,3400,3461,3400,3452,3430,52,30,200,6861720,278
912,m1312,20130724,3452,3430,3392,3433,3380,3417,3410,-13,-20,46,1568940,278
913,m1312,20130725,3417,3410,3387,3402,3387,3389,3399,-21,-11,102,3467600,284
914,m1312,20130726,3389,3399,3282,3346,3281,3312,3333,-87,-66,438,14600040,530
915,m1312,20130729,3312,3333,3312,3334,3311,3334,3324,1,-9,40,1329960,534
916,m1312,20130730,3334,3324,3348,3360,3337,3353,3345,29,21,50,1672960,534
917,m1312,20130731,3353,3345,3319,3342,3309,3342,3328,-3,-17,40,1331280,530
918,m1312,20130801,3342,3328,3355,3369,3353,3369,3358,41,30,18,604560,530
919,m1312,20130802,3369,3358,3354,3389,3354,3380,3369,22,11,90,3032980,568
920,m1312,20130805,3380,3369,3371,3371,3345,3350,3356,-19,-13,126,4228820,584
921,m1312,20130806,3350,3356,3340,3367,3330,3363,3359,7,3,70,2351720,586
922,m1312,20130807,3363,3359,3353,3354,3341,3341,3349,-18,-10,22,736920,586
923,m1312,20130808,3341,3349,3351,3376,3350,3350,3369,1,20,70,2358360,552
924,m1312,20130809,3350,3369,3387,3400,3364,3376,3376,7,7,196,6617980,518
925,m1312,20130812,3376,3376,3367,3378,3366,3369,3369,-7,-7,74,2493340,514
926,m1312,20130813,3369,3369,3431,3432,3406,3420,3419,51,50,176,6017660,382
927,m1312,20130814,3420,3419,3439,3439,3381,3386,3389,-33,-30,262,8880020,290
928,m1312,20130815,3386,3389,3420,3437,3384,3395,3410,6,21,236,8049460,254
929,m1312,20130816,3395,3410,3420,3456,3420,3426,3432,16,22,198,6796120,224
930,m1312,20130819,3426,3432,3452,3473,3447,3466,3456,34,24,136,4700600,248
931,m1312,20130820,3466,3456,3510,3510,3476,3478,3486,22,30,186,6484860,242
932,m1312,20130821,3478,3486,3478,3491,3475,3483,3481,-3,-5,82,2855020,258
933,m1312,20130822,3483,3481,3485,3502,3485,3502,3492,21,11,16,558780,258
934,m1312,20130823,3502,3492,3481,3500,3480,3500,3488,8,-4,60,2093060,264
935,m1312,20130826,3500,3488,3611,3627,3602,3627,3617,139,129,58,2098280,266
936,m1312,20130827,3627,3617,3694,3741,3681,3722,3706,105,89,204,7560620,230
937,m1312,20130828,3722,3706,3714,3732,3690,3710,3711,4,5,142,5270020,248
938,m1312,20130829,3710,3711,3755,3755,3630,3669,3692,-42,-19,98,3618380,258
939,m1312,20130830,3669,3692,3669,3669,3588,3618,3626,-74,-66,96,3481800,210
940,m1312,20130902,3618,3626,3650,3708,3650,3708,3696,82,70,78,2883240,182
941,m1312,20130903,3708,3696,3703,3716,3663,3709,3687,13,-9,188,6932980,178
942,m1312,20130904,3709,3687,3655,3679,3645,3673,3663,-14,-24,30,1098940,164
943,m1312,20130905,3673,3663,3662,3673,3633,3639,3658,-24,-5,38,1390060,166
944,m1312,20130906,3639,3658,3688,3708,3673,3708,3687,50,29,116,4277780,178
945,m1312,20130909,3708,3687,3740,3740,3693,3693,3718,6,31,178,6619080,222
946,m1312,20130910,3693,3718,3654,3671,3630,3655,3655,-63,-63,138,5044500,194
947,m1312,20130911,3655,3655,3673,3694,3671,3694,3674,39,19,28,1028960,180
948,m1312,20130912,3694,3674,3704,3757,3703,3744,3728,70,54,68,2535360,162
949,m1312,20130913,3744,3728,3796,3853,3778,3852,3826,124,98,220,8418780,196
950,m1312,20130916,3852,3826,3800,3820,3785,3789,3800,-37,-26,180,6841740,188
951,m1312,20130917,3789,3800,3768,3792,3768,3788,3780,-12,-20,122,4612160,178
952,m1312,20130918,3788,3780,3781,3827,3761,3786,3783,6,3,102,3858960,166
953,m1312,20130923,3786,3783,3742,3758,3732,3741,3742,-42,-41,66,2469820,162
954,m1312,20130924,3741,3742,3721,3780,3721,3776,3771,34,29,42,1584220,158
955,m1312,20130925,3776,3771,3785,3793,3775,3775,3782,4,11,82,3101800,160
956,m1312,20130926,3775,3782,3784,3792,3752,3782,3774,0,-8,56,2113600,168
957,m1312,20130927,3782,3774,3778,3825,3778,3825,3803,51,29,156,5933240,228
958,m1312,20130930,3825,3803,3827,3855,3823,3855,3834,52,31,108,4141740,214
959,m1312,20131008,3855,3834,3911,3911,3860,3898,3894,64,60,128,4984720,158
960,m1312,20131009,3898,3894,3891,3925,3867,3921,3909,27,15,298,11650720,356
961,m1312,20131010,3921,3909,3901,3940,3900,3900,3915,-9,6,100,3915620,364
962,m1312,20131011,3900,3915,3906,3913,3885,3889,3901,-26,-14,192,7490280,388
963,m1312,20131014,3889,3901,3866,3900,3866,3877,3887,-24,-14,98,3809700,394
964,m1312,20131015,3877,3887,3848,3884,3841,3854,3862,-33,-25,140,5408000,420
965,m1312,20131016,3854,3862,3826,3857,3826,3848,3843,-14,-19,106,4073820,410
966,m1312,20131017,3848,3843,3845,3856,3801,3825,3831,-18,-12,176,6742940,384
967,m1312,20131018,3825,3831,3850,3896,3840,3865,3860,34,29,226,8724660,408
968,m1312,20131021,3865,3860,3844,3857,3833,3856,3850,-4,-10,70,2695060,414
969,m1312,20131022,3856,3850,3856,3869,3848,3848,3854,-2,4,66,2543960,408
970,m1312,20131023,3848,3854,3842,3879,3842,3867,3865,13,11,64,2473660,412
971,m1312,20131024,3867,3865,3868,3877,3851,3877,3861,12,-4,136,5251520,446
972,m1312,20131025,3877,3861,3870,3872,3850,3851,3858,-10,-3,52,2006660,432
973,m1312,20131028,3851,3858,3822,3834,3759,3759,3786,-99,-72,98,3710540,428
974,m1312,20131029,3759,3786,3767,3767,3701,3737,3741,-49,-45,56,2095460,428
975,m1312,20131030,3737,3741,3759,3760,3725,3744,3747,3,6,140,5247040,444
976,m1312,20131031,3744,3747,3702,3750,3702,3750,3731,3,-16,132,4926020,416
977,m1312,20131101,3750,3731,3750,3784,3750,3780,3771,49,40,88,3319020,452
978,m1312,20131104,3780,3771,3777,3780,3750,3779,3769,8,-2,304,11459540,634
979,m1312,20131105,3779,3769,3772,3774,3760,3770,3769,1,0,126,4749480,690
980,m1312,20131106,3770,3769,3767,3767,3752,3763,3762,-6,-7,106,3988080,676
981,m1312,20131107,3763,3762,3766,3770,3756,3764,3764,2,2,64,2409520,682
982,m1312,20131108,3764,3764,3770,3770,3756,3760,3759,-4,-5,42,1578920,666
983,m1312,20131111,3760,3759,3791,3791,3781,3781,3788,22,29,14,530320,660
984,m1312,20131112,3781,3788,3801,3801,3786,3791,3793,3,5,30,1138040,656
985,m1312,20131113,3791,3793,3808,3808,3793,3803,3800,10,7,92,3496200,664
986,m1312,20131114,3803,3800,3800,3816,3800,3803,3812,3,12,322,12277320,666
987,m1312,20131115,3803,3812,3810,3848,3810,3825,3824,13,12,234,8948880,640
988,m1312,20131118,3825,3824,3760,3834,3760,3810,3807,-14,-17,68,2589040,642
989,m1312,20131119,3810,3807,3820,3882,3815,3842,3842,35,35,374,14372160,668
990,m1312,20131120,3842,3842,3840,3840,3835,3840,3838,-2,-4,10,383840,666
991,m1312,20131121,3840,3838,3849,3925,3849,3861,3886,23,48,578,22465160,1004
992,m1312,20131122,3861,3886,3860,3895,3860,3895,3886,9,0,12,466360,998
993,m1312,20131125,3895,3886,3936,3936,3880,3895,3897,9,11,20,779480,1004
994,m1312,20131126,3895,3897,3886,3886,3873,3874,3879,-23,-18,58,2249900,1004
995,m1312,20131127,3874,3879,3892,3917,3892,3917,3906,38,27,14,546900,992
996,m1312,20131128,3917,3906,3930,3930,3922,3929,3926,23,20,160,6281800,1004
997,m1312,20131129,3929,3926,3960,3975,3862,3945,3942,19,16,186,7332140,968
998,m1312,20131202,3945,3942,4055,4055,3950,3950,3991,8,49,10,399100,960
999,m1312,20131203,3950,3991,4130,4130,3981,3990,4048,-1,57,52,2105460,946
1000,m1312,20131204,3990,4048,0,0,0,4000,4000,-48,-48,0,0,946
1001,m1312,20131205,4000,4000,0,0,0,4000,4000,0,0,0,0,946
1002,m1312,20131206,4000,4000,3995,3995,3995,3995,3995,-5,-5,180,7191000,946
1003,m1312,20131209,3995,3995,4000,4000,4000,4000,4000,5,5,8,320000,944
1004,m1312,20131210,4000,4000,3980,3980,3980,3980,3980,-20,-20,354,14089200,944
1005,m1312,20131211,3980,3980,4000,4000,4000,4000,4000,20,20,2,80000,2
1006,m1312,20131212,4000,4000,4000,4000,4000,4000,4000,0,0,2,80000,0
1007,m1312,20131213,4000,4000,0,0,0,3990,3990,-10,-10,0,0,0
1008,m1401,20130121,3158,3148,3160,3216,3158,3200,3192,52,44,30562,975675320,40716
1009,m1401,20130122,3200,3192,3200,3210,3172,3185,3182,-7,-10,74228,2362125780,84714
1010,m1401,20130123,3185,3182,3198,3198,3184,3187,3188,5,6,28570,910924360,92262
1011,m1401,20130124,3187,3188,3179,3179,3124,3147,3148,-41,-40,92938,2926082860,125468
1012,m1401,20130125,3147,3148,3165,3179,3163,3163,3173,15,25,32090,1018246360,128266
1013,m1401,20130128,3163,3173,3178,3185,3164,3180,3175,7,2,40162,1275272300,129324
1014,m1401,20130129,3180,3175,3178,3179,3167,3174,3173,-1,-2,27562,874615820,130564
1015,m1401,20130130,3174,3173,3179,3212,3175,3203,3193,30,20,72364,2310654360,124968
1016,m1401,20130131,3203,3193,3216,3240,3204,3212,3214,19,21,90422,2906801480,149820
1017,m1401,20130201,3212,3214,3208,3241,3202,3240,3216,26,2,68954,2217941380,154956
1018,m1401,20130204,3240,3216,3216,3262,3216,3242,3246,26,30,63320,2055662060,170264
1019,m1401,20130205,3242,3246,3249,3265,3235,3242,3250,-4,4,68034,2211452440,169076
1020,m1401,20130206,3242,3250,3248,3258,3235,3239,3250,-11,0,48358,1571701480,168514
1021,m1401,20130207,3239,3250,3235,3235,3215,3223,3221,-27,-29,44040,1418892900,169268
1022,m1401,20130208,3223,3221,3220,3245,3218,3233,3232,12,11,48560,1569847820,159696
1023,m1401,20130218,3233,3232,3132,3156,3123,3146,3143,-86,-89,90636,2848796000,188280
1024,m1401,20130219,3146,3143,3150,3163,3146,3154,3153,11,10,151232,4769717020,265104
1025,m1401,20130220,3154,3153,3165,3188,3161,3174,3172,21,19,134724,4273797460,294094
1026,m1401,20130221,3174,3172,3172,3172,3140,3166,3154,-6,-18,185612,5855712280,325576
1027,m1401,20130222,3166,3154,3176,3275,3160,3223,3229,69,75,525976,16986684360,437034
1028,m1401,20130225,3223,3229,3180,3200,3125,3170,3168,-59,-61,284610,9019217500,433298
1029,m1401,20130226,3170,3168,3168,3208,3156,3162,3178,-6,10,315214,10019158980,380518
1030,m1401,20130227,3162,3178,3179,3190,3163,3171,3174,-7,-4,159720,5071027140,390036
1031,m1401,20130228,3171,3174,3182,3191,3160,3165,3175,-9,1,169584,5384615940,406476
1032,m1401,20130301,3165,3175,3179,3197,3170,3194,3183,19,8,191690,6103301880,390478
1033,m1401,20130304,3194,3183,3186,3205,3180,3184,3193,1,10,132072,4217314700,378316
1034,m1401,20130305,3184,3193,3198,3215,3195,3205,3205,12,12,179598,5757751580,394084
1035,m1401,20130306,3205,3205,3205,3208,3181,3195,3194,-10,-11,125852,4019905160,399906
1036,m1401,20130307,3195,3194,3192,3200,3188,3196,3195,2,1,85476,2731388040,383862
1037,m1401,20130308,3196,3195,3200,3220,3200,3207,3207,12,12,129756,4162280860,410836
1038,m1401,20130311,3207,3207,3207,3210,3175,3176,3190,-31,-17,189506,6045334120,462378
1039,m1401,20130312,3176,3190,3186,3187,3140,3143,3156,-47,-34,190258,6004828580,464546
1040,m1401,20130313,3143,3156,3153,3165,3132,3151,3148,-5,-8,195266,6147500480,445160
1041,m1401,20130314,3151,3148,3130,3150,3122,3136,3134,-12,-14,220028,6896738260,427686
1042,m1401,20130315,3136,3134,3150,3164,3144,3153,3153,19,19,177962,5611165820,414246
1043,m1401,20130318,3153,3153,3130,3130,3080,3102,3105,-51,-48,231774,7197629220,444756
1044,m1401,20130319,3102,3105,3115,3120,3106,3113,3110,8,5,99726,3102222880,447290
1045,m1401,20130320,3113,3110,3110,3127,3107,3125,3120,15,10,192090,5994223380,470716
1046,m1401,20130321,3125,3120,3129,3149,3129,3138,3138,18,18,170932,5363972100,460850
1047,m1401,20130322,3138,3138,3146,3148,3135,3140,3141,2,3,115620,3632267820,453340
1048,m1401,20130325,3140,3141,3140,3145,3122,3131,3134,-10,-7,101432,3179824240,458982
1049,m1401,20130326,3131,3134,3140,3147,3134,3143,3139,9,5,76944,2415922920,441128
1050,m1401,20130327,3143,3139,3150,3153,3135,3144,3141,5,2,89690,2817857620,440930
1051,m1401,20130328,3144,3141,3149,3155,3125,3130,3138,-11,-3,139728,4385133300,411262
1052,m1401,20130329,3130,3138,3090,3107,3068,3103,3095,-35,-43,263362,8152189060,422558
1053,m1401,20130401,3103,3095,3098,3115,3090,3096,3100,1,5,197884,6135134840,419566
1054,m1401,20130402,3096,3100,3101,3118,3087,3111,3106,11,6,161456,5016436800,424888
1055,m1401,20130403,3111,3106,3090,3090,3040,3049,3065,-57,-41,349636,10718444440,477048
1056,m1401,20130408,3049,3065,3008,3031,2988,3029,3013,-36,-52,303466,9143447000,500936
1057,m1401,20130409,3029,3013,3024,3055,3020,3023,3036,10,23,265672,8067289520,516948
1058,m1401,20130410,3023,3036,3036,3041,3028,3036,3034,0,-2,196858,5973804680,535820
1059,m1401,20130411,3036,3034,3019,3035,3012,3028,3023,-6,-11,203788,6162516040,533204
1060,m1401,20130412,3028,3023,3035,3052,3024,3051,3038,28,15,207756,6312838640,503862
1061,m1401,20130415,3051,3038,3030,3036,2996,3014,3013,-24,-25,331218,9981605980,538652
1062,m1401,20130416,3014,3013,2973,3004,2958,3002,2986,-11,-27,474892,14184552280,542342
1063,m1401,20130417,3002,2986,3012,3024,2996,3012,3009,26,23,261028,7856597960,532686
1064,m1401,20130418,3012,3009,3000,3038,2990,3033,3016,24,7,455126,13730788340,582144
1065,m1401,20130419,3033,3016,3035,3059,3031,3035,3044,19,28,342468,10427525400,579696
1066,m1401,20130422,3035,3044,3020,3027,3002,3006,3016,-38,-28,311322,9389636900,588780
1067,m1401,20130423,3006,3016,3001,3017,2990,3001,3003,-15,-13,411296,12353107200,660500
1068,m1401,20130424,3001,3003,2990,2994,2928,2938,2954,-65,-49,869126,25675235240,806130
1069,m1401,20130425,2938,2954,2942,2965,2932,2949,2950,-5,-4,524508,15476005120,758378
1070,m1401,20130426,2949,2950,2973,2985,2958,2966,2973,16,23,423258,12584037700,698782
1071,m1401,20130502,2966,2973,2959,3008,2952,3006,2989,33,16,532510,15919750040,718256
1072,m1401,20130503,3006,2989,2994,3011,2987,2996,3000,7,11,490318,14710490580,762188
1073,m1401,20130506,2996,3000,3000,3025,2977,3022,3009,22,9,704296,21192919980,706004
1074,m1401,20130507,3022,3009,3002,3020,2997,3015,3010,6,1,468672,14110162900,743024
1075,m1401,20130508,3015,3010,3016,3050,3014,3042,3036,32,26,519758,15780898760,751298
1076,m1401,20130509,3042,3036,3030,3039,3019,3034,3027,-2,-9,366844,11106374280,768842
1077,m1401,20130510,3034,3027,3050,3059,3035,3042,3042,15,15,393250,11963197480,795834
1078,m1401,20130513,3042,3042,3021,3033,2984,2984,3009,-58,-33,842874,25366887900,928002
1079,m1401,20130514,2984,3009,3005,3014,2988,3000,3001,-9,-8,731354,21951832080,941488
1080,m1401,20130515,3000,3001,3000,3008,2982,2992,2995,-9,-6,512782,15361238580,868942
1081,m1401,20130516,2992,2995,2985,3012,2962,2999,2987,4,-8,783558,23410658400,888324
1082,m1401,20130517,2999,2987,3015,3025,3009,3013,3017,26,30,476466,14375019960,853410
1083,m1401,20130520,3013,3017,3031,3050,3022,3036,3036,19,19,649974,19733255200,888728
1084,m1401,20130521,3036,3036,3035,3045,3007,3018,3028,-18,-8,623376,18877373880,949898
1085,m1401,20130522,3018,3028,3021,3028,3006,3024,3019,-4,-9,495670,14966279520,984484
1086,m1401,20130523,3024,3019,3050,3053,3024,3025,3035,6,16,565616,17169994020,913214
1087,m1401,20130524,3025,3035,3024,3034,3016,3027,3027,-8,-8,355868,10772565080,945190
1088,m1401,20130527,3027,3027,3022,3052,3015,3040,3040,13,13,658104,20012063540,962198
1089,m1401,20130528,3040,3040,3045,3066,3040,3065,3050,25,10,528774,16132640380,1013976
1090,m1401,20130529,3065,3050,3100,3172,3092,3154,3149,104,99,2410988,75928873960,1174676
1091,m1401,20130530,3154,3149,3171,3199,3156,3192,3183,43,34,2057378,65498061560,1382028
1092,m1401,20130531,3192,3183,3201,3211,3188,3210,3200,27,17,1489166,47659367600,1352560
1093,m1401,20130603,3210,3200,3230,3307,3230,3293,3281,93,81,3057502,1.00342E+11,1554684
1094,m1401,20130604,3293,3281,3296,3296,3221,3236,3251,-45,-30,2296978,74688799900,1265324
1095,m1401,20130605,3236,3251,3242,3280,3230,3266,3261,15,10,2399618,78267004960,1292534
1096,m1401,20130606,3266,3261,3222,3246,3202,3227,3226,-34,-35,1846868,59582364700,1318482
1097,m1401,20130607,3227,3226,3246,3254,3217,3233,3232,7,6,1263910,40854304040,1240058
1098,m1401,20130613,3233,3232,3239,3244,3202,3216,3218,-16,-14,1013164,32609096280,1197192
1099,m1401,20130614,3216,3218,3200,3238,3182,3238,3211,20,-7,1507298,48403112080,1380502
1100,m1401,20130617,3238,3211,3192,3233,3174,3214,3205,3,-6,2431918,77956952200,1517136
1101,m1401,20130618,3214,3205,3222,3250,3213,3220,3231,15,26,2026932,65492203040,1521864
1102,m1401,20130619,3220,3231,3210,3226,3201,3210,3214,-21,-17,1295616,41641619860,1487124
1103,m1401,20130620,3210,3214,3232,3239,3210,3217,3224,3,10,1547916,49913973400,1479880
1104,m1401,20130621,3217,3224,3182,3203,3138,3139,3168,-85,-56,2335446,73998026600,1412386
1105,m1401,20130624,3139,3168,3121,3141,3102,3114,3118,-54,-50,1652830,51537037500,1296800
1106,m1401,20130625,3114,3118,3150,3165,3132,3161,3147,43,29,1889610,59477306340,1311468
1107,m1401,20130626,3161,3147,3159,3168,3139,3150,3153,3,6,1422790,44867211680,1350788
1108,m1401,20130627,3150,3153,3150,3190,3142,3178,3169,25,16,1727662,54762669160,1434150
1109,m1401,20130628,3178,3169,3170,3190,3145,3154,3162,-15,-7,1611074,50955237120,1371608
1110,m1401,20130701,3154,3162,3100,3124,3092,3115,3113,-47,-49,1507396,46935358220,1472060
1111,m1401,20130702,3115,3113,3094,3147,3091,3139,3125,26,12,1769924,55314285960,1544374
1112,m1401,20130703,3139,3125,3135,3177,3132,3172,3154,47,29,1426288,44991350520,1584592
1113,m1401,20130704,3172,3154,3166,3184,3159,3166,3171,12,17,1130046,35840671260,1584614
1114,m1401,20130705,3166,3171,3164,3187,3160,3181,3175,10,4,1092752,34702344280,1536590
1115,m1401,20130708,3181,3175,3150,3161,3120,3140,3138,-35,-37,1431860,44933344780,1546834
1116,m1401,20130709,3140,3138,3181,3243,3179,3234,3217,96,79,2673788,86030386180,1755090
1117,m1401,20130710,3234,3217,3258,3267,3226,3241,3243,24,26,2010824,65230692340,1654576
1118,m1401,20130711,3241,3243,3255,3264,3231,3252,3250,9,7,1482864,48197511680,1620680
1119,m1401,20130712,3252,3250,3268,3294,3254,3254,3270,4,20,1818722,59489233640,1694358
1120,m1401,20130715,3254,3270,3209,3231,3200,3230,3218,-40,-52,1205818,38813016760,1648292
1121,m1401,20130716,3230,3218,3254,3268,3236,3267,3251,49,33,1290798,41972455740,1653180
1122,m1401,20130717,3267,3251,3296,3298,3270,3271,3283,20,32,1462286,48018347880,1625392
1123,m1401,20130718,3271,3283,3250,3297,3249,3295,3271,12,-12,1287182,42107117180,1727714
1124,m1401,20130719,3295,3271,3280,3292,3257,3259,3277,-12,6,1829150,59953790120,1664694
1125,m1401,20130722,3259,3277,3273,3284,3235,3245,3252,-32,-25,1526234,49635495820,1658868
1126,m1401,20130723,3245,3252,3279,3328,3261,3324,3300,72,48,2480026,81856981100,1855276
1127,m1401,20130724,3324,3300,3285,3305,3272,3289,3288,-11,-12,2241770,73714406040,1810058
1128,m1401,20130725,3289,3288,3270,3277,3245,3262,3260,-26,-28,1463340,47715030740,1869228
1129,m1401,20130726,3262,3260,3200,3207,3135,3156,3168,-104,-92,3011344,95422507140,1796364
1130,m1401,20130729,3156,3168,3160,3164,3135,3155,3151,-13,-17,1521494,47944479420,1758682
1131,m1401,20130730,3155,3151,3169,3175,3146,3158,3162,7,11,1274182,40294996640,1742076
1132,m1401,20130731,3158,3162,3120,3150,3107,3148,3134,-14,-28,1405364,44044772980,1736366
1133,m1401,20130801,3148,3134,3142,3170,3140,3169,3157,35,23,1278242,40361211500,1743246
1134,m1401,20130802,3169,3157,3149,3157,3137,3144,3146,-13,-11,1239374,39000073380,1810426
1135,m1401,20130805,3144,3146,3123,3140,3115,3136,3129,-10,-17,1055900,33049648300,1832574
1136,m1401,20130806,3136,3129,3125,3150,3113,3148,3132,19,3,1527666,47855270820,1942894
1137,m1401,20130807,3148,3132,3136,3140,3116,3125,3129,-7,-3,1521128,47597191400,1931368
1138,m1401,20130808,3125,3129,3132,3167,3130,3154,3153,25,24,1444490,45554900380,1852524
1139,m1401,20130809,3154,3153,3174,3201,3171,3180,3187,27,34,1566166,49919965960,1826218
1140,m1401,20130812,3180,3187,3176,3207,3175,3206,3193,19,6,1053708,33653528760,1875210
1141,m1401,20130813,3206,3193,3260,3295,3260,3282,3278,89,85,1429252,46861284360,1822162
1142,m1401,20130814,3282,3278,3277,3295,3264,3266,3277,-12,-1,1073100,35173700200,1835844
1143,m1401,20130815,3266,3277,3298,3367,3297,3319,3333,42,56,2744398,91498155320,1830736
1144,m1401,20130816,3319,3333,3366,3394,3346,3356,3368,23,35,1718362,57878127160,1784218
1145,m1401,20130819,3356,3368,3400,3411,3382,3394,3394,26,26,1287804,43712499000,1783092
1146,m1401,20130820,3394,3394,3444,3454,3386,3409,3413,15,19,2104168,71832669220,1859676
1147,m1401,20130821,3409,3413,3402,3418,3390,3408,3405,-5,-8,1275442,43438078060,1905508
1148,m1401,20130822,3408,3405,3410,3444,3405,3439,3421,34,16,1718290,58788279500,1977058
1149,m1401,20130823,3439,3421,3429,3433,3408,3423,3419,2,-2,1183956,40489290080,1849642
1150,m1401,20130826,3423,3419,3555,3555,3541,3555,3554,136,135,417638,14843139220,1758352
1151,m1401,20130827,3555,3554,3620,3677,3610,3676,3646,122,92,2755632,1.00476E+11,1801248
1152,m1401,20130828,3676,3646,3660,3686,3647,3649,3664,3,18,2106982,77213523380,1767250
1153,m1401,20130829,3649,3664,3670,3673,3561,3622,3630,-42,-34,2706444,98270695200,1676816
1154,m1401,20130830,3622,3630,3599,3605,3523,3556,3555,-74,-75,2855704,1.01527E+11,1560306
1155,m1401,20130902,3556,3555,3560,3660,3560,3658,3627,103,72,2061058,74764521620,1774198
1156,m1401,20130903,3658,3627,3679,3686,3612,3649,3642,22,15,2340474,85254321940,1776470
1157,m1401,20130904,3649,3642,3612,3619,3576,3609,3598,-33,-44,2526334,90922731500,1695862
1158,m1401,20130905,3609,3598,3585,3628,3563,3582,3590,-16,-8,2720732,97698284360,1745302
1159,m1401,20130906,3582,3590,3618,3655,3609,3652,3627,62,37,2381752,86392017460,1907226
1160,m1401,20130909,3652,3627,3658,3678,3621,3636,3645,9,18,2221350,80976669100,1889230
1161,m1401,20130910,3636,3645,3590,3615,3578,3581,3593,-64,-52,2166878,77863238840,1888240
1162,m1401,20130911,3581,3593,3606,3635,3574,3633,3604,40,11,2231024,80417204020,1979726
1163,m1401,20130912,3633,3604,3636,3658,3617,3628,3635,24,31,2785280,1.01245E+11,1969772
1164,m1401,20130913,3628,3635,3720,3738,3695,3723,3718,88,83,3105310,1.15472E+11,2196810
1165,m1401,20130916,3723,3718,3675,3678,3625,3633,3651,-85,-67,1979280,72275181680,1945660
1166,m1401,20130917,3633,3651,3611,3634,3593,3633,3617,-18,-34,1751822,63368089140,1966138
1167,m1401,20130918,3633,3617,3605,3639,3605,3629,3621,12,4,1319340,47782004620,1965692
1168,m1401,20130923,3629,3621,3560,3597,3550,3585,3579,-36,-42,1308930,46852932660,1931944
1169,m1401,20130924,3585,3579,3605,3631,3594,3630,3620,51,41,1501870,54369770220,2033188
1170,m1401,20130925,3630,3620,3631,3669,3621,3648,3645,28,25,1354434,49372943940,2013698
1171,m1401,20130926,3648,3645,3658,3673,3642,3659,3656,14,11,1156164,42276269880,1906400
1172,m1401,20130927,3659,3656,3656,3700,3648,3692,3681,36,25,1579366,58143822360,1918248
1173,m1401,20130930,3692,3681,3685,3716,3675,3711,3694,30,13,1047114,38686773760,1893454
1174,m1401,20131008,3711,3694,3720,3782,3718,3757,3764,63,70,1288402,48498661040,1978884
1175,m1401,20131009,3757,3764,3731,3765,3723,3752,3745,-12,-19,1325932,49667922420,2043322
1176,m1401,20131010,3752,3745,3755,3771,3708,3710,3741,-35,-4,1422488,53224039760,1930596
1177,m1401,20131011,3710,3741,3699,3706,3653,3655,3678,-86,-63,1510140,55547661200,1882952
1178,m1401,20131014,3655,3678,3633,3660,3628,3631,3641,-47,-37,1302642,47434013320,1812564
1179,m1401,20131015,3631,3641,3643,3653,3605,3618,3629,-23,-12,1308664,47496341040,1842460
1180,m1401,20131016,3618,3629,3619,3631,3592,3624,3614,-5,-15,1426140,51544678940,1829476
1181,m1401,20131017,3624,3614,3642,3654,3564,3596,3601,-18,-13,1564154,56339103960,1763608
1182,m1401,20131018,3596,3601,3622,3636,3607,3625,3622,24,21,1053664,38164634720,1696530
1183,m1401,20131021,3625,3622,3630,3630,3581,3614,3600,-8,-22,1107318,39867359360,1660130
1184,m1401,20131022,3614,3600,3618,3626,3588,3589,3607,-11,7,860250,31037332200,1620984
1185,m1401,20131023,3589,3607,3594,3619,3573,3611,3598,4,-9,847780,30510588060,1582270
1186,m1401,20131024,3611,3598,3630,3640,3600,3638,3618,40,20,669332,24221404620,1564316
1187,m1401,20131025,3638,3618,3625,3653,3603,3608,3629,-10,11,949742,34470752380,1490208
1188,m1401,20131028,3608,3629,3600,3604,3544,3580,3566,-49,-63,1317712,46996553280,1529416
1189,m1401,20131029,3580,3566,3545,3576,3544,3573,3562,7,-4,792872,28246936460,1468418
1190,m1401,20131030,3573,3562,3575,3590,3549,3554,3567,-8,5,939902,33534948880,1403842
1191,m1401,20131031,3554,3567,3545,3568,3536,3555,3550,-12,-17,746818,26515006920,1350752
1192,m1401,20131101,3555,3550,3535,3558,3532,3555,3548,5,-2,412298,14631190760,1316398
1193,m1401,20131104,3555,3548,3535,3566,3526,3555,3545,7,-3,715642,25373194260,1318126
1194,m1401,20131105,3555,3545,3560,3575,3540,3563,3558,18,13,544166,19362969060,1263950
1195,m1401,20131106,3563,3558,3543,3591,3543,3586,3573,28,15,711912,25442359420,1346240
1196,m1401,20131107,3586,3573,3591,3597,3563,3568,3579,-5,6,520202,18622607940,1278436
1197,m1401,20131108,3568,3579,3587,3587,3556,3561,3570,-18,-9,469822,16777160220,1213980
1198,m1401,20131111,3561,3570,3618,3629,3602,3606,3613,36,43,628084,22695639440,1118118
1199,m1401,20131112,3606,3613,3612,3645,3608,3643,3628,30,15,640154,23225294440,1168834
1200,m1401,20131113,3643,3628,3639,3673,3639,3659,3660,31,32,725260,26549380380,1097662
1201,m1401,20131114,3659,3660,3655,3668,3642,3651,3654,-9,-6,438928,16042104560,1007620
1202,m1401,20131115,3651,3654,3657,3678,3648,3663,3662,9,8,474170,17366926060,999152
1203,m1401,20131118,3663,3662,3630,3634,3610,3617,3621,-45,-41,401118,14525164780,944906
1204,m1401,20131119,3617,3621,3629,3630,3612,3612,3622,-9,1,191810,6948446160,911940
1205,m1401,20131120,3612,3622,3609,3617,3601,3615,3609,-7,-13,195618,7059924640,886784
1206,m1401,20131121,3615,3609,3615,3627,3611,3626,3621,17,12,239974,8690171200,833678
1207,m1401,20131122,3626,3621,3636,3669,3635,3660,3656,39,35,355982,13017740820,829118
1208,m1401,20131125,3660,3656,3698,3698,3670,3671,3681,15,25,246214,9063503000,791574
1209,m1401,20131126,3671,3681,3690,3696,3674,3676,3683,-5,2,200938,7400636500,780660
1210,m1401,20131127,3676,3683,3690,3712,3671,3707,3700,24,17,412254,15256627960,748438
1211,m1401,20131128,3707,3700,3703,3709,3691,3705,3700,5,0,158628,5869769280,745714
1212,m1401,20131129,3705,3700,3700,3728,3700,3725,3719,25,19,251616,9358965520,720282
1213,m1401,20131202,3725,3719,3730,3750,3729,3744,3743,25,24,219624,8222333460,675816
1214,m1401,20131203,3744,3743,3728,3738,3715,3722,3727,-21,-16,195860,7299816920,654172
1215,m1401,20131204,3722,3727,3728,3739,3722,3729,3732,2,5,116200,4337372700,630146
1216,m1401,20131205,3729,3732,3732,3740,3726,3730,3733,-2,1,117124,4372943200,585000
1217,m1401,20131206,3730,3733,3730,3736,3705,3720,3718,-13,-15,111146,4133422860,569360
1218,m1401,20131209,3720,3718,3718,3756,3718,3753,3741,35,23,131316,4912739280,541168
1219,m1401,20131210,3753,3741,3763,3774,3748,3749,3761,8,20,108978,4099577580,503646
1220,m1401,20131211,3749,3761,3745,3762,3740,3759,3753,-2,-8,78438,2944063500,477236
1221,m1401,20131212,3759,3753,3760,3767,3730,3734,3745,-19,-8,175794,6584572480,382278
1222,m1401,20131213,3734,3745,3720,3720,3701,3714,3708,-31,-37,135486,5024992980,307372
1223,m1401,20131216,3714,3708,3719,3738,3717,3733,3730,25,22,60752,2266645720,285052
1224,m1401,20131217,3733,3730,3743,3773,3739,3765,3760,35,30,117466,4417041640,243830
1225,m1401,20131218,3765,3760,3776,3787,3765,3771,3773,11,13,52392,1976770540,229700
1226,m1401,20131219,3771,3773,3749,3769,3749,3769,3762,-4,-11,49626,1867294760,201164
1227,m1401,20131220,3769,3762,3772,3773,3756,3766,3764,4,2,45444,1710848920,178004
1228,m1401,20131223,3766,3764,3768,3770,3760,3762,3764,-2,0,50614,1905522500,145320
1229,m1401,20131224,3762,3764,3750,3760,3710,3729,3734,-35,-30,62306,2327122840,111594
1230,m1401,20131225,3729,3734,3731,3741,3716,3740,3730,6,-4,32850,1225365940,93046
1231,m1401,20131226,3740,3730,3745,3755,3739,3745,3747,15,17,28254,1058690740,72972
1232,m1401,20131227,3745,3747,3735,3740,3721,3738,3733,-9,-14,18286,682792200,57530
1233,m1401,20131230,3738,3733,3740,3740,3716,3720,3725,-13,-8,37380,1392536400,28324
1234,m1401,20131231,3720,3725,3711,3735,3711,3726,3722,1,-3,20530,764300280,12176
1235,m1403,20130318,3162,3169,3135,3150,3112,3118,3120,-51,-49,72,2246980,54
1236,m1403,20130319,3118,3120,3049,3122,3049,3113,3108,-7,-12,18,559500,62
1237,m1403,20130320,3113,3108,3126,3126,3080,3123,3118,15,10,160,4989000,54
1238,m1403,20130321,3123,3118,3133,3144,3132,3132,3137,14,19,46,1443180,54
1239,m1403,20130322,3132,3137,3132,3143,3132,3142,3139,5,2,62,1946240,72
1240,m1403,20130325,3142,3139,3143,3143,3134,3134,3138,-5,-1,12,376660,76
1241,m1403,20130326,3134,3138,3110,3149,3110,3139,3134,1,-4,26,814900,82
1242,m1403,20130327,3139,3134,3145,3147,3138,3144,3143,10,9,26,817220,92
1243,m1403,20130328,3144,3143,3146,3150,3128,3133,3142,-10,-1,48,1508480,94
1244,m1403,20130329,3133,3142,3077,3122,3068,3105,3103,-37,-39,34,1055040,110
1245,m1403,20130401,3105,3103,3088,3114,3088,3094,3093,-9,-10,30,927940,92
1246,m1403,20130402,3094,3093,3115,3120,3099,3114,3109,21,16,42,1305820,84
1247,m1403,20130403,3114,3109,3090,3090,3055,3055,3072,-54,-37,112,3441580,156
1248,m1403,20130408,3055,3072,3025,3041,3006,3039,3029,-33,-43,134,4059640,246
1249,m1403,20130409,3039,3029,3043,3061,3040,3040,3050,11,21,104,3172620,284
1250,m1403,20130410,3040,3050,3050,3055,3040,3050,3047,0,-3,78,2376660,272
1251,m1403,20130411,3050,3047,3032,3041,3022,3030,3029,-17,-18,172,5211140,232
1252,m1403,20130412,3030,3029,3032,3050,3032,3050,3040,21,11,124,3770600,224
1253,m1403,20130415,3050,3040,3027,3029,3012,3020,3020,-20,-20,166,5013880,278
1254,m1403,20130416,3020,3020,2992,3012,2973,3010,2996,-10,-24,114,3416100,290
1255,m1403,20130417,3010,2996,3028,3032,3013,3015,3024,19,28,146,4415720,320
1256,m1403,20130418,3015,3024,3009,3045,3000,3039,3024,15,0,252,7621660,348
1257,m1403,20130419,3039,3024,3050,3063,3050,3050,3058,26,34,154,4709460,368
1258,m1403,20130422,3050,3058,3021,3038,3018,3020,3024,-38,-34,76,2298500,364
1259,m1403,20130423,3020,3024,3023,3028,3004,3014,3016,-10,-8,188,5670700,460
1260,m1403,20130424,3014,3016,3006,3015,2950,2961,2972,-55,-44,188,5587500,472
1261,m1403,20130425,2961,2972,2957,2984,2957,2975,2973,3,1,82,2438320,458
1262,m1403,20130426,2975,2973,2980,2992,2980,2982,2986,9,13,30,895820,446
1263,m1403,20130502,2982,2986,2982,3015,2974,3005,2999,19,13,66,1979860,450
1264,m1403,20130503,3005,2999,3012,3018,3003,3008,3010,9,11,96,2889940,462
1265,m1403,20130506,3008,3010,3012,3030,2989,3029,3016,19,6,98,2956060,460
1266,m1403,20130507,3029,3016,3005,3025,3005,3021,3016,5,0,20,603280,452
1267,m1403,20130508,3021,3016,3028,3052,3028,3050,3047,34,31,84,2560060,480
1268,m1403,20130509,3050,3047,3042,3043,3028,3036,3036,-11,-11,44,1335880,482
1269,m1403,20130510,3036,3036,3058,3058,3046,3050,3048,14,12,34,1036620,476
1270,m1403,20130513,3050,3048,3039,3048,3000,3000,3018,-48,-30,172,5191180,580
1271,m1403,20130514,3000,3018,3019,3027,3012,3018,3018,0,0,312,9418640,810
1272,m1403,20130515,3018,3018,3023,3023,2993,3013,3010,-5,-8,206,6201740,852
1273,m1403,20130516,3013,3010,3003,3013,2984,3009,2998,-1,-12,552,16552700,886
1274,m1403,20130517,3009,2998,3028,3029,3013,3020,3024,22,26,80,2419960,842
1275,m1403,20130520,3020,3024,3035,3053,3033,3040,3043,16,19,82,2495340,824
1276,m1403,20130521,3040,3043,3040,3047,3015,3020,3036,-23,-7,64,1943320,842
1277,m1403,20130522,3020,3036,3017,3032,3015,3019,3022,-17,-14,122,3687680,828
1278,m1403,20130523,3019,3022,3044,3046,3029,3029,3040,7,18,42,1277200,832
1279,m1403,20130524,3029,3040,3030,3034,3026,3026,3029,-14,-11,24,727120,826
1280,m1403,20130527,3026,3029,3039,3048,3039,3041,3043,12,14,36,1095780,814
1281,m1403,20130528,3041,3043,3047,3070,3044,3070,3053,27,10,70,2137560,818
1282,m1403,20130529,3070,3053,3090,3175,3090,3143,3156,90,103,226,7133060,852
1283,m1403,20130530,3143,3156,3154,3187,3154,3182,3164,26,8,102,3228080,810
1284,m1403,20130531,3182,3164,3177,3186,3176,3185,3181,21,17,46,1463420,818
1285,m1403,20130603,3185,3181,3291,3291,3265,3280,3277,99,96,112,3670980,812
1286,m1403,20130604,3280,3277,3275,3275,3215,3223,3235,-54,-42,270,8736640,788
1287,m1403,20130605,3223,3235,3240,3267,3224,3254,3253,19,18,154,5010720,800
1288,m1403,20130606,3254,3253,3223,3233,3190,3213,3214,-40,-39,166,5335580,786
1289,m1403,20130607,3213,3214,3228,3237,3205,3205,3221,-9,7,212,6830380,788
1290,m1403,20130613,3205,3221,3212,3212,3195,3200,3204,-21,-17,44,1410040,786
1291,m1403,20130614,3200,3204,3181,3211,3181,3210,3199,6,-5,30,959780,780
1292,m1403,20130617,3210,3199,3195,3199,3163,3197,3181,-2,-18,220,6998360,738
1293,m1403,20130618,3197,3181,3182,3214,3182,3194,3200,13,19,34,1088140,744
1294,m1403,20130619,3194,3200,3196,3197,3180,3180,3188,-20,-12,74,2359840,722
1295,m1403,20130620,3180,3188,3199,3203,3177,3177,3185,-11,-3,54,1719920,716
1296,m1403,20130621,3177,3185,3143,3171,3118,3118,3143,-67,-42,200,6287400,666
1297,m1403,20130624,3118,3143,3098,3110,3084,3084,3097,-59,-46,66,2044360,648
1298,m1403,20130625,3084,3097,3135,3135,3118,3123,3124,26,27,72,2249420,626
1299,m1403,20130626,3123,3124,3135,3143,3123,3124,3126,0,2,60,1876060,638
1300,m1403,20130627,3124,3126,3130,3170,3100,3168,3135,42,9,564,17681640,740
1301,m1403,20130628,3168,3135,3156,3156,3115,3115,3133,-20,-2,152,4763020,698
1302,m1403,20130701,3115,3133,3096,3100,3085,3096,3092,-37,-41,98,3030340,708
1303,m1403,20130702,3096,3092,3100,3112,3084,3112,3102,20,10,120,3722460,650
1304,m1403,20130703,3112,3102,3113,3141,3103,3138,3120,36,18,58,1809760,642
1305,m1403,20130704,3138,3120,3135,3145,3131,3131,3136,11,16,42,1317400,638
1306,m1403,20130705,3131,3136,3149,3149,3149,3149,3149,13,13,2,62980,636
1307,m1403,20130708,3149,3149,3119,3120,3103,3111,3111,-38,-38,36,1120300,648
1308,m1403,20130709,3111,3111,3149,3210,3149,3201,3186,90,75,48,1529400,646
1309,m1403,20130710,3201,3186,3216,3216,3200,3209,3207,23,21,16,513240,640
1310,m1403,20130711,3209,3207,3227,3232,3206,3218,3219,11,12,32,1030360,640
1311,m1403,20130712,3218,3219,3250,3250,3226,3227,3235,8,16,54,1747000,640
1312,m1403,20130715,3227,3235,3185,3205,3182,3193,3191,-42,-44,66,2106520,640
1313,m1403,20130716,3193,3191,3221,3237,3213,3237,3224,46,33,52,1676540,654
1314,m1403,20130717,3237,3224,3241,3273,3226,3238,3244,14,20,182,5904820,708
1315,m1403,20130718,3238,3244,3221,3237,3221,3227,3226,-17,-18,30,967860,694
1316,m1403,20130719,3227,3226,3223,3247,3221,3221,3233,-5,7,80,2586440,702
1317,m1403,20130722,3221,3233,3219,3226,3201,3202,3211,-31,-22,44,1412860,700
1318,m1403,20130723,3202,3211,3221,3281,3221,3276,3265,65,54,146,4768080,698
1319,m1403,20130724,3276,3265,3243,3258,3236,3243,3245,-22,-20,94,3050880,672
1320,m1403,20130725,3243,3245,3217,3232,3215,3220,3224,-25,-21,158,5094820,676
1321,m1403,20130726,3220,3224,3151,3156,3108,3109,3128,-115,-96,90,2815660,688
1322,m1403,20130729,3109,3128,3115,3128,3104,3114,3113,-14,-15,28,871720,698
1323,m1403,20130730,3114,3113,3128,3131,3106,3121,3123,8,10,58,1811400,668
1324,m1403,20130731,3121,3123,3119,3119,3093,3111,3107,-12,-16,28,870140,654
1325,m1403,20130801,3111,3107,3112,3132,3112,3125,3122,18,15,10,312280,650
1326,m1403,20130802,3125,3122,3116,3121,3107,3107,3115,-15,-7,24,747820,648
1327,m1403,20130805,3107,3115,3085,3113,3085,3102,3096,-13,-19,28,867080,648
1328,m1403,20130806,3102,3096,3076,3102,3076,3102,3082,6,-14,16,493160,642
1329,m1403,20130807,3102,3082,3130,3131,3082,3083,3096,1,14,120,3716300,666
1330,m1403,20130808,3083,3096,3103,3111,3092,3105,3103,9,7,20,620660,666
1331,m1403,20130809,3105,3103,3126,3174,3110,3174,3157,71,54,128,4041860,750
1332,m1403,20130812,3174,3157,3174,3174,3130,3139,3136,-18,-21,198,6211060,674
1333,m1403,20130813,3139,3136,3146,3200,3146,3193,3184,57,48,82,2611680,644
1334,m1403,20130814,3193,3184,3182,3195,3150,3180,3184,-4,0,68,2165540,632
1335,m1403,20130815,3180,3184,3237,3245,3200,3212,3225,28,41,190,6128700,594
1336,m1403,20130816,3212,3225,3230,3291,3230,3253,3263,28,38,122,3981820,582
1337,m1403,20130819,3253,3263,3286,3393,3275,3297,3312,34,49,578,19145180,746
1338,m1403,20130820,3297,3312,3312,3335,3281,3282,3304,-30,-8,296,9782520,646
1339,m1403,20130821,3282,3304,3223,3285,3223,3282,3268,-22,-36,50,1634340,644
1340,m1403,20130822,3282,3268,3273,3302,3273,3296,3287,28,19,74,2432860,624
1341,m1403,20130823,3296,3287,3283,3290,3276,3288,3285,1,-2,30,985580,624
1342,m1403,20130826,3288,3285,3352,3416,3352,3416,3411,131,126,226,7709820,786
1343,m1403,20130827,3416,3411,3461,3499,3431,3473,3462,62,51,360,12465060,602
1344,m1403,20130828,3473,3462,3430,3516,3430,3473,3492,11,30,396,13830060,672
1345,m1403,20130829,3473,3492,3449,3486,3438,3441,3456,-51,-36,118,4078160,650
1346,m1403,20130830,3441,3456,3417,3476,3369,3377,3396,-79,-60,262,8897720,644
1347,m1403,20130902,3377,3396,3397,3483,3397,3465,3443,69,47,86,2961380,612
1348,m1403,20130903,3465,3443,3474,3479,3436,3471,3465,28,22,226,7831260,646
1349,m1403,20130904,3471,3465,3426,3437,3410,3430,3418,-35,-47,106,3624080,642
1350,m1403,20130905,3430,3418,3457,3457,3411,3420,3423,2,5,338,11572400,898
1351,m1403,20130906,3420,3423,3465,3494,3423,3494,3458,71,35,72,2490360,898
1352,m1403,20130909,3494,3458,3499,3499,3466,3466,3477,8,19,196,6816060,864
1353,m1403,20130910,3466,3477,3439,3462,3436,3436,3448,-41,-29,312,10760700,962
1354,m1403,20130911,3436,3448,3459,3494,3445,3494,3462,46,14,234,8103220,954
1355,m1403,20130912,3494,3462,3473,3489,3468,3472,3478,10,16,206,7164680,910
1356,m1403,20130913,3472,3478,3524,3555,3524,3548,3544,70,66,214,7584160,926
1357,m1403,20130916,3548,3544,3529,3529,3470,3475,3499,-69,-45,114,3989560,924
1358,m1403,20130917,3475,3499,3466,3470,3450,3456,3459,-43,-40,46,1591480,920
1359,m1403,20130918,3456,3459,3451,3465,3451,3461,3459,2,0,20,691980,922
1360,m1403,20130923,3461,3459,3406,3432,3406,3427,3423,-32,-36,34,1163880,928
1361,m1403,20130924,3427,3423,3438,3466,3438,3465,3461,42,38,86,2976620,928
1362,m1403,20130925,3465,3461,3467,3482,3461,3469,3467,8,6,44,1525660,922
1363,m1403,20130926,3469,3467,3473,3480,3463,3472,3468,5,1,24,832440,916
1364,m1403,20130927,3472,3468,3472,3488,3470,3488,3475,20,7,36,1251220,916
1365,m1403,20130930,3488,3475,3487,3516,3487,3516,3494,41,19,8,279560,912
1366,m1403,20131008,3516,3494,3569,3569,3550,3550,3563,56,69,40,1425260,918
1367,m1403,20131009,3550,3563,3548,3584,3545,3580,3560,17,-3,66,2349940,950
1368,m1403,20131010,3580,3560,3595,3624,3562,3579,3601,19,41,214,7707780,1046
1369,m1403,20131011,3579,3601,3585,3585,3544,3545,3564,-56,-37,68,2424140,1068
1370,m1403,20131014,3545,3564,3540,3555,3522,3551,3543,-13,-21,62,2196740,1084
1371,m1403,20131015,3551,3543,3554,3554,3500,3501,3527,-42,-16,72,2539880,1078
1372,m1403,20131016,3501,3527,3514,3576,3484,3505,3517,-22,-10,232,8161000,1184
1373,m1403,20131017,3505,3517,3529,3529,3472,3486,3492,-31,-25,140,4889980,1152
1374,m1403,20131018,3486,3492,3508,3518,3505,3515,3509,23,17,36,1263400,1132
1375,m1403,20131021,3515,3509,3518,3522,3487,3510,3507,1,-2,124,4349760,1162
1376,m1403,20131022,3510,3507,3524,3524,3492,3492,3507,-15,0,24,841860,1154
1377,m1403,20131023,3492,3507,3474,3514,3474,3511,3506,4,-1,56,1963680,1124
1378,m1403,20131024,3511,3506,3517,3517,3508,3512,3510,6,4,20,702180,1122
1379,m1403,20131025,3512,3510,3515,3521,3481,3481,3512,-29,2,56,1966820,1124
1380,m1403,20131028,3481,3512,3465,3471,3444,3452,3456,-60,-56,24,829440,1122
1381,m1403,20131029,3452,3456,3431,3449,3426,3440,3433,-16,-23,70,2403780,1106
1382,m1403,20131030,3440,3433,3448,3448,3429,3437,3433,4,0,68,2334860,1080
1383,m1403,20131031,3437,3433,3409,3439,3409,3432,3424,-1,-9,24,821780,1082
1384,m1403,20131101,3432,3424,3419,3429,3417,3423,3419,-1,-5,48,1641380,1082
1385,m1403,20131104,3423,3419,3420,3420,3380,3414,3393,-5,-26,356,12080960,1048
1386,m1403,20131105,3414,3393,3411,3422,3401,3415,3414,22,21,72,2458240,992
1387,m1403,20131106,3415,3414,3391,3431,3391,3431,3408,17,-6,94,3204140,1010
1388,m1403,20131107,3431,3408,3442,3442,3423,3427,3428,19,20,30,1028440,1014
1389,m1403,20131108,3427,3428,3448,3448,3426,3426,3441,-2,13,42,1445400,1006
1390,m1403,20131111,3426,3441,3489,3498,3464,3470,3481,29,40,128,4456060,1018
1391,m1403,20131112,3470,3481,3476,3495,3476,3495,3480,14,-1,44,1531440,1038
1392,m1403,20131113,3495,3480,3511,3514,3508,3508,3510,28,30,86,3019380,1030
1393,m1403,20131114,3508,3510,3505,3509,3498,3498,3504,-12,-6,20,700940,1038
1394,m1403,20131115,3498,3504,3509,3512,3494,3508,3507,4,3,66,2315240,1054
1395,m1403,20131118,3508,3507,3471,3479,3470,3473,3471,-34,-36,132,4582220,1158
1396,m1403,20131119,3473,3471,3479,3488,3470,3470,3474,-1,3,208,7227780,1134
1397,m1403,20131120,3470,3474,3472,3472,3459,3467,3467,-7,-7,160,5547220,1166
1398,m1403,20131121,3467,3467,3470,3484,3470,3484,3477,17,10,64,2225500,1186
1399,m1403,20131122,3484,3477,3490,3505,3490,3505,3501,28,24,134,4692660,1146
1400,m1403,20131125,3505,3501,3526,3539,3520,3521,3525,20,24,136,4794260,1160
1401,m1403,20131126,3521,3525,3537,3537,3530,3530,3531,5,6,84,2966260,1186
1402,m1403,20131127,3530,3531,3536,3567,3533,3554,3547,23,16,364,12914380,1172
1403,m1403,20131128,3554,3547,3543,3566,3543,3560,3552,13,5,98,3481720,1152
1404,m1403,20131129,3560,3552,3563,3578,3538,3563,3566,11,14,354,12623920,1120
1405,m1403,20131202,3563,3566,3576,3595,3576,3588,3586,22,20,242,8680100,1100
1406,m1403,20131203,3588,3586,3572,3585,3565,3569,3575,-17,-11,178,6364540,1134
1407,m1403,20131204,3569,3575,3575,3587,3554,3582,3580,7,5,152,5442660,1164
1408,m1403,20131205,3582,3580,3585,3593,3578,3586,3585,6,5,766,27467660,1172
1409,m1403,20131206,3586,3585,3580,3580,3570,3578,3574,-7,-11,156,5576220,1198
1410,m1403,20131209,3578,3574,3585,3611,3585,3611,3599,37,25,228,8206620,1256
1411,m1403,20131210,3611,3599,3629,3639,3615,3621,3630,22,31,246,8930540,1318
1412,m1403,20131211,3621,3630,3619,3624,3613,3624,3616,-6,-14,150,5424880,1370
1413,m1403,20131212,3624,3616,3622,3637,3607,3611,3611,-5,-5,282,10185800,1564
1414,m1403,20131213,3611,3611,3598,3598,3582,3593,3589,-18,-22,178,6388560,1610
1415,m1403,20131216,3593,3589,3600,3620,3600,3613,3614,24,25,164,5927640,1670
1416,m1403,20131217,3613,3614,3635,3641,3624,3635,3632,21,18,228,8281480,1650
1417,m1403,20131218,3635,3632,3643,3651,3635,3637,3639,5,7,298,10847140,1718
1418,m1403,20131219,3637,3639,3625,3645,3625,3644,3639,5,0,250,9098820,1652
1419,m1403,20131220,3644,3639,3641,3641,3630,3637,3635,-2,-4,228,8289600,1764
1420,m1403,20131223,3637,3635,3637,3644,3631,3633,3634,-2,-1,230,8360000,1812
1421,m1403,20131224,3633,3634,3622,3622,3595,3603,3606,-31,-28,756,27262960,2128
1422,m1403,20131225,3603,3606,3600,3608,3592,3608,3601,2,-5,792,28526360,2178
1423,m1403,20131226,3608,3601,3608,3635,3604,3614,3621,13,20,882,31941240,1920
1424,m1403,20131227,3614,3621,3601,3618,3595,3617,3605,-4,-16,852,30717800,2028
1425,m1403,20131230,3617,3605,3615,3633,3603,3605,3618,0,13,260,9407380,1992
1426,m1403,20131231,3605,3618,3607,3619,3605,3615,3614,-3,-4,240,8674280,1960
1427,m1405,20130517,2942,2927,2957,2973,2951,2965,2964,38,37,32170,953800620,41768
1428,m1405,20130520,2965,2964,2984,2997,2973,2978,2982,14,18,32058,956181280,55068
1429,m1405,20130521,2978,2982,2973,2986,2935,2945,2958,-37,-24,74866,2214968300,95974
1430,m1405,20130522,2945,2958,2955,2955,2935,2940,2943,-18,-15,50132,1475657620,122344
1431,m1405,20130523,2940,2943,2961,2965,2936,2937,2947,-6,4,45268,1334274380,129768
1432,m1405,20130524,2937,2947,2937,2945,2930,2939,2938,-8,-9,36028,1058802060,134814
1433,m1405,20130527,2939,2938,2939,2959,2932,2955,2952,17,14,44384,1310598760,136836
1434,m1405,20130528,2955,2952,2964,2973,2956,2972,2962,20,10,51744,1533109460,144876
1435,m1405,20130529,2972,2962,3001,3069,2988,3033,3035,71,73,122608,3721742540,147328
1436,m1405,20130530,3033,3035,3041,3066,3034,3062,3051,27,16,91492,2792229220,156370
1437,m1405,20130531,3062,3051,3075,3086,3058,3084,3075,33,24,109444,3365587900,172582
1438,m1405,20130603,3084,3075,3110,3182,3103,3160,3160,85,85,215834,6820668240,217950
1439,m1405,20130604,3160,3160,3155,3161,3103,3114,3128,-46,-32,150552,4709688800,230240
1440,m1405,20130605,3114,3128,3126,3148,3111,3131,3131,3,3,128840,4034230520,232956
1441,m1405,20130606,3131,3131,3094,3106,3075,3091,3090,-40,-41,117030,3616511100,215130
1442,m1405,20130607,3091,3090,3120,3120,3088,3098,3099,8,9,78574,2435281720,216808
1443,m1405,20130613,3098,3099,3105,3110,3069,3073,3086,-26,-13,107060,3304894380,210278
1444,m1405,20130614,3073,3086,3057,3090,3052,3089,3070,3,-16,75080,2304998000,216066
1445,m1405,20130617,3089,3070,3052,3070,3039,3065,3054,-5,-16,151368,4624254260,239952
1446,m1405,20130618,3065,3054,3063,3093,3063,3066,3074,12,20,108078,3322976240,253200
1447,m1405,20130619,3066,3074,3060,3071,3055,3060,3062,-14,-12,70346,2154339260,272856
1448,m1405,20130620,3060,3062,3073,3078,3056,3059,3065,-3,3,85942,2634961240,282106
1449,m1405,20130621,3059,3065,3029,3041,2999,3000,3021,-65,-44,189314,5720006020,332744
1450,m1405,20130624,3000,3021,2981,2997,2968,2973,2981,-48,-40,115806,3452815260,347824
1451,m1405,20130625,2973,2981,2995,3021,2993,3018,3007,37,26,139540,4196230140,333474
1452,m1405,20130626,3018,3007,3015,3022,2999,3009,3010,2,3,115604,3480439780,342712
1453,m1405,20130627,3009,3010,3010,3040,3002,3031,3023,21,13,141370,4274577460,320218
1454,m1405,20130628,3031,3023,3029,3035,3010,3015,3020,-8,-3,103746,3133981880,334820
1455,m1405,20130701,3015,3020,2970,2990,2966,2982,2981,-38,-39,124090,3700172220,377792
1456,m1405,20130702,2982,2981,2968,3003,2966,3000,2989,19,8,100970,3018713620,384770
1457,m1405,20130703,3000,2989,2996,3032,2993,3026,3010,37,21,148560,4473055680,400612
1458,m1405,20130704,3026,3010,3029,3038,3022,3027,3029,17,19,96340,2919073240,414090
1459,m1405,20130705,3027,3029,3028,3050,3024,3046,3040,17,11,161394,4906792140,448768
1460,m1405,20130708,3046,3040,3016,3024,2995,3007,3007,-33,-33,201498,6059927820,509062
1461,m1405,20130709,3007,3007,3045,3095,3041,3090,3073,83,66,335314,10305305280,486090
1462,m1405,20130710,3090,3073,3108,3118,3086,3100,3100,27,27,287050,8899250860,492338
1463,m1405,20130711,3100,3100,3113,3115,3086,3105,3102,5,2,233716,7251105600,494604
1464,m1405,20130712,3105,3102,3108,3139,3101,3102,3120,0,18,228658,7135674660,475390
1465,m1405,20130715,3102,3120,3070,3084,3061,3078,3072,-42,-48,191014,5869644900,497530
1466,m1405,20130716,3078,3072,3099,3102,3087,3101,3094,29,22,157144,4862834160,474142
1467,m1405,20130717,3101,3094,3131,3134,3107,3111,3118,17,24,208410,6498799940,479590
1468,m1405,20130718,3111,3118,3090,3119,3090,3118,3103,0,-15,120792,3748453120,496242
1469,m1405,20130719,3118,3103,3100,3112,3081,3081,3101,-22,-2,264880,8215499840,553586
1470,m1405,20130722,3081,3101,3090,3097,3070,3086,3083,-15,-18,231866,7150521620,561188
1471,m1405,20130723,3086,3083,3099,3140,3096,3135,3121,52,38,277284,8655107580,522054
1472,m1405,20130724,3135,3121,3105,3115,3100,3111,3108,-10,-13,262522,8160887220,567416
1473,m1405,20130725,3111,3108,3090,3094,3074,3086,3084,-22,-24,195372,6025315140,598950
1474,m1405,20130726,3086,3084,3030,3036,2975,2992,3005,-92,-79,599738,18025700000,633984
1475,m1405,20130729,2992,3005,2998,3000,2976,2988,2987,-17,-18,244382,7299735180,633202
1476,m1405,20130730,2988,2987,2996,3005,2985,2998,2996,11,9,237442,7113846180,620300
1477,m1405,20130731,2998,2996,2958,2992,2955,2990,2975,-6,-21,287002,8540371720,643056
1478,m1405,20130801,2990,2975,2989,3004,2983,2998,2995,23,20,232214,6955128160,644654
1479,m1405,20130802,2998,2995,2978,2994,2974,2990,2986,-5,-9,209320,6250583040,673204
1480,m1405,20130805,2990,2986,2965,2977,2961,2968,2969,-18,-17,252116,7487018980,707502
1481,m1405,20130806,2968,2969,2962,2975,2956,2971,2965,2,-4,338126,10028528800,729000
1482,m1405,20130807,2971,2965,2960,2969,2942,2946,2952,-19,-13,340882,10063903700,789868
1483,m1405,20130808,2946,2952,2953,2971,2949,2965,2962,13,10,286314,8482811040,769214
1484,m1405,20130809,2965,2962,2980,2996,2972,2974,2985,12,23,328994,9821821360,760322
1485,m1405,20130812,2974,2985,2977,2991,2972,2991,2981,6,-4,208512,6217534260,774608
1486,m1405,20130813,2991,2981,3035,3064,3030,3049,3048,68,67,402858,12281089560,791946
1487,m1405,20130814,3049,3048,3040,3052,3023,3024,3039,-24,-9,316008,9603620000,830108
1488,m1405,20130815,3024,3039,3053,3099,3048,3063,3071,24,32,602072,18491348400,827194
1489,m1405,20130816,3063,3071,3100,3123,3085,3088,3101,17,30,477622,14814271660,837490
1490,m1405,20130819,3088,3101,3125,3133,3106,3119,3117,18,16,322016,10037418040,854604
1491,m1405,20130820,3119,3117,3159,3165,3093,3116,3124,-1,7,575264,17973564220,812652
1492,m1405,20130821,3116,3124,3110,3137,3103,3127,3123,3,-1,451950,14117970480,882614
1493,m1405,20130822,3127,3123,3124,3171,3116,3169,3150,46,27,781116,24606497760,977032
1494,m1405,20130823,3169,3150,3161,3169,3142,3161,3155,11,5,588134,18557133920,967134
1495,m1405,20130826,3161,3155,3260,3281,3260,3281,3277,126,122,281666,9232985820,920096
1496,m1405,20130827,3281,3277,3334,3358,3317,3356,3335,79,58,1067046,35586428420,949654
1497,m1405,20130828,3356,3335,3345,3362,3313,3314,3344,-21,9,823940,27558335300,1001326
1498,m1405,20130829,3314,3344,3338,3340,3258,3302,3311,-42,-33,825232,27326349380,923284
1499,m1405,20130830,3302,3311,3295,3295,3223,3245,3249,-66,-62,758874,24662313220,908518
1500,m1405,20130902,3245,3249,3250,3339,3250,3336,3305,87,56,679096,22447919320,945952
1501,m1405,20130903,3336,3305,3359,3360,3305,3335,3328,30,23,609404,20284920740,962546
1502,m1405,20130904,3335,3328,3300,3303,3259,3293,3283,-35,-45,719192,23611111400,962380
1503,m1405,20130905,3293,3283,3275,3298,3242,3258,3267,-25,-16,843446,27560287040,985084
1504,m1405,20130906,3258,3267,3280,3293,3267,3292,3281,25,14,728250,23894829540,927860
1505,m1405,20130909,3292,3281,3306,3313,3271,3278,3286,-3,5,551634,18129482280,957400
1506,m1405,20130910,3278,3286,3239,3264,3225,3232,3243,-54,-43,653008,21177443760,1002254
1507,m1405,20130911,3232,3243,3251,3277,3236,3267,3256,24,13,655462,21348364340,1004604
1508,m1405,20130912,3267,3256,3276,3283,3258,3265,3269,9,13,664218,21719364700,967888
1509,m1405,20130913,3265,3269,3340,3345,3305,3316,3318,47,49,852340,28283711100,907938
1510,m1405,20130916,3316,3318,3260,3282,3240,3243,3265,-75,-53,701290,22901877680,944854
1511,m1405,20130917,3243,3265,3230,3252,3216,3251,3236,-14,-29,602180,19487601620,955298
1512,m1405,20130918,3251,3236,3231,3265,3231,3261,3249,25,13,393152,12775038020,955538
1513,m1405,20130923,3261,3249,3209,3234,3197,3228,3220,-21,-29,365908,11783301280,994744
1514,m1405,20130924,3228,3220,3228,3270,3228,3260,3256,40,36,546178,17784326240,1077744
1515,m1405,20130925,3260,3256,3260,3268,3249,3252,3257,-4,1,416894,13579833320,1062220
1516,m1405,20130926,3252,3257,3259,3265,3236,3254,3252,-3,-5,377340,12271861420,1068184
1517,m1405,20130927,3254,3252,3245,3275,3237,3270,3256,18,4,438512,14279647500,1022242
1518,m1405,20130930,3270,3256,3260,3285,3257,3279,3272,23,16,346062,11326472400,980210
1519,m1405,20131008,3279,3272,3301,3378,3300,3353,3350,81,78,751890,25192302800,1078746
1520,m1405,20131009,3353,3350,3331,3354,3323,3354,3341,4,-9,671406,22435128240,1248750
1521,m1405,20131010,3354,3341,3351,3397,3326,3338,3364,-3,23,1486540,50020871940,1429708
1522,m1405,20131011,3338,3364,3318,3342,3305,3315,3324,-49,-40,823964,27391413240,1448336
1523,m1405,20131014,3315,3324,3300,3341,3289,3319,3316,-5,-8,941428,31222877500,1435022
1524,m1405,20131015,3319,3316,3320,3334,3281,3296,3306,-20,-10,1005650,33249618320,1435026
1525,m1405,20131016,3296,3306,3302,3310,3255,3267,3277,-39,-29,1167570,38264299960,1464338
1526,m1405,20131017,3267,3277,3289,3292,3235,3250,3260,-27,-17,851986,27778863540,1454580
1527,m1405,20131018,3250,3260,3268,3288,3264,3282,3277,22,17,885506,29023104080,1425872
1528,m1405,20131021,3282,3277,3275,3318,3265,3316,3290,39,13,1100388,36208220780,1539448
1529,m1405,20131022,3316,3290,3311,3322,3286,3287,3304,-3,14,876184,28952635440,1472096
1530,m1405,20131023,3287,3304,3290,3324,3282,3308,3307,4,3,1251844,41400789220,1533492
1531,m1405,20131024,3308,3307,3325,3326,3300,3319,3313,12,6,890194,29493148880,1485386
1532,m1405,20131025,3319,3313,3309,3329,3285,3291,3309,-22,-4,999084,33069325420,1439724
1533,m1405,20131028,3291,3309,3288,3289,3235,3257,3254,-52,-55,1023748,33315478920,1439438
1534,m1405,20131029,3257,3254,3225,3252,3222,3248,3239,-6,-15,791944,25655138520,1369366
1535,m1405,20131030,3248,3239,3247,3264,3237,3242,3251,3,12,699664,22749592680,1344110
1536,m1405,20131031,3242,3251,3233,3255,3217,3238,3234,-13,-17,776896,25125426320,1376648
1537,m1405,20131101,3238,3234,3218,3235,3215,3228,3225,-6,-9,944044,30451978940,1451696
1538,m1405,20131104,3228,3225,3198,3229,3188,3223,3207,-2,-18,1590444,51008771100,1569836
1539,m1405,20131105,3223,3207,3225,3234,3208,3223,3219,16,12,931860,30001902740,1535390
1540,m1405,20131106,3223,3219,3205,3228,3204,3224,3217,5,-2,873634,28105862180,1585714
1541,m1405,20131107,3224,3217,3229,3236,3217,3222,3227,5,10,811064,26177211620,1591406
1542,m1405,20131108,3222,3227,3235,3243,3218,3221,3229,-6,2,806288,26042683980,1553394
1543,m1405,20131111,3221,3229,3296,3300,3264,3265,3283,36,54,1611590,52924210380,1639384
1544,m1405,20131112,3265,3283,3268,3284,3262,3281,3273,-2,-10,839882,27492728220,1645960
1545,m1405,20131113,3281,3273,3295,3307,3287,3296,3297,23,24,995086,32813651700,1626836
1546,m1405,20131114,3296,3297,3285,3296,3272,3276,3280,-21,-17,738256,24221778760,1611992
1547,m1405,20131115,3276,3280,3283,3291,3273,3280,3282,0,2,777470,25522206100,1564674
1548,m1405,20131118,3280,3282,3240,3248,3231,3238,3239,-44,-43,762936,24713587300,1585974
1549,m1405,20131119,3238,3239,3249,3252,3223,3226,3239,-13,0,750704,24318896960,1653154
1550,m1405,20131120,3226,3239,3227,3238,3221,3235,3230,-4,-9,694484,22436411840,1653132
1551,m1405,20131121,3235,3230,3237,3245,3229,3237,3238,7,8,593684,19225576860,1675496
1552,m1405,20131122,3237,3238,3250,3263,3247,3261,3255,23,17,705930,22979084460,1663766
1553,m1405,20131125,3261,3255,3300,3306,3270,3272,3289,17,34,1003722,33013246180,1667622
1554,m1405,20131126,3272,3289,3292,3297,3278,3279,3287,-10,-2,711552,23389060500,1627654
1555,m1405,20131127,3279,3287,3290,3335,3282,3326,3316,39,29,1676934,55611422080,1688880
1556,m1405,20131128,3326,3316,3310,3326,3310,3323,3318,7,2,667666,22155112120,1674266
1557,m1405,20131129,3323,3318,3324,3345,3323,3338,3337,20,19,874630,29193446340,1689592
1558,m1405,20131202,3338,3337,3350,3385,3345,3376,3367,39,30,1203782,40534020820,1699290
1559,m1405,20131203,3376,3367,3350,3368,3348,3355,3357,-12,-10,950878,31925369860,1804812
1560,m1405,20131204,3355,3357,3359,3374,3351,3369,3363,12,6,813394,27355680660,1825756
1561,m1405,20131205,3369,3363,3375,3390,3365,3368,3378,5,15,881760,29788415900,1779486
1562,m1405,20131206,3368,3378,3374,3374,3334,3347,3347,-31,-31,1018682,34098552180,1717162
1563,m1405,20131209,3347,3347,3353,3384,3349,3383,3369,36,22,1008214,33972526820,1757076
1564,m1405,20131210,3383,3369,3400,3413,3373,3378,3392,9,23,1140252,38686295060,1743908
1565,m1405,20131211,3378,3392,3375,3380,3362,3377,3371,-15,-21,744320,25094143720,1734588
1566,m1405,20131212,3377,3371,3378,3388,3342,3347,3361,-24,-10,1058922,35596227180,1684478
1567,m1405,20131213,3347,3361,3328,3334,3314,3330,3325,-31,-36,828286,27548455920,1654148
1568,m1405,20131216,3330,3325,3341,3364,3335,3348,3351,23,26,938428,31446819080,1659396
1569,m1405,20131217,3348,3351,3365,3395,3362,3386,3378,35,27,1231522,41601559460,1625218
1570,m1405,20131218,3386,3378,3400,3406,3382,3393,3391,15,13,989908,33573925060,1617380
1571,m1405,20131219,3393,3391,3371,3383,3366,3381,3375,-10,-16,765966,25851378800,1616592
1572,m1405,20131220,3381,3375,3376,3384,3358,3378,3367,3,-8,743034,25022875080,1614880
1573,m1405,20131223,3378,3367,3385,3385,3362,3368,3373,1,6,944192,31851979560,1522030
1574,m1405,20131224,3368,3373,3358,3358,3318,3331,3336,-42,-37,1045088,34866743120,1576354
1575,m1405,20131225,3331,3336,3340,3370,3321,3370,3344,34,8,1115434,37303230780,1534090
1576,m1405,20131226,3370,3344,3383,3384,3364,3369,3372,25,28,742530,25040019420,1508334
1577,m1405,20131227,3369,3372,3345,3389,3342,3385,3365,13,-7,976832,32875530980,1510656
1578,m1405,20131230,3385,3365,3385,3434,3349,3352,3387,-13,22,2432200,82395055920,1576972
1579,m1405,20131231,3352,3387,3352,3373,3350,3368,3362,-19,-25,1049534,35290553540,1556822
1580,m1407,20130716,3078,3076,3180,3180,3089,3100,3099,24,23,228,7065960,198
1581,m1407,20130717,3100,3099,3113,3139,3113,3115,3120,16,21,154,4805200,260
1582,m1407,20130718,3115,3120,3103,3122,3103,3122,3112,2,-8,88,2739300,314
1583,m1407,20130719,3122,3112,3110,3115,3099,3099,3110,-13,-2,260,8086140,504
1584,m1407,20130722,3099,3110,3099,3123,3099,3113,3112,3,2,828,25772860,1048
1585,m1407,20130723,3113,3112,3138,3153,3114,3148,3138,36,26,240,7531300,990
1586,m1407,20130724,3148,3138,3120,3142,3120,3132,3129,-6,-9,174,5445340,1076
1587,m1407,20130725,3132,3129,3108,3117,3103,3113,3108,-16,-21,96,2984480,1126
1588,m1407,20130726,3113,3108,3078,3078,3015,3030,3052,-78,-56,482,14711700,1468
1589,m1407,20130729,3030,3052,3036,3044,3018,3032,3027,-20,-25,158,4783140,1556
1590,m1407,20130730,3032,3027,3054,3064,3029,3034,3037,7,10,76,2308180,1550
1591,m1407,20130731,3034,3037,2998,3024,2998,3024,3010,-13,-27,198,5961640,1582
1592,m1407,20130801,3024,3010,3025,3033,3016,3025,3026,15,16,112,3389360,1590
1593,m1407,20130802,3025,3026,3019,3020,3006,3016,3013,-10,-13,96,2893400,1608
1594,m1407,20130805,3016,3013,3002,3006,2993,3000,3000,-13,-13,60,1800080,1616
1595,m1407,20130806,3000,3000,2996,3023,2983,3001,2997,1,-3,44,1318700,1636
1596,m1407,20130807,3001,2997,2993,2993,2972,2975,2979,-22,-18,88,2621800,1664
1597,m1407,20130808,2975,2979,2988,3007,2985,2993,2992,14,13,68,2035200,1660
1598,m1407,20130809,2993,2992,3008,3020,3000,3000,3011,8,19,50,1505640,1646
1599,m1407,20130812,3000,3011,3001,3010,3000,3010,3005,-1,-6,114,3426120,1650
1600,m1407,20130813,3010,3005,3069,3080,3049,3072,3063,67,58,134,4105560,1598
1601,m1407,20130814,3072,3063,3051,3062,3036,3036,3050,-27,-13,428,13058240,1670
1602,m1407,20130815,3036,3050,3060,3099,3060,3066,3079,16,29,368,11331700,1530
1603,m1407,20130816,3066,3079,3095,3121,3085,3085,3100,6,21,442,13702800,1378
1604,m1407,20130819,3085,3100,3118,3119,3102,3110,3108,10,8,220,6838760,1344
1605,m1407,20130820,3110,3108,3120,3150,3103,3120,3124,12,16,624,19497060,1468
1606,m1407,20130821,3120,3124,3130,3141,3101,3135,3131,11,7,276,8642700,1456
1607,m1407,20130822,3135,3131,3136,3177,3133,3175,3153,44,22,204,6433000,1448
1608,m1407,20130823,3175,3153,3169,3169,3150,3163,3157,10,4,92,2905260,1422
1609,m1407,20130826,3163,3157,3279,3283,3265,3283,3281,126,124,180,5906320,1382
1610,m1407,20130827,3283,3281,3379,3384,3313,3340,3338,59,57,356,11883580,1242
1611,m1407,20130828,3340,3338,3340,3340,3295,3295,3330,-43,-8,586,19514440,1154
1612,m1407,20130829,3295,3330,3288,3313,3253,3281,3287,-49,-43,260,8548500,1154
1613,m1407,20130830,3281,3287,3265,3265,3214,3231,3234,-56,-53,184,5951100,1154
1614,m1407,20130902,3231,3234,3242,3317,3242,3317,3286,83,52,146,4798380,1170
1615,m1407,20130903,3317,3286,3268,3326,3266,3314,3303,28,17,84,2775200,1162
1616,m1407,20130904,3314,3303,3298,3298,3246,3281,3270,-22,-33,148,4839700,1176
1617,m1407,20130905,3281,3270,3256,3282,3227,3239,3246,-31,-24,476,15454900,1212
1618,m1407,20130906,3239,3246,3250,3273,3250,3273,3258,27,12,208,6777100,1230
1619,m1407,20130909,3273,3258,3289,3289,3220,3224,3233,-34,-25,2100,67910160,1962
1620,m1407,20130910,3224,3233,3190,3194,3157,3163,3175,-70,-58,2460,78122140,3114
1621,m1407,20130911,3163,3175,3176,3206,3161,3203,3179,28,4,816,25945960,3146
1622,m1407,20130912,3203,3179,3205,3274,3194,3216,3229,37,50,2600,83976540,3010
1623,m1407,20130913,3216,3229,3268,3288,3246,3253,3259,24,30,1058,34483660,2772
1624,m1407,20130916,3253,3259,3218,3228,3179,3179,3208,-80,-51,466,14952940,2746
1625,m1407,20130917,3179,3208,3166,3203,3162,3178,3178,-30,-30,542,17229440,2678
1626,m1407,20130918,3178,3178,3178,3186,3172,3184,3181,6,3,154,4899240,2660
1627,m1407,20130923,3184,3181,3147,3153,3140,3140,3144,-41,-37,798,25089240,2942
1628,m1407,20130924,3140,3144,3151,3169,3146,3163,3160,19,16,400,12641600,2858
1629,m1407,20130925,3163,3160,3170,3196,3158,3180,3180,20,20,742,23598480,2882
1630,m1407,20130926,3180,3180,3188,3190,3168,3169,3175,-11,-5,90,2857800,2872
1631,m1407,20130927,3169,3175,3163,3188,3161,3185,3181,10,6,232,7382080,2728
1632,m1407,20130930,3185,3181,3185,3201,3178,3201,3192,20,11,148,4725100,2684
1633,m1407,20131008,3201,3192,3225,3274,3225,3264,3260,72,68,324,10564780,2668
1634,m1407,20131009,3264,3260,3260,3260,3239,3258,3249,-2,-11,406,13191560,2904
1635,m1407,20131010,3258,3249,3254,3298,3252,3252,3275,3,26,534,17492580,2850
1636,m1407,20131011,3252,3275,3258,3265,3240,3242,3253,-33,-22,140,4554820,2866
1637,m1407,20131014,3242,3253,3231,3260,3230,3243,3243,-10,-10,158,5125420,2874
1638,m1407,20131015,3243,3243,3258,3259,3192,3249,3236,6,-7,948,30685800,3216
1639,m1407,20131016,3249,3236,3253,3260,3221,3229,3241,-7,5,332,10760760,3188
1640,m1407,20131017,3229,3241,3244,3244,3210,3211,3232,-30,-9,486,15708240,3384
1641,m1407,20131018,3211,3232,3217,3250,3217,3236,3239,4,7,128,4146600,3306
1642,m1407,20131021,3236,3239,3243,3267,3234,3267,3245,28,6,110,3570440,3308
1643,m1407,20131022,3267,3245,3266,3268,3246,3246,3258,1,13,140,4561720,3254
1644,m1407,20131023,3246,3258,3245,3269,3235,3266,3259,8,1,120,3911920,3190
1645,m1407,20131024,3266,3259,3272,3272,3260,3269,3264,10,5,60,1958400,3168
1646,m1407,20131025,3269,3264,3261,3270,3242,3242,3256,-22,-8,66,2149560,3182
1647,m1407,20131028,3242,3256,3259,3259,3197,3200,3200,-56,-56,3242,103763100,6040
1648,m1407,20131029,3200,3200,3172,3198,3172,3188,3182,-12,-18,510,16229860,6176
1649,m1407,20131030,3188,3182,3191,3195,3181,3182,3187,0,5,180,5736920,6148
1650,m1407,20131031,3182,3187,3171,3186,3166,3173,3173,-14,-14,98,3110140,6154
1651,m1407,20131101,3173,3173,3169,3171,3164,3166,3166,-7,-7,50,1583400,6154
1652,m1407,20131104,3166,3166,3150,3167,3138,3167,3151,1,-15,206,6491200,6184
1653,m1407,20131105,3167,3151,3160,3163,3156,3163,3159,12,8,64,2021880,6164
1654,m1407,20131106,3163,3159,3155,3159,3149,3151,3150,-8,-9,1168,36801340,6944
1655,m1407,20131107,3151,3150,3155,3155,3146,3146,3151,-4,1,388,12228860,6910
1656,m1407,20131108,3146,3151,3158,3160,3145,3150,3153,-1,2,228,7190800,6916
1657,m1407,20131111,3150,3153,3179,3201,3179,3179,3190,26,37,980,31264280,6778
1658,m1407,20131112,3179,3190,3178,3180,3166,3180,3172,-10,-18,410,13006580,6726
1659,m1407,20131113,3180,3172,3183,3198,3183,3190,3192,18,20,298,9512740,6726
1660,m1407,20131114,3190,3192,3190,3191,3180,3181,3184,-11,-8,114,3629960,6730
1661,m1407,20131115,3181,3184,3187,3188,3181,3181,3184,-3,0,68,2165500,6716
1662,m1407,20131118,3181,3184,3154,3160,3150,3159,3155,-25,-29,192,6057760,6722
1663,m1407,20131119,3159,3155,3161,3161,3144,3147,3152,-8,-3,392,12358760,6676
1664,m1407,20131120,3147,3152,3146,3147,3140,3143,3143,-9,-9,90,2829460,6676
1665,m1407,20131121,3143,3143,3148,3151,3145,3150,3148,7,5,192,6046060,6678
1666,m1407,20131122,3150,3148,3158,3162,3142,3160,3153,12,5,424,13372140,6676
1667,m1407,20131125,3160,3153,3181,3191,3172,3173,3179,20,26,578,18376820,6666
1668,m1407,20131126,3173,3179,3178,3185,3173,3174,3178,-5,-1,186,5912140,6672
1669,m1407,20131127,3174,3178,3181,3244,3171,3212,3202,34,24,2158,69103400,7160
1670,m1407,20131128,3212,3202,3205,3248,3197,3219,3216,17,14,566,18203520,6940
1671,m1407,20131129,3219,3216,3225,3254,3225,3252,3242,36,26,702,22763820,6972
1672,m1407,20131202,3252,3242,3253,3289,3253,3284,3275,42,33,552,18080720,6860
1673,m1407,20131203,3284,3275,3256,3280,3255,3270,3270,-5,-5,388,12689900,6722
1674,m1407,20131204,3270,3270,3276,3294,3276,3289,3282,19,12,422,13850240,6708
1675,m1407,20131205,3289,3282,3295,3300,3258,3259,3275,-23,-7,2740,89751700,8298
1676,m1407,20131206,3259,3275,3263,3269,3236,3246,3244,-29,-31,596,19337780,8282
1677,m1407,20131209,3246,3244,3244,3271,3244,3270,3262,26,18,632,20618440,8290
1678,m1407,20131210,3270,3262,3285,3289,3271,3275,3279,13,17,366,12004480,8308
1679,m1407,20131211,3275,3279,3282,3283,3249,3255,3253,-24,-26,3434,111728980,10680
1680,m1407,20131212,3255,3253,3256,3262,3235,3235,3249,-18,-4,494,16050480,10682
1681,m1407,20131213,3235,3249,3235,3235,3206,3224,3220,-25,-29,454,14619200,10660
1682,m1407,20131216,3224,3220,3236,3252,3231,3240,3243,20,23,514,16673840,10658
1683,m1407,20131217,3240,3243,3261,3270,3254,3261,3260,18,17,814,26543820,10662
1684,m1407,20131218,3261,3260,3282,3282,3259,3265,3265,5,5,344,11231660,10664
1685,m1407,20131219,3265,3265,3245,3263,3245,3262,3255,-3,-10,356,11590500,10670
1686,m1407,20131220,3262,3255,3260,3265,3251,3262,3257,7,2,336,10946220,10672
1687,m1407,20131223,3262,3257,3265,3268,3258,3260,3263,3,6,246,8027560,10670
1688,m1407,20131224,3260,3263,3255,3255,3225,3236,3238,-27,-25,432,13990640,10666
1689,m1407,20131225,3236,3238,3236,3266,3233,3265,3248,27,10,472,15332640,10686
1690,m1407,20131226,3265,3248,3272,3272,3260,3264,3265,16,17,166,5421000,10666
1691,m1407,20131227,3264,3265,3246,3277,3246,3275,3263,10,-2,384,12531600,10672
1692,m1407,20131230,3275,3263,3284,3299,3254,3260,3273,-3,10,2542,83205200,10828
1693,m1407,20131231,3260,3273,3265,3279,3257,3277,3270,4,-3,754,24660140,10892
1694,m1408,20130816,3077,3074,3094,3109,3085,3085,3098,11,24,54,1673120,86
1695,m1408,20130819,3085,3098,3143,3143,3100,3116,3117,18,19,38,1184700,112
1696,m1408,20130820,3116,3117,3173,3210,3121,3138,3173,21,56,802,25447800,554
1697,m1408,20130821,3138,3173,3125,3165,3125,3153,3147,-20,-26,166,5224520,534
1698,m1408,20130822,3153,3147,3153,3183,3141,3180,3164,33,17,134,4240520,546
1699,m1408,20130823,3180,3164,3169,3175,3160,3173,3168,9,4,110,3485360,550
1700,m1408,20130826,3173,3168,3246,3294,3246,3294,3291,126,123,312,10268000,550
1701,m1408,20130827,3294,3291,3331,3348,3309,3333,3329,42,38,386,12850340,394
1702,m1408,20130828,3333,3329,3320,3326,3280,3306,3317,-23,-12,364,12075860,380
1703,m1408,20130829,3306,3317,3294,3310,3240,3262,3276,-55,-41,194,6356100,426
1704,m1408,20130830,3262,3276,3255,3280,3202,3224,3223,-52,-53,208,6705640,482
1705,m1408,20130902,3224,3223,3202,3318,3202,3318,3275,95,52,286,9367680,472
1706,m1408,20130903,3318,3275,3350,3365,3289,3312,3305,37,30,238,7867720,484
1707,m1408,20130904,3312,3305,3280,3298,3245,3262,3260,-43,-45,300,9782780,544
1708,m1408,20130905,3262,3260,3255,3262,3220,3235,3239,-25,-21,418,13541280,670
1709,m1408,20130906,3235,3239,3246,3264,3240,3264,3250,25,11,316,10273120,620
1710,m1408,20130909,3264,3250,3260,3279,3223,3229,3238,-21,-12,1060,34323160,1050
1711,m1408,20130910,3229,3238,3204,3207,3162,3163,3177,-75,-61,1514,48100820,1620
1712,m1408,20130911,3163,3177,3179,3300,3162,3205,3223,28,46,2392,77099420,2516
1713,m1408,20130912,3205,3223,3210,3222,3192,3214,3206,-9,-17,1196,38343800,2544
1714,m1408,20130913,3214,3206,3258,3280,3240,3246,3252,40,46,810,26343940,2504
1715,m1408,20130916,3246,3252,3216,3220,3176,3180,3203,-72,-49,910,29151320,2400
1716,m1408,20130917,3180,3203,3168,3210,3163,3181,3179,-22,-24,866,27535320,2292
1717,m1408,20130918,3181,3179,3170,3192,3170,3185,3181,6,2,214,6808540,2270
1718,m1408,20130923,3185,3181,3131,3159,3131,3147,3148,-34,-33,586,18452820,2252
1719,m1408,20130924,3147,3148,3150,3172,3150,3170,3163,22,15,336,10630140,2192
1720,m1408,20130925,3170,3163,3170,3189,3164,3176,3174,13,11,372,11810400,2164
1721,m1408,20130926,3176,3174,3189,3189,3163,3173,3175,-1,1,176,5588320,2196
1722,m1408,20130927,3173,3175,3167,3186,3165,3186,3173,11,-2,152,4823080,2184
1723,m1408,20130930,3186,3173,3177,3195,3173,3193,3183,20,10,180,5729640,2070
1724,m1408,20131008,3193,3183,3218,3275,3218,3255,3254,72,71,354,11521420,1978
1725,m1408,20131009,3255,3254,3236,3258,3236,3257,3245,3,-9,300,9735360,1944
1726,m1408,20131010,3257,3245,3268,3297,3250,3250,3275,5,30,796,26069340,1690
1727,m1408,20131011,3250,3275,3262,3262,3238,3240,3249,-35,-26,314,10202220,1758
1728,m1408,20131014,3240,3249,3266,3266,3229,3241,3242,-8,-7,126,4086140,1752
1729,m1408,20131015,3241,3242,3257,3323,3213,3246,3244,4,2,1218,39523800,2386
1730,m1408,20131016,3246,3244,3248,3250,3210,3218,3225,-26,-19,248,7998920,2434
1731,m1408,20131017,3218,3225,3225,3237,3201,3208,3220,-17,-5,556,17903720,2840
1732,m1408,20131018,3208,3220,3219,3235,3219,3226,3226,6,6,52,1677840,2834
1733,m1408,20131021,3226,3226,3225,3253,3222,3253,3235,27,9,88,2847520,2822
1734,m1408,20131022,3253,3235,3245,3253,3232,3232,3244,-3,9,96,3114740,2818
1735,m1408,20131023,3232,3244,3235,3255,3232,3252,3245,8,1,150,4867900,2748
1736,m1408,20131024,3252,3245,3261,3261,3250,3255,3254,10,9,70,2278340,2698
1737,m1408,20131025,3255,3254,3259,3264,3223,3227,3242,-27,-12,136,4409440,2662
1738,m1408,20131028,3227,3242,3206,3206,3194,3194,3200,-48,-42,114,3648980,2680
1739,m1408,20131029,3194,3200,3182,3189,3177,3186,3183,-14,-17,128,4074420,2730
1740,m1408,20131030,3186,3183,3192,3194,3178,3178,3185,-5,2,56,1784020,2742
1741,m1408,20131031,3178,3185,3170,3186,3163,3177,3171,-8,-14,100,3171100,2726
1742,m1408,20131101,3177,3171,3167,3170,3160,3165,3164,-6,-7,102,3228160,2736
1743,m1408,20131104,3165,3164,3146,3163,3137,3157,3149,-7,-15,62,1952680,2740
1744,m1408,20131105,3157,3149,3168,3168,3155,3162,3158,13,9,34,1074040,2722
1745,m1408,20131106,3162,3158,3153,3153,3149,3150,3150,-8,-8,110,3465560,2706
1746,m1408,20131107,3150,3150,3152,3159,3139,3151,3151,1,1,140,4412180,2716
1747,m1408,20131108,3151,3151,3153,3160,3147,3152,3155,1,4,50,1577500,2702
1748,m1408,20131111,3152,3155,3187,3205,3177,3177,3194,22,39,436,13927380,2602
1749,m1408,20131112,3177,3194,3175,3183,3170,3181,3176,-13,-18,162,5145280,2596
1750,m1408,20131113,3181,3176,3197,3201,3189,3193,3195,17,19,212,6775120,2552
1751,m1408,20131114,3193,3195,3193,3193,3185,3186,3188,-9,-7,20,637680,2548
1752,m1408,20131115,3186,3188,3187,3188,3178,3184,3185,-4,-3,46,1465540,2534
1753,m1408,20131118,3184,3185,3156,3165,3155,3160,3160,-25,-25,154,4866580,2588
1754,m1408,20131119,3160,3160,3159,3164,3143,3145,3151,-15,-9,442,13928480,2444
1755,m1408,20131120,3145,3151,3148,3151,3141,3147,3146,-4,-5,350,11012320,2318
1756,m1408,20131121,3147,3146,3149,3154,3147,3150,3149,4,3,250,7872640,2212
1757,m1408,20131122,3150,3149,3153,3169,3150,3166,3160,17,11,214,6763540,2136
1758,m1408,20131125,3166,3160,3182,3196,3182,3183,3187,23,27,426,13577660,2060
1759,m1408,20131126,3183,3187,3190,3190,3176,3176,3180,-11,-7,330,10495120,1858
1760,m1408,20131127,3176,3180,3181,3243,3181,3218,3212,38,32,360,11566360,1980
1761,m1408,20131128,3218,3212,3206,3222,3206,3221,3214,9,2,122,3922240,1980
1762,m1408,20131129,3221,3214,3232,3250,3232,3250,3244,36,30,506,16418840,2176
1763,m1408,20131202,3250,3244,3251,3283,3251,3280,3269,36,25,366,11964580,2246
1764,m1408,20131203,3280,3269,3257,3296,3257,3266,3265,-3,-4,290,9471080,2292
1765,m1408,20131204,3266,3265,3275,3295,3273,3290,3285,25,20,376,12353280,2474
1766,m1408,20131205,3290,3285,3293,3301,3263,3263,3290,-22,5,722,23760640,2630
1767,m1408,20131206,3263,3290,3266,3266,3242,3251,3252,-39,-38,200,6504380,2658
1768,m1408,20131209,3251,3252,3260,3275,3260,3275,3266,23,14,242,7905200,2716
1769,m1408,20131210,3275,3266,3266,3297,3266,3275,3286,9,20,150,4929620,2668
1770,m1408,20131211,3275,3286,3270,3277,3256,3264,3265,-22,-21,224,7314360,2714
1771,m1408,20131212,3264,3265,3269,3270,3243,3243,3257,-22,-8,144,4690940,2692
1772,m1408,20131213,3243,3257,3233,3235,3223,3228,3230,-29,-27,96,3100820,2660
1773,m1408,20131216,3228,3230,3280,3280,3242,3248,3252,18,22,120,3903580,2672
1774,m1408,20131217,3248,3252,3265,3279,3265,3270,3270,18,18,82,2682020,2626
1775,m1408,20131218,3270,3270,3287,3289,3269,3272,3277,2,7,134,4391260,2606
1776,m1408,20131219,3272,3277,3277,3277,3262,3266,3267,-11,-10,20,653440,2616
1777,m1408,20131220,3266,3267,3256,3274,3256,3270,3264,3,-3,122,3982760,2676
1778,m1408,20131223,3270,3264,3272,3279,3247,3273,3272,9,8,190,6217120,2706
1779,m1408,20131224,3273,3272,3262,3262,3236,3241,3249,-31,-23,162,5264020,2752
1780,m1408,20131225,3241,3249,3242,3275,3242,3275,3261,26,12,182,5935780,2722
1781,m1408,20131226,3275,3261,3279,3283,3272,3279,3276,18,15,84,2752280,2666
1782,m1408,20131227,3279,3276,3265,3297,3265,3291,3277,15,1,112,3671320,2668
1783,m1408,20131230,3291,3277,3286,3313,3272,3272,3287,-5,10,490,16110160,2908
1784,m1408,20131231,3272,3287,3281,3294,3275,3289,3285,2,-2,236,7752980,3034
1785,m1409,20130917,3115,3147,3110,3126,3099,3124,3115,-23,-32,105056,3273385220,127954
1786,m1409,20130918,3124,3115,3113,3130,3113,3121,3122,6,7,61054,1906150560,151926
1787,m1409,20130923,3121,3122,3099,3099,3081,3084,3088,-38,-34,84860,2620776160,192592
1788,m1409,20130924,3084,3088,3085,3099,3081,3093,3091,5,3,91578,2831586380,233960
1789,m1409,20130925,3093,3091,3096,3096,3082,3084,3087,-7,-4,62210,1920446240,258096
1790,m1409,20130926,3084,3087,3096,3096,3070,3078,3081,-9,-6,83366,2568722760,289372
1791,m1409,20130927,3078,3081,3058,3080,3058,3075,3071,-6,-10,62946,1933641740,302374
1792,m1409,20130930,3075,3071,3065,3078,3056,3077,3065,6,-6,60238,1846756220,310948
1793,m1409,20131008,3077,3065,3101,3133,3093,3119,3119,54,54,141438,4411851200,339386
1794,m1409,20131009,3119,3119,3110,3155,3100,3153,3126,34,7,267546,8365516720,426274
1795,m1409,20131010,3153,3126,3156,3232,3145,3195,3200,69,74,730598,23382038480,565052
1796,m1409,20131011,3195,3200,3195,3204,3170,3176,3187,-24,-13,441394,14071396440,624670
1797,m1409,20131014,3176,3187,3168,3209,3161,3187,3193,0,6,490426,15659510500,676624
1798,m1409,20131015,3187,3193,3188,3198,3160,3172,3179,-21,-14,387382,12317986440,671952
1799,m1409,20131016,3172,3179,3178,3186,3152,3160,3167,-19,-12,441670,13988402620,726946
1800,m1409,20131017,3160,3167,3177,3180,3126,3134,3148,-33,-19,388266,12222874920,719516
1801,m1409,20131018,3134,3148,3150,3156,3141,3149,3148,1,0,200024,6297259440,713096
1802,m1409,20131021,3149,3148,3150,3168,3133,3166,3147,18,-1,292488,9207000040,746986
1803,m1409,20131022,3166,3147,3160,3174,3155,3155,3162,8,15,262942,8316018960,736080
1804,m1409,20131023,3155,3162,3157,3183,3151,3178,3172,16,10,372480,11817348760,773684
1805,m1409,20131024,3178,3172,3188,3191,3175,3187,3182,15,10,224670,7149654780,779946
1806,m1409,20131025,3187,3182,3183,3186,3154,3156,3172,-26,-10,222912,7070902980,795772
1807,m1409,20131028,3156,3172,3150,3155,3127,3136,3136,-36,-36,249826,7836229560,842784
1808,m1409,20131029,3136,3136,3120,3136,3112,3134,3126,-2,-10,245668,7680820000,882714
1809,m1409,20131030,3134,3126,3135,3143,3123,3125,3132,-1,6,217024,6797788440,918700
1810,m1409,20131031,3125,3132,3124,3132,3111,3119,3119,-13,-13,185130,5775785780,922188
1811,m1409,20131101,3119,3119,3103,3116,3102,3113,3109,-6,-10,229338,7130777120,972874
1812,m1409,20131104,3113,3109,3099,3114,3084,3107,3096,-2,-13,434024,13441120160,1030330
1813,m1409,20131105,3107,3096,3108,3112,3095,3105,3102,9,6,298314,9254338380,1075004
1814,m1409,20131106,3105,3102,3097,3111,3095,3109,3103,7,1,312652,9703233900,1094060
1815,m1409,20131107,3109,3103,3109,3115,3101,3103,3108,0,5,221768,6893527360,1113688
1816,m1409,20131108,3103,3108,3110,3116,3101,3108,3107,0,-1,232098,7211551860,1143590
1817,m1409,20131111,3108,3107,3152,3160,3127,3131,3143,24,36,427920,13449763620,1101816
1818,m1409,20131112,3131,3143,3135,3137,3124,3133,3130,-10,-13,238200,7456871380,1127164
1819,m1409,20131113,3133,3130,3142,3151,3138,3145,3145,15,15,296106,9314038240,1083342
1820,m1409,20131114,3145,3145,3145,3148,3135,3137,3140,-8,-5,172698,5423222220,1077960
1821,m1409,20131115,3137,3140,3140,3148,3136,3139,3141,-1,1,178416,5604634900,1089860
1822,m1409,20131118,3139,3141,3115,3120,3109,3118,3116,-23,-25,283888,8846728440,1134534
1823,m1409,20131119,3118,3116,3125,3130,3114,3117,3122,1,6,257080,8026453780,1212904
1824,m1409,20131120,3117,3122,3114,3121,3110,3119,3116,-3,-6,209212,6519122900,1211982
1825,m1409,20131121,3119,3116,3118,3125,3114,3119,3118,3,2,144860,4517904100,1206520
1826,m1409,20131122,3119,3118,3128,3132,3118,3128,3126,10,8,256760,8027974700,1165416
1827,m1409,20131125,3128,3126,3155,3157,3135,3136,3145,10,19,261160,8215154500,1119324
1828,m1409,20131126,3136,3145,3151,3154,3136,3137,3143,-8,-2,255514,8033213760,1106328
1829,m1409,20131127,3137,3143,3143,3175,3134,3170,3161,27,18,434320,13729204280,1031908
1830,m1409,20131128,3170,3161,3163,3167,3156,3162,3161,1,0,187762,5935250040,1035116
1831,m1409,20131129,3162,3161,3162,3178,3160,3171,3171,10,10,288044,9135048840,1026888
1832,m1409,20131202,3171,3171,3181,3191,3172,3188,3183,17,12,320476,10203245460,1043146
1833,m1409,20131203,3188,3183,3171,3190,3165,3183,3181,0,-2,349608,11123835440,1060936
1834,m1409,20131204,3183,3181,3185,3214,3185,3208,3202,27,21,564050,18066106840,1124190
1835,m1409,20131205,3208,3202,3209,3218,3202,3204,3210,2,8,402222,12915116760,1140860
1836,m1409,20131206,3204,3210,3204,3209,3177,3189,3191,-21,-19,414408,13225357100,1183298
1837,m1409,20131209,3189,3191,3194,3208,3187,3208,3200,17,9,398664,12758518940,1156812
1838,m1409,20131210,3208,3200,3220,3228,3208,3213,3218,13,18,336310,10823286060,1145152
1839,m1409,20131211,3213,3218,3200,3214,3200,3213,3207,-5,-11,251034,8052398400,1177568
1840,m1409,20131212,3213,3207,3216,3220,3188,3191,3203,-16,-4,340426,10905780480,1170702
1841,m1409,20131213,3191,3203,3180,3183,3165,3176,3174,-27,-29,294946,9363976560,1172528
1842,m1409,20131216,3176,3174,3181,3204,3181,3192,3194,18,20,339706,10852722560,1138606
1843,m1409,20131217,3192,3194,3206,3227,3204,3220,3217,26,23,492534,15846632420,1119656
1844,m1409,20131218,3220,3217,3235,3239,3212,3218,3220,1,3,343528,11061860360,1068744
1845,m1409,20131219,3218,3220,3201,3218,3200,3215,3210,-5,-10,261908,8409557580,1105166
1846,m1409,20131220,3215,3210,3215,3220,3203,3215,3209,5,-1,195646,6278429740,1110630
1847,m1409,20131223,3215,3209,3220,3225,3208,3214,3216,5,7,323646,10409744140,1084642
1848,m1409,20131224,3214,3216,3200,3208,3172,3183,3189,-33,-27,334462,10668000940,1119652
1849,m1409,20131225,3183,3189,3184,3222,3175,3219,3199,30,10,526344,16838910360,1154946
1850,m1409,20131226,3219,3199,3230,3235,3211,3216,3218,17,19,297382,9571522980,1148120
1851,m1409,20131227,3216,3218,3194,3241,3192,3238,3218,20,0,503244,16198901300,1159696
1852,m1409,20131230,3238,3218,3242,3265,3205,3206,3230,-12,12,938222,30305195940,1143610
1853,m1409,20131231,3206,3230,3210,3221,3205,3215,3214,-15,-16,338746,10887996340,1148042
1854,m1411,20131118,3114,3120,3115,3115,3096,3103,3103,-17,-17,814,25260260,860
1855,m1411,20131119,3103,3103,3104,3115,3101,3103,3106,0,3,432,13418020,1118
1856,m1411,20131120,3103,3106,3097,3105,3095,3103,3098,-3,-8,722,22373060,1436
1857,m1411,20131121,3103,3098,3101,3105,3097,3099,3099,1,1,672,20825280,1964
1858,m1411,20131122,3099,3099,3103,3105,3099,3102,3101,3,2,994,30833040,2306
1859,m1411,20131125,3102,3101,3112,3135,3107,3108,3110,7,9,800,24884600,2498
1860,m1411,20131126,3108,3110,3118,3118,3106,3107,3109,-3,-1,718,22327340,2712
1861,m1411,20131127,3107,3109,3111,3129,3105,3125,3120,16,11,1832,57169180,2478
1862,m1411,20131128,3125,3120,3120,3123,3116,3120,3120,0,0,536,16726280,2606
1863,m1411,20131129,3120,3120,3129,3130,3117,3127,3125,7,5,966,30194900,2966
1864,m1411,20131202,3127,3125,3136,3145,3130,3145,3138,20,13,2744,86120520,4022
1865,m1411,20131203,3145,3138,3135,3148,3131,3145,3140,7,2,1346,42274500,4210
1866,m1411,20131204,3145,3140,3149,3244,3147,3174,3168,34,28,2928,92770400,5212
1867,m1411,20131205,3174,3168,3183,3198,3171,3178,3180,10,12,2322,73848440,5932
1868,m1411,20131206,3178,3180,3177,3180,3152,3163,3163,-17,-17,2608,82511620,7338
1869,m1411,20131209,3163,3163,3165,3186,3165,3182,3178,19,15,2836,90135480,7294
1870,m1411,20131210,3182,3178,3190,3200,3184,3187,3191,9,13,2224,70990040,7082
1871,m1411,20131211,3187,3191,3181,3191,3179,3188,3184,-3,-7,1552,49424140,7516
1872,m1411,20131212,3188,3184,3205,3205,3161,3163,3179,-21,-5,4086,129923340,9582
1873,m1411,20131213,3163,3179,3161,3161,3141,3150,3148,-29,-31,2244,70649500,10246
1874,m1411,20131216,3150,3148,3154,3172,3152,3165,3163,17,15,1910,60414200,9928
1875,m1411,20131217,3165,3163,3176,3200,3169,3191,3188,28,25,3650,116367000,8144
1876,m1411,20131218,3191,3188,3199,3203,3185,3186,3192,-2,4,2838,90595580,7436
1877,m1411,20131219,3186,3192,3171,3188,3163,3184,3181,-8,-11,720,22908580,7598
1878,m1411,20131220,3184,3181,3188,3188,3177,3186,3181,5,0,770,24494480,7548
1879,m1411,20131223,3186,3181,3195,3195,3179,3186,3185,5,4,1012,32241600,7358
1880,m1411,20131224,3186,3185,3180,3180,3136,3145,3155,-40,-30,3998,126162680,8368
1881,m1411,20131225,3145,3155,3151,3177,3142,3173,3160,18,5,2034,64288940,7744
1882,m1411,20131226,3173,3160,3180,3200,3175,3178,3181,18,21,1124,35762380,7712
1883,m1411,20131227,3178,3181,3168,3195,3161,3195,3183,14,2,1502,47809080,7296
1884,m1411,20131230,3195,3183,3198,3218,3170,3170,3194,-13,11,6964,222443900,6430
1885,m1411,20131231,3170,3194,3171,3182,3171,3177,3176,-17,-18,1050,33352520,6466
1886,m1412,20131217,3161,3153,3165,3185,3165,3180,3176,27,23,500,15884420,632
1887,m1412,20131218,3180,3176,3190,3193,3176,3181,3182,5,6,362,11520940,856
1888,m1412,20131219,3181,3182,3172,3183,3172,3176,3176,-6,-6,330,10482080,1046
1889,m1412,20131220,3176,3176,3180,3180,3167,3179,3174,3,-2,310,9839680,1136
1890,m1412,20131223,3179,3174,3183,3185,3175,3178,3180,4,6,428,13612920,1336
1891,m1412,20131224,3178,3180,3175,3175,3132,3139,3149,-41,-31,1200,37799820,2138
1892,m1412,20131225,3139,3149,3141,3167,3137,3163,3151,14,2,1012,31896160,2024
1893,m1412,20131226,3163,3151,3170,3180,3162,3168,3168,17,17,780,24715920,2028
1894,m1412,20131227,3168,3168,3161,3180,3156,3180,3166,12,-2,940,29761640,2150
1895,m1412,20131230,3180,3166,3185,3207,3160,3163,3181,-3,15,2260,71895660,2476
1896,m1412,20131231,3163,3181,3160,3172,3159,3169,3165,-12,-16,456,14434320,2726
