ROWNUM,合约,日期,前收盘价,前结算价,开盘价,最高价,最低价,收盘价,结算价,涨跌1,涨跌2,成交量,成交金额,持仓量
1,p1701,20170103,6380,6394,6438,6650,6438,6548,6578,154,184,1148,75532360,6432
2,p1701,20170104,6548,6578,6552,6558,6450,6450,6488,-128,-90,56,3634320,6426
3,p1701,20170105,6450,6488,6412,6450,6400,6434,6434,-54,-54,144,9266920,6426
4,p1701,20170106,6434,6434,0,0,0,6366,6366,-68,-68,0,0,6426
5,p1701,20170109,6366,6366,0,0,0,6366,6366,0,0,0,0,6426
6,p1701,20170110,6366,6366,0,0,0,6366,6366,0,0,0,0,6426
7,p1701,20170111,6366,6366,6744,6744,6334,6380,6356,14,-10,238,15129680,6188
8,p1701,20170112,6380,6356,0,0,0,6356,6356,0,0,0,0,6188
9,p1701,20170113,6356,6356,6392,6392,6392,6392,6392,36,36,2,127840,6186
10,p1701,20170116,6392,6392,0,0,0,6528,6528,136,136,0,0,0
11,p1702,20170103,6528,6528,0,0,0,6528,6528,0,0,0,0,18
12,p1702,20170104,6528,6528,0,0,0,6528,6528,0,0,0,0,18
13,p1702,20170105,6528,6528,0,0,0,6528,6528,0,0,0,0,18
14,p1702,20170106,6528,6528,0,0,0,6500,6500,-28,-28,0,0,18
15,p1702,20170109,6500,6500,6486,6486,6486,6486,6486,-14,-14,4,259440,14
16,p1702,20170110,6486,6486,0,0,0,6486,6486,0,0,0,0,14
17,p1702,20170111,6486,6486,0,0,0,6486,6486,0,0,0,0,14
18,p1702,20170112,6486,6486,0,0,0,6486,6486,0,0,0,0,14
19,p1702,20170113,6486,6486,0,0,0,6486,6486,0,0,0,0,14
20,p1702,20170116,6486,6486,0,0,0,6486,6486,0,0,0,0,14
21,p1702,20170117,6486,6486,0,0,0,6486,6486,0,0,0,0,14
22,p1702,20170118,6486,6486,0,0,0,6486,6486,0,0,0,0,14
23,p1702,20170119,6486,6486,6310,6310,6308,6308,6308,-178,-178,12,757160,12
24,p1702,20170120,6308,6308,0,0,0,6308,6308,0,0,0,0,12
25,p1702,20170123,6308,6308,6188,6188,6188,6188,6188,-120,-120,12,742560,0
26,p1702,20170124,6188,6188,6106,6460,6000,6296,6202,108,14,798,49499480,0
27,p1702,20170125,6296,6202,0,0,0,6202,6202,0,0,0,0,0
28,p1702,20170126,6202,6202,0,0,0,6202,6202,0,0,0,0,0
29,p1702,20170203,6202,6202,6202,6202,6202,6202,6202,0,0,8,496160,0
30,p1702,20170206,6202,6202,0,0,0,6202,6202,0,0,0,0,0
31,p1702,20170207,6202,6202,0,0,0,6202,6202,0,0,0,0,0
32,p1702,20170208,6202,6202,0,0,0,6202,6202,0,0,0,0,0
33,p1702,20170209,6202,6202,0,0,0,6202,6202,0,0,0,0,0
34,p1702,20170210,6202,6202,0,0,0,6202,6202,0,0,0,0,0
35,p1702,20170213,6202,6202,0,0,0,6202,6202,0,0,0,0,0
36,p1702,20170214,6202,6202,0,0,0,6202,6202,0,0,0,0,0
37,p1702,20170215,6202,6202,0,0,0,6202,6202,0,0,0,0,0
38,p1702,20170216,6202,6202,0,0,0,6202,6202,0,0,0,0,0
39,p1703,20170103,6214,6214,0,0,0,6214,6214,0,0,0,0,0
40,p1703,20170104,6214,6214,0,0,0,6214,6214,0,0,0,0,0
41,p1703,20170105,6214,6214,0,0,0,6214,6214,0,0,0,0,0
42,p1703,20170106,6214,6214,0,0,0,6214,6214,0,0,0,0,0
43,p1703,20170109,6214,6214,0,0,0,6214,6214,0,0,0,0,0
44,p1703,20170110,6214,6214,0,0,0,6214,6214,0,0,0,0,0
45,p1703,20170111,6214,6214,0,0,0,6214,6214,0,0,0,0,0
46,p1703,20170112,6214,6214,0,0,0,6214,6214,0,0,0,0,0
47,p1703,20170113,6214,6214,0,0,0,6214,6214,0,0,0,0,0
48,p1703,20170116,6214,6214,0,0,0,6214,6214,0,0,0,0,0
49,p1703,20170117,6214,6214,0,0,0,6214,6214,0,0,0,0,0
50,p1703,20170118,6214,6214,0,0,0,6214,6214,0,0,0,0,0
51,p1703,20170119,6214,6214,0,0,0,6044,6044,-170,-170,0,0,0
52,p1703,20170120,6044,6044,0,0,0,6044,6044,0,0,0,0,0
53,p1703,20170123,6044,6044,0,0,0,5930,5930,-114,-114,0,0,0
54,p1703,20170124,5930,5930,0,0,0,5942,5942,12,12,0,0,0
55,p1703,20170125,5942,5942,0,0,0,5942,5942,0,0,0,0,0
56,p1703,20170126,5942,5942,0,0,0,5942,5942,0,0,0,0,0
57,p1703,20170203,5942,5942,0,0,0,5942,5942,0,0,0,0,0
58,p1703,20170206,5942,5942,0,0,0,5942,5942,0,0,0,0,0
59,p1703,20170207,5942,5942,0,0,0,5942,5942,0,0,0,0,0
60,p1703,20170208,5942,5942,5938,6238,5938,6184,6116,242,174,114,6972960,0
61,p1703,20170209,6184,6116,0,0,0,6116,6116,0,0,0,0,0
62,p1703,20170210,6116,6116,0,0,0,6116,6116,0,0,0,0,0
63,p1703,20170213,6116,6116,0,0,0,6116,6116,0,0,0,0,0
64,p1703,20170214,6116,6116,0,0,0,6116,6116,0,0,0,0,0
65,p1703,20170215,6116,6116,0,0,0,6116,6116,0,0,0,0,0
66,p1703,20170216,6116,6116,0,0,0,6116,6116,0,0,0,0,0
67,p1703,20170217,6116,6116,0,0,0,6116,6116,0,0,0,0,0
68,p1703,20170220,6116,6116,0,0,0,6116,6116,0,0,0,0,0
69,p1703,20170221,6116,6116,0,0,0,6116,6116,0,0,0,0,0
70,p1703,20170222,6116,6116,0,0,0,6116,6116,0,0,0,0,0
71,p1703,20170223,6116,6116,0,0,0,6116,6116,0,0,0,0,0
72,p1703,20170224,6116,6116,0,0,0,6116,6116,0,0,0,0,0
73,p1703,20170227,6116,6116,0,0,0,6116,6116,0,0,0,0,0
74,p1703,20170228,6116,6116,0,0,0,6116,6116,0,0,0,0,0
75,p1703,20170301,6116,6116,0,0,0,6116,6116,0,0,0,0,0
76,p1703,20170302,6116,6116,0,0,0,6116,6116,0,0,0,0,0
77,p1703,20170303,6116,6116,0,0,0,6116,6116,0,0,0,0,0
78,p1703,20170306,6116,6116,0,0,0,6116,6116,0,0,0,0,0
79,p1703,20170307,6116,6116,0,0,0,6116,6116,0,0,0,0,0
80,p1703,20170308,6116,6116,0,0,0,6116,6116,0,0,0,0,0
81,p1703,20170309,6116,6116,0,0,0,6116,6116,0,0,0,0,0
82,p1703,20170310,6116,6116,0,0,0,6116,6116,0,0,0,0,0
83,p1703,20170313,6116,6116,0,0,0,6116,6116,0,0,0,0,0
84,p1703,20170314,6116,6116,0,0,0,6116,6116,0,0,0,0,0
85,p1704,20170103,6230,6230,0,0,0,6230,6230,0,0,0,0,4
86,p1704,20170104,6230,6230,0,0,0,6230,6230,0,0,0,0,4
87,p1704,20170105,6230,6230,0,0,0,6230,6230,0,0,0,0,4
88,p1704,20170106,6230,6230,0,0,0,6230,6230,0,0,0,0,4
89,p1704,20170109,6230,6230,6230,6536,5920,6146,6186,-84,-44,56,3465240,8
90,p1704,20170110,6146,6186,6126,6126,6126,6126,6126,-60,-60,2,122520,6
91,p1704,20170111,6126,6126,0,0,0,6126,6126,0,0,0,0,6
92,p1704,20170112,6126,6126,6346,6384,6302,6304,6346,178,220,54,3426920,12
93,p1704,20170113,6304,6346,6290,6290,6290,6290,6290,-56,-56,4,251600,8
94,p1704,20170116,6290,6290,6402,6432,6322,6322,6400,32,110,138,8834280,4
95,p1704,20170117,6322,6400,0,0,0,6400,6400,0,0,0,0,4
96,p1704,20170118,6400,6400,0,0,0,6364,6364,-36,-36,0,0,4
97,p1704,20170119,6364,6364,0,0,0,6364,6364,0,0,0,0,4
98,p1704,20170120,6364,6364,0,0,0,6364,6364,0,0,0,0,4
99,p1704,20170123,6364,6364,0,0,0,6364,6364,0,0,0,0,4
100,p1704,20170124,6364,6364,0,0,0,6364,6364,0,0,0,0,4
101,p1704,20170125,6364,6364,0,0,0,6364,6364,0,0,0,0,4
102,p1704,20170126,6364,6364,0,0,0,6364,6364,0,0,0,0,4
103,p1704,20170203,6364,6364,0,0,0,6298,6298,-66,-66,0,0,4
104,p1704,20170206,6298,6298,0,0,0,6298,6298,0,0,0,0,4
105,p1704,20170207,6298,6298,0,0,0,6298,6298,0,0,0,0,4
106,p1704,20170208,6298,6298,0,0,0,6298,6298,0,0,0,0,4
107,p1704,20170209,6298,6298,0,0,0,6298,6298,0,0,0,0,4
108,p1704,20170210,6298,6298,6168,6226,6168,6226,6196,-72,-102,4,247880,2
109,p1704,20170213,6226,6196,0,0,0,6196,6196,0,0,0,0,2
110,p1704,20170214,6196,6196,6238,6238,6148,6148,6192,-48,-4,4,247720,2
111,p1704,20170215,6148,6192,0,0,0,6192,6192,0,0,0,0,2
112,p1704,20170216,6192,6192,6034,6152,6034,6152,6092,-40,-100,4,243720,2
113,p1704,20170217,6152,6092,6022,6042,6022,6042,6032,-50,-60,4,241280,0
114,p1704,20170220,6042,6032,0,0,0,6032,6032,0,0,0,0,0
115,p1704,20170221,6032,6032,0,0,0,6032,6032,0,0,0,0,0
116,p1704,20170222,6032,6032,0,0,0,6032,6032,0,0,0,0,0
117,p1704,20170223,6032,6032,5990,5992,5860,5916,5952,-116,-80,136,8097040,2
118,p1704,20170224,5916,5952,0,0,0,5952,5952,0,0,0,0,2
119,p1704,20170227,5952,5952,0,0,0,5952,5952,0,0,0,0,2
120,p1704,20170228,5952,5952,0,0,0,5872,5872,-80,-80,0,0,2
121,p1704,20170301,5872,5872,0,0,0,5872,5872,0,0,0,0,2
122,p1704,20170302,5872,5872,0,0,0,5872,5872,0,0,0,0,2
123,p1704,20170303,5872,5872,0,0,0,5872,5872,0,0,0,0,2
124,p1704,20170306,5872,5872,6042,6080,5900,5900,6000,28,128,8,480040,2
125,p1704,20170307,5900,6000,0,0,0,6000,6000,0,0,0,0,2
126,p1704,20170308,6000,6000,5782,5890,5782,5890,5836,-110,-164,8,466880,2
127,p1704,20170309,5890,5836,0,0,0,5836,5836,0,0,0,0,2
128,p1704,20170310,5836,5836,5686,5830,5686,5830,5758,-6,-78,4,230320,0
129,p1704,20170313,5830,5758,0,0,0,5758,5758,0,0,0,0,0
130,p1704,20170314,5758,5758,0,0,0,5758,5758,0,0,0,0,0
131,p1704,20170315,5758,5758,0,0,0,5758,5758,0,0,0,0,0
132,p1704,20170316,5758,5758,0,0,0,5758,5758,0,0,0,0,0
133,p1704,20170317,5758,5758,0,0,0,5758,5758,0,0,0,0,0
134,p1704,20170320,5758,5758,0,0,0,5758,5758,0,0,0,0,0
135,p1704,20170321,5758,5758,0,0,0,5758,5758,0,0,0,0,0
136,p1704,20170322,5758,5758,0,0,0,5758,5758,0,0,0,0,0
137,p1704,20170323,5758,5758,0,0,0,5758,5758,0,0,0,0,0
138,p1704,20170324,5758,5758,5710,5910,5710,5910,5810,152,52,4,232400,0
139,p1704,20170327,5910,5810,0,0,0,5810,5810,0,0,0,0,0
140,p1704,20170328,5810,5810,0,0,0,5810,5810,0,0,0,0,0
141,p1704,20170329,5810,5810,0,0,0,5810,5810,0,0,0,0,0
142,p1704,20170330,5810,5810,0,0,0,5810,5810,0,0,0,0,0
143,p1704,20170331,5810,5810,0,0,0,5810,5810,0,0,0,0,0
144,p1704,20170405,5810,5810,0,0,0,5810,5810,0,0,0,0,0
145,p1704,20170406,5810,5810,0,0,0,5810,5810,0,0,0,0,0
146,p1704,20170407,5810,5810,0,0,0,5810,5810,0,0,0,0,0
147,p1704,20170410,5810,5810,0,0,0,5810,5810,0,0,0,0,0
148,p1704,20170411,5810,5810,0,0,0,5810,5810,0,0,0,0,0
149,p1704,20170412,5810,5810,0,0,0,5810,5810,0,0,0,0,0
150,p1704,20170413,5810,5810,0,0,0,5810,5810,0,0,0,0,0
151,p1704,20170414,5810,5810,0,0,0,5810,5810,0,0,0,0,0
152,p1704,20170417,5810,5810,0,0,0,5810,5810,0,0,0,0,0
153,p1704,20170418,5810,5810,0,0,0,5810,5810,0,0,0,0,0
154,p1705,20170103,6202,6220,6200,6328,6188,6240,6278,20,58,587462,36884830120,516636
155,p1705,20170104,6240,6278,6262,6318,6114,6170,6212,-108,-66,910296,56555102160,507594
156,p1705,20170105,6170,6212,6188,6216,6112,6134,6170,-78,-42,605182,37349070560,516650
157,p1705,20170106,6134,6170,6114,6182,6062,6066,6128,-104,-42,576876,35360997840,515804
158,p1705,20170109,6066,6128,6094,6156,6062,6132,6108,4,-20,561856,34321952600,507676
159,p1705,20170110,6132,6108,6124,6206,6098,6190,6148,82,40,714322,43916765160,509348
160,p1705,20170111,6190,6148,6148,6288,6142,6254,6212,106,64,812598,50481661240,515722
161,p1705,20170112,6254,6212,6252,6300,6230,6270,6264,58,52,588388,36865803400,522052
162,p1705,20170113,6270,6264,6272,6342,6240,6268,6288,4,24,677188,42582449760,526254
163,p1705,20170116,6268,6288,6264,6368,6238,6320,6306,32,18,652668,41159644800,518688
164,p1705,20170117,6320,6306,6330,6374,6272,6318,6320,12,14,520784,32920725280,508978
165,p1705,20170118,6318,6320,6352,6356,6284,6312,6316,-8,-4,451366,28515068280,485632
166,p1705,20170119,6312,6316,6304,6348,6268,6306,6308,-10,-8,431558,27228241720,474296
167,p1705,20170120,6306,6308,6302,6324,6254,6282,6290,-26,-18,373692,23505541960,458192
168,p1705,20170123,6282,6290,6280,6280,6216,6256,6246,-34,-44,343080,21431574720,448838
169,p1705,20170124,6256,6246,6246,6408,6246,6372,6330,126,84,496736,31445781360,471018
170,p1705,20170125,6372,6330,6378,6382,6274,6292,6334,-38,4,356636,22595185680,455122
171,p1705,20170126,6292,6334,6310,6336,6200,6208,6278,-126,-56,317400,19931712080,446644
172,p1705,20170203,6208,6278,6228,6256,6114,6122,6170,-156,-108,272410,16812211640,480380
173,p1705,20170206,6122,6170,6122,6170,6118,6140,6144,-30,-26,354758,21797138480,503474
174,p1705,20170207,6140,6144,6152,6188,6098,6124,6150,-20,6,378312,23268356320,530586
175,p1705,20170208,6124,6150,6124,6252,6118,6236,6196,86,46,583848,36184716440,521344
176,p1705,20170209,6236,6196,6218,6244,6186,6190,6220,-6,24,323144,20102740680,501168
177,p1705,20170210,6190,6220,6192,6288,6178,6284,6244,64,24,486388,30378718760,511472
178,p1705,20170213,6284,6244,6240,6302,6140,6146,6224,-98,-20,815044,50736189200,553036
179,p1705,20170214,6146,6224,6144,6184,6082,6088,6138,-136,-86,644586,39572942600,560358
180,p1705,20170215,6088,6138,6100,6136,6060,6112,6102,-26,-36,565642,34518883440,549226
181,p1705,20170216,6112,6102,6114,6156,6038,6044,6112,-58,10,654178,39987363960,550316
182,p1705,20170217,6044,6112,6014,6054,5906,5918,5978,-194,-134,735698,43981965000,555908
183,p1705,20170220,5918,5978,5900,5950,5888,5930,5922,-48,-56,414222,24536506960,541666
184,p1705,20170221,5930,5922,5908,5944,5856,5898,5906,-24,-16,608438,35937284120,526920
185,p1705,20170222,5898,5906,5868,5890,5820,5878,5852,-28,-54,544826,31891214080,530872
186,p1705,20170223,5878,5852,5890,5918,5760,5790,5844,-62,-8,648982,37934920200,534178
187,p1705,20170224,5790,5844,5800,5832,5730,5826,5792,-18,-52,479696,27786880960,502952
188,p1705,20170227,5826,5792,5842,5868,5784,5806,5830,14,38,496346,28945860640,504188
189,p1705,20170228,5806,5830,5780,5826,5742,5786,5782,-44,-48,530672,30689918000,516334
190,p1705,20170301,5786,5782,5826,5922,5818,5856,5864,74,82,659580,38683901920,497428
191,p1705,20170302,5856,5864,5898,5906,5844,5876,5872,12,8,426664,25059624160,485396
192,p1705,20170303,5876,5872,5880,5924,5822,5896,5878,24,6,513128,30170856440,470730
193,p1705,20170306,5896,5878,5894,5966,5858,5934,5910,56,32,482800,28540542080,442036
194,p1705,20170307,5934,5910,5920,5940,5852,5876,5892,-34,-18,386190,22758363360,434976
195,p1705,20170308,5876,5892,5870,5876,5764,5822,5814,-70,-78,463866,26975755080,414358
196,p1705,20170309,5822,5814,5848,5898,5788,5882,5858,68,44,674762,39533901680,392870
197,p1705,20170310,5882,5858,5848,5852,5694,5758,5778,-100,-80,639434,36958837040,379104
198,p1705,20170313,5758,5778,5740,5824,5740,5820,5782,42,4,387988,22438839920,364344
199,p1705,20170314,5820,5782,5762,5798,5740,5754,5768,-28,-14,436712,25193040960,357502
200,p1705,20170315,5754,5768,5780,5872,5710,5838,5802,70,34,449270,26071190600,347176
201,p1705,20170316,5838,5802,5888,5926,5850,5914,5892,112,90,436838,25740964800,328024
202,p1705,20170317,5914,5892,5930,5948,5868,5904,5910,12,18,300012,17730739280,305512
203,p1705,20170320,5904,5910,5924,5926,5846,5884,5880,-26,-30,277248,16305740680,251300
204,p1705,20170321,5884,5880,5870,5906,5834,5884,5878,4,-2,131890,7754166600,234900
205,p1705,20170322,5884,5878,5896,5924,5872,5894,5902,16,24,133734,7893784640,221438
206,p1705,20170323,5894,5902,5898,5914,5812,5820,5866,-82,-36,148912,8737513480,202834
207,p1705,20170324,5820,5866,5822,5846,5792,5808,5816,-58,-50,76172,4430475920,195386
208,p1705,20170327,5808,5816,5800,5826,5704,5716,5760,-100,-56,110606,6371292760,177962
209,p1705,20170328,5716,5760,5704,5752,5672,5720,5714,-40,-46,68652,3923036440,161350
210,p1705,20170329,5720,5714,5728,5760,5708,5730,5730,16,16,46076,2640675680,156040
211,p1705,20170330,5730,5730,5730,5746,5650,5664,5688,-66,-42,56112,3192438240,147854
212,p1705,20170331,5664,5688,5662,5718,5618,5668,5682,-20,-6,44702,2540325440,141274
213,p1705,20170405,5668,5682,5654,5776,5602,5772,5710,90,28,55388,3162857920,133498
214,p1705,20170406,5772,5710,5798,5800,5752,5788,5776,78,66,35282,2038012720,129088
215,p1705,20170407,5788,5776,5770,5800,5704,5756,5772,-20,-4,49876,2878920720,123146
216,p1705,20170410,5756,5772,5750,5816,5632,5636,5736,-136,-36,65724,3770771320,112440
217,p1705,20170411,5636,5736,5616,5662,5568,5652,5628,-84,-108,29120,1639066560,106798
218,p1705,20170412,5652,5628,5652,5680,5558,5560,5614,-68,-14,37736,2118884840,93962
219,p1705,20170413,5560,5614,5578,5666,5578,5660,5628,46,14,20590,1158941520,88212
220,p1705,20170414,5660,5628,5616,5632,5582,5630,5608,2,-20,16170,907045960,83460
221,p1705,20170417,5630,5608,5628,5712,5618,5686,5682,78,74,20178,1146515480,75636
222,p1705,20170418,5686,5682,5666,5734,5656,5656,5692,-26,10,22034,1254243440,65524
223,p1705,20170419,5656,5692,5634,5680,5600,5608,5638,-84,-54,22836,1287512320,56366
224,p1705,20170420,5608,5638,5620,5690,5584,5680,5628,42,-10,28744,1617970440,46836
225,p1705,20170421,5680,5628,5676,5712,5594,5608,5646,-20,18,16446,928792360,45398
226,p1705,20170424,5608,5646,5612,5640,5566,5578,5590,-68,-56,10020,560182560,39262
227,p1705,20170425,5578,5590,5570,5592,5398,5442,5482,-148,-108,11644,638434600,33206
228,p1705,20170426,5442,5482,5458,5490,5424,5470,5452,-12,-30,5092,277701120,30034
229,p1705,20170427,5470,5452,5498,5580,5476,5560,5546,108,94,7308,405355800,25986
230,p1705,20170428,5560,5546,5566,5580,5500,5580,5532,34,-14,8166,451818120,22998
231,p1705,20170502,5580,5532,5566,5650,5566,5620,5598,88,66,1228,68761720,22160
232,p1705,20170503,5620,5598,5648,5700,5620,5650,5650,52,52,144,8138360,22124
233,p1705,20170504,5650,5650,5600,5610,5570,5610,5580,-40,-70,74,4130000,22080
234,p1705,20170505,5610,5580,5620,5638,5600,5600,5602,20,22,398,22296360,22076
235,p1705,20170508,5600,5602,5650,5650,5650,5650,5650,48,48,2,113000,22076
236,p1705,20170509,5650,5650,5820,5820,5314,5550,5562,-100,-88,92,5117560,22134
237,p1705,20170510,5550,5562,5690,5690,5562,5688,5688,126,126,2074,117991480,20060
238,p1705,20170511,5688,5688,0,0,0,5688,5688,0,0,0,0,20060
239,p1705,20170512,5688,5688,0,0,0,5688,5688,0,0,0,0,20060
240,p1705,20170515,5688,5688,5350,5560,5350,5560,5642,-128,-46,50,2699280,0
241,p1706,20170103,6250,6250,0,0,0,6250,6250,0,0,0,0,14
242,p1706,20170104,6250,6250,6368,6368,6202,6202,6276,-48,26,14,878680,16
243,p1706,20170105,6202,6276,6202,6202,6202,6202,6202,-74,-74,4,248080,12
244,p1706,20170106,6202,6202,6152,6202,6152,6202,6178,0,-24,22,1359160,14
245,p1706,20170109,6202,6178,0,0,0,6178,6178,0,0,0,0,14
246,p1706,20170110,6178,6178,0,0,0,6178,6178,0,0,0,0,14
247,p1706,20170111,6178,6178,6230,6230,6204,6216,6218,38,40,10,621960,14
248,p1706,20170112,6216,6218,0,0,0,6218,6218,0,0,0,0,14
249,p1706,20170113,6218,6218,0,0,0,6218,6218,0,0,0,0,14
250,p1706,20170116,6218,6218,0,0,0,6234,6234,16,16,0,0,14
251,p1706,20170117,6234,6234,0,0,0,6234,6234,0,0,0,0,14
252,p1706,20170118,6234,6234,6234,6370,6228,6344,6320,110,86,90,5688720,16
253,p1706,20170119,6344,6320,6304,6352,6304,6352,6328,32,8,4,253120,14
254,p1706,20170120,6352,6328,6292,6292,6292,6292,6292,-36,-36,2,125840,14
255,p1706,20170123,6292,6292,6266,6276,6266,6270,6270,-22,-22,16,1003240,8
256,p1706,20170124,6270,6270,6338,6338,6310,6310,6324,40,54,4,252960,8
257,p1706,20170125,6310,6324,0,0,0,6324,6324,0,0,0,0,8
258,p1706,20170126,6324,6324,6318,6354,6318,6354,6336,30,12,4,253440,8
259,p1706,20170203,6354,6336,0,0,0,6300,6300,-36,-36,0,0,8
260,p1706,20170206,6300,6300,0,0,0,6300,6300,0,0,0,0,8
261,p1706,20170207,6300,6300,0,0,0,6300,6300,0,0,0,0,8
262,p1706,20170208,6300,6300,6224,6224,6224,6224,6224,-76,-76,4,248960,12
263,p1706,20170209,6224,6224,6220,6220,6216,6216,6218,-8,-6,4,248720,8
264,p1706,20170210,6216,6218,0,0,0,6218,6218,0,0,0,0,8
265,p1706,20170213,6218,6218,6252,6258,6108,6108,6174,-110,-44,26,1605720,22
266,p1706,20170214,6108,6174,0,0,0,6174,6174,0,0,0,0,22
267,p1706,20170215,6174,6174,6072,6114,6040,6040,6086,-134,-88,52,3165240,18
268,p1706,20170216,6040,6086,6096,6110,6080,6080,6094,-6,8,10,609560,14
269,p1706,20170217,6080,6094,0,0,0,6094,6094,0,0,0,0,14
270,p1706,20170220,6094,6094,0,0,0,6094,6094,0,0,0,0,14
271,p1706,20170221,6094,6094,5910,5910,5858,5858,5878,-236,-216,12,705560,14
272,p1706,20170222,5858,5878,5808,5822,5768,5822,5798,-56,-80,10,579840,16
273,p1706,20170223,5822,5798,5892,5928,5768,5768,5888,-30,90,34,2002320,14
274,p1706,20170224,5768,5888,5790,5834,5790,5834,5812,-54,-76,8,464960,14
275,p1706,20170227,5834,5812,0,0,0,5812,5812,0,0,0,0,14
276,p1706,20170228,5812,5812,5740,5740,5740,5740,5740,-72,-72,4,229600,12
277,p1706,20170301,5740,5740,5880,5942,5844,5856,5872,116,132,10,587320,10
278,p1706,20170302,5856,5872,0,0,0,5872,5872,0,0,0,0,10
279,p1706,20170303,5872,5872,0,0,0,5872,5872,0,0,0,0,10
280,p1706,20170306,5872,5872,0,0,0,5872,5872,0,0,0,0,10
281,p1706,20170307,5872,5872,5918,5918,5870,5870,5894,-2,22,6,353640,10
282,p1706,20170308,5870,5894,5778,5778,5778,5778,5778,-116,-116,2,115560,8
283,p1706,20170309,5778,5778,5798,5878,5798,5878,5838,100,60,4,233520,10
284,p1706,20170310,5878,5838,5834,5834,5662,5752,5760,-86,-78,8,460880,10
285,p1706,20170313,5752,5760,0,0,0,5760,5760,0,0,0,0,10
286,p1706,20170314,5760,5760,5776,5822,5742,5778,5776,18,16,72,4159560,42
287,p1706,20170315,5778,5776,5810,5810,5744,5796,5786,20,10,76,4398200,14
288,p1706,20170316,5796,5786,5884,5902,5858,5858,5880,72,94,40,2352600,20
289,p1706,20170317,5858,5880,5940,6100,5878,5894,5932,14,52,74,4390200,20
290,p1706,20170320,5894,5932,5902,5902,5850,5852,5852,-80,-80,258,15100680,256
291,p1706,20170321,5852,5852,5852,5878,5852,5878,5852,26,0,246,14399520,16
292,p1706,20170322,5878,5852,5852,5852,5852,5852,5852,0,0,2,117040,16
293,p1706,20170323,5852,5852,5856,5862,5820,5820,5846,-32,-6,8,467760,16
294,p1706,20170324,5820,5846,0,0,0,5846,5846,0,0,0,0,16
295,p1706,20170327,5846,5846,5812,5812,5778,5778,5794,-68,-52,4,231800,14
296,p1706,20170328,5778,5794,5698,5700,5600,5700,5640,-94,-154,16,902440,12
297,p1706,20170329,5700,5640,0,0,0,5662,5662,22,22,0,0,12
298,p1706,20170330,5662,5662,0,0,0,5662,5662,0,0,0,0,12
299,p1706,20170331,5662,5662,0,0,0,5662,5662,0,0,0,0,12
300,p1706,20170405,5662,5662,0,0,0,5662,5662,0,0,0,0,12
301,p1706,20170406,5662,5662,0,0,0,5726,5726,64,64,0,0,12
302,p1706,20170407,5726,5726,5730,5764,5686,5686,5716,-40,-10,8,457320,12
303,p1706,20170410,5686,5716,5716,5716,5716,5716,5716,0,0,2,114320,12
304,p1706,20170411,5716,5716,0,0,0,5716,5716,0,0,0,0,12
305,p1706,20170412,5716,5716,0,0,0,5716,5716,0,0,0,0,12
306,p1706,20170413,5716,5716,5646,5646,5644,5644,5644,-72,-72,6,338680,16
307,p1706,20170414,5644,5644,5594,5594,5574,5574,5586,-70,-58,6,335240,14
308,p1706,20170417,5574,5586,5556,5556,5556,5556,5556,-30,-30,6,333360,20
309,p1706,20170418,5556,5556,0,0,0,5564,5564,8,8,0,0,20
310,p1706,20170419,5564,5564,0,0,0,5564,5564,0,0,0,0,20
311,p1706,20170420,5564,5564,0,0,0,5564,5564,0,0,0,0,20
312,p1706,20170421,5564,5564,5342,5342,5342,5342,5342,-222,-222,2,106840,22
313,p1706,20170424,5342,5342,5464,5464,5320,5344,5398,2,56,8,431840,26
314,p1706,20170425,5344,5398,0,0,0,5398,5398,0,0,0,0,26
315,p1706,20170426,5398,5398,0,0,0,5398,5398,0,0,0,0,26
316,p1706,20170427,5398,5398,0,0,0,5490,5490,92,92,0,0,26
317,p1706,20170428,5490,5490,0,0,0,5490,5490,0,0,0,0,26
318,p1706,20170502,5490,5490,5526,5526,5526,5526,5526,36,36,2,110520,24
319,p1706,20170503,5526,5526,0,0,0,5526,5526,0,0,0,0,24
320,p1706,20170504,5526,5526,0,0,0,5526,5526,0,0,0,0,24
321,p1706,20170505,5526,5526,0,0,0,5526,5526,0,0,0,0,24
322,p1706,20170508,5526,5526,0,0,0,5526,5526,0,0,0,0,24
323,p1706,20170509,5526,5526,0,0,0,5440,5440,-86,-86,0,0,24
324,p1706,20170510,5440,5440,5406,5660,5406,5602,5556,162,116,6,333360,24
325,p1706,20170511,5602,5556,5352,5370,5352,5370,5358,-186,-198,8,428640,24
326,p1706,20170512,5370,5358,5604,5604,5604,5604,5604,246,246,2,112080,22
327,p1706,20170515,5604,5604,0,0,0,5604,5604,0,0,0,0,22
328,p1706,20170516,5604,5604,0,0,0,5604,5604,0,0,0,0,22
329,p1706,20170517,5604,5604,0,0,0,5604,5604,0,0,0,0,22
330,p1706,20170518,5604,5604,0,0,0,5604,5604,0,0,0,0,22
331,p1706,20170519,5604,5604,5566,5566,5566,5566,5566,-38,-38,4,222640,18
332,p1706,20170522,5566,5566,0,0,0,5566,5566,0,0,0,0,18
333,p1706,20170523,5566,5566,5704,5704,5704,5704,5704,138,138,2,114080,18
334,p1706,20170524,5704,5704,5734,5778,5734,5778,5746,74,42,14,804440,4
335,p1706,20170525,5778,5746,0,0,0,5746,5746,0,0,0,0,4
336,p1706,20170526,5746,5746,5910,5910,5910,5910,5910,164,164,2,118200,4
337,p1706,20170531,5910,5910,5800,6204,5800,6204,6002,294,92,4,240080,2
338,p1706,20170601,6204,6002,6362,6362,6362,6362,6362,360,360,2,127240,0
339,p1706,20170602,6362,6362,0,0,0,6362,6362,0,0,0,0,0
340,p1706,20170605,6362,6362,0,0,0,6362,6362,0,0,0,0,0
341,p1706,20170606,6362,6362,0,0,0,6362,6362,0,0,0,0,0
342,p1706,20170607,6362,6362,0,0,0,6362,6362,0,0,0,0,0
343,p1706,20170608,6362,6362,0,0,0,6362,6362,0,0,0,0,0
344,p1706,20170609,6362,6362,0,0,0,6362,6362,0,0,0,0,0
345,p1706,20170612,6362,6362,0,0,0,6362,6362,0,0,0,0,0
346,p1706,20170613,6362,6362,0,0,0,6362,6362,0,0,0,0,0
347,p1706,20170614,6362,6362,0,0,0,6362,6362,0,0,0,0,0
348,p1707,20170103,6196,6196,0,0,0,6196,6196,0,0,0,0,0
349,p1707,20170104,6196,6196,0,0,0,6196,6196,0,0,0,0,0
350,p1707,20170105,6196,6196,0,0,0,6196,6196,0,0,0,0,0
351,p1707,20170106,6196,6196,0,0,0,6174,6174,-22,-22,0,0,0
352,p1707,20170109,6174,6174,0,0,0,6174,6174,0,0,0,0,0
353,p1707,20170110,6174,6174,0,0,0,6174,6174,0,0,0,0,0
354,p1707,20170111,6174,6174,0,0,0,6174,6174,0,0,0,0,0
355,p1707,20170112,6174,6174,0,0,0,6174,6174,0,0,0,0,0
356,p1707,20170113,6174,6174,0,0,0,6174,6174,0,0,0,0,0
357,p1707,20170116,6174,6174,0,0,0,6190,6190,16,16,0,0,0
358,p1707,20170117,6190,6190,6246,6376,6246,6306,6338,116,148,208,13186840,4
359,p1707,20170118,6306,6338,0,0,0,6338,6338,0,0,0,0,4
360,p1707,20170119,6338,6338,0,0,0,6338,6338,0,0,0,0,4
361,p1707,20170120,6338,6338,0,0,0,6334,6334,-4,-4,0,0,4
362,p1707,20170123,6334,6334,0,0,0,6334,6334,0,0,0,0,4
363,p1707,20170124,6334,6334,0,0,0,6334,6334,0,0,0,0,4
364,p1707,20170125,6334,6334,0,0,0,6332,6332,-2,-2,0,0,4
365,p1707,20170126,6332,6332,6200,6200,6200,6200,6200,-132,-132,2,124000,2
366,p1707,20170203,6200,6200,0,0,0,6178,6178,-22,-22,0,0,2
367,p1707,20170206,6178,6178,0,0,0,6178,6178,0,0,0,0,2
368,p1707,20170207,6178,6178,0,0,0,6160,6160,-18,-18,0,0,2
369,p1707,20170208,6160,6160,0,0,0,6160,6160,0,0,0,0,2
370,p1707,20170209,6160,6160,0,0,0,6160,6160,0,0,0,0,2
371,p1707,20170210,6160,6160,6236,6236,6236,6236,6236,76,76,2,124720,0
372,p1707,20170213,6236,6236,6148,6148,6122,6122,6130,-114,-106,6,367840,6
373,p1707,20170214,6122,6130,6026,6026,6026,6026,6026,-104,-104,4,241040,10
374,p1707,20170215,6026,6026,6046,6046,6046,6046,6046,20,20,2,120920,8
375,p1707,20170216,6046,6046,6112,6112,6112,6112,6112,66,66,2,122240,8
376,p1707,20170217,6112,6112,0,0,0,5980,5980,-132,-132,0,0,8
377,p1707,20170220,5980,5980,0,0,0,5924,5924,-56,-56,0,0,8
378,p1707,20170221,5924,5924,0,0,0,5924,5924,0,0,0,0,8
379,p1707,20170222,5924,5924,5860,5860,5822,5822,5840,-102,-84,4,233640,8
380,p1707,20170223,5822,5840,0,0,0,5840,5840,0,0,0,0,8
381,p1707,20170224,5840,5840,0,0,0,5840,5840,0,0,0,0,8
382,p1707,20170227,5840,5840,0,0,0,5840,5840,0,0,0,0,8
383,p1707,20170228,5840,5840,5760,5760,5682,5746,5724,-94,-116,22,1259280,4
384,p1707,20170301,5746,5724,0,0,0,5724,5724,0,0,0,0,4
385,p1707,20170302,5724,5724,0,0,0,5730,5730,6,6,0,0,4
386,p1707,20170303,5730,5730,0,0,0,5734,5734,4,4,0,0,4
387,p1707,20170306,5734,5734,0,0,0,5764,5764,30,30,0,0,4
388,p1707,20170307,5764,5764,0,0,0,5784,5784,20,20,0,0,4
389,p1707,20170308,5784,5784,5806,5806,5806,5806,5806,22,22,2,116120,4
390,p1707,20170309,5806,5806,0,0,0,5806,5806,0,0,0,0,4
391,p1707,20170310,5806,5806,5698,5698,5698,5698,5698,-108,-108,2,113960,4
392,p1707,20170313,5698,5698,5690,5690,5690,5690,5690,-8,-8,2,113800,4
393,p1707,20170314,5690,5690,0,0,0,5690,5690,0,0,0,0,4
394,p1707,20170315,5690,5690,0,0,0,5690,5690,0,0,0,0,4
395,p1707,20170316,5690,5690,0,0,0,5782,5782,92,92,0,0,4
396,p1707,20170317,5782,5782,0,0,0,5782,5782,0,0,0,0,4
397,p1707,20170320,5782,5782,0,0,0,5706,5706,-76,-76,0,0,4
398,p1707,20170321,5706,5706,0,0,0,5706,5706,0,0,0,0,4
399,p1707,20170322,5706,5706,0,0,0,5706,5706,0,0,0,0,4
400,p1707,20170323,5706,5706,0,0,0,5702,5702,-4,-4,0,0,4
401,p1707,20170324,5702,5702,0,0,0,5702,5702,0,0,0,0,4
402,p1707,20170327,5702,5702,0,0,0,5652,5652,-50,-50,0,0,4
403,p1707,20170328,5652,5652,0,0,0,5502,5502,-150,-150,0,0,4
404,p1707,20170329,5502,5502,0,0,0,5516,5516,14,14,0,0,4
405,p1707,20170330,5516,5516,5516,5636,5516,5606,5570,90,54,24,1337240,4
406,p1707,20170331,5606,5570,0,0,0,5566,5566,-4,-4,0,0,4
407,p1707,20170405,5566,5566,0,0,0,5566,5566,0,0,0,0,4
408,p1707,20170406,5566,5566,0,0,0,5566,5566,0,0,0,0,4
409,p1707,20170407,5566,5566,0,0,0,5558,5558,-8,-8,0,0,4
410,p1707,20170410,5558,5558,0,0,0,5558,5558,0,0,0,0,4
411,p1707,20170411,5558,5558,0,0,0,5454,5454,-104,-104,0,0,4
412,p1707,20170412,5454,5454,0,0,0,5442,5442,-12,-12,0,0,4
413,p1707,20170413,5442,5442,0,0,0,5442,5442,0,0,0,0,4
414,p1707,20170414,5442,5442,0,0,0,5388,5388,-54,-54,0,0,4
415,p1707,20170417,5388,5388,0,0,0,5388,5388,0,0,0,0,4
416,p1707,20170418,5388,5388,0,0,0,5396,5396,8,8,0,0,4
417,p1707,20170419,5396,5396,0,0,0,5346,5346,-50,-50,0,0,4
418,p1707,20170420,5346,5346,0,0,0,5338,5338,-8,-8,0,0,4
419,p1707,20170421,5338,5338,0,0,0,5338,5338,0,0,0,0,4
420,p1707,20170424,5338,5338,0,0,0,5338,5338,0,0,0,0,4
421,p1707,20170425,5338,5338,0,0,0,5236,5236,-102,-102,0,0,4
422,p1707,20170426,5236,5236,0,0,0,5208,5208,-28,-28,0,0,4
423,p1707,20170427,5208,5208,0,0,0,5208,5208,0,0,0,0,4
424,p1707,20170428,5208,5208,0,0,0,5196,5196,-12,-12,0,0,4
425,p1707,20170502,5196,5196,5350,5350,5350,5350,5350,154,154,2,107000,2
426,p1707,20170503,5350,5350,0,0,0,5398,5398,48,48,0,0,2
427,p1707,20170504,5398,5398,0,0,0,5398,5398,0,0,0,0,2
428,p1707,20170505,5398,5398,5314,5314,5298,5306,5306,-92,-92,6,318360,2
429,p1707,20170508,5306,5306,5414,5414,5414,5414,5414,108,108,2,108280,2
430,p1707,20170509,5414,5414,5428,5428,5428,5428,5428,14,14,2,108560,2
431,p1707,20170510,5428,5428,0,0,0,5542,5542,114,114,0,0,2
432,p1707,20170511,5542,5542,0,0,0,5542,5542,0,0,0,0,2
433,p1707,20170512,5542,5542,5488,5488,5488,5488,5488,-54,-54,2,109760,4
434,p1707,20170515,5488,5488,0,0,0,5444,5444,-44,-44,0,0,4
435,p1707,20170516,5444,5444,0,0,0,5444,5444,0,0,0,0,4
436,p1707,20170517,5444,5444,0,0,0,5444,5444,0,0,0,0,4
437,p1707,20170518,5444,5444,0,0,0,5444,5444,0,0,0,0,4
438,p1707,20170519,5444,5444,0,0,0,5408,5408,-36,-36,0,0,4
439,p1707,20170522,5408,5408,0,0,0,5408,5408,0,0,0,0,4
440,p1707,20170523,5408,5408,0,0,0,5542,5542,134,134,0,0,4
441,p1707,20170524,5542,5542,0,0,0,5542,5542,0,0,0,0,4
442,p1707,20170525,5542,5542,0,0,0,5542,5542,0,0,0,0,4
443,p1707,20170526,5542,5542,0,0,0,5548,5548,6,6,0,0,4
444,p1707,20170531,5548,5548,0,0,0,5548,5548,0,0,0,0,4
445,p1707,20170601,5548,5548,0,0,0,5548,5548,0,0,0,0,4
446,p1707,20170602,5548,5548,5528,5528,5528,5528,5528,-20,-20,2,110560,2
447,p1707,20170605,5528,5528,0,0,0,5530,5530,2,2,0,0,2
448,p1707,20170606,5530,5530,0,0,0,5530,5530,0,0,0,0,2
449,p1707,20170607,5530,5530,0,0,0,5530,5530,0,0,0,0,2
450,p1707,20170608,5530,5530,0,0,0,5530,5530,0,0,0,0,2
451,p1707,20170609,5530,5530,0,0,0,5530,5530,0,0,0,0,2
452,p1707,20170612,5530,5530,0,0,0,5530,5530,0,0,0,0,2
453,p1707,20170613,5530,5530,0,0,0,5530,5530,0,0,0,0,2
454,p1707,20170614,5530,5530,0,0,0,5530,5530,0,0,0,0,2
455,p1707,20170615,5530,5530,5802,5802,5374,5374,5588,-156,58,4,223520,2
456,p1707,20170616,5374,5588,0,0,0,5588,5588,0,0,0,0,2
457,p1707,20170619,5588,5588,0,0,0,5588,5588,0,0,0,0,2
458,p1707,20170620,5588,5588,0,0,0,5588,5588,0,0,0,0,2
459,p1707,20170621,5588,5588,0,0,0,5588,5588,0,0,0,0,2
460,p1707,20170622,5588,5588,0,0,0,5588,5588,0,0,0,0,2
461,p1707,20170623,5588,5588,0,0,0,5588,5588,0,0,0,0,2
462,p1707,20170626,5588,5588,5568,5568,5568,5568,5568,-20,-20,2,111360,0
463,p1707,20170627,5568,5568,0,0,0,5568,5568,0,0,0,0,0
464,p1707,20170628,5568,5568,0,0,0,5568,5568,0,0,0,0,0
465,p1707,20170629,5568,5568,0,0,0,5568,5568,0,0,0,0,0
466,p1707,20170630,5568,5568,0,0,0,5568,5568,0,0,0,0,0
467,p1707,20170703,5568,5568,0,0,0,5568,5568,0,0,0,0,0
468,p1707,20170704,5568,5568,0,0,0,5568,5568,0,0,0,0,0
469,p1707,20170705,5568,5568,0,0,0,5568,5568,0,0,0,0,0
470,p1707,20170706,5568,5568,0,0,0,5568,5568,0,0,0,0,0
471,p1707,20170707,5568,5568,0,0,0,5568,5568,0,0,0,0,0
472,p1707,20170710,5568,5568,0,0,0,5568,5568,0,0,0,0,0
473,p1707,20170711,5568,5568,0,0,0,5568,5568,0,0,0,0,0
474,p1707,20170712,5568,5568,0,0,0,5568,5568,0,0,0,0,0
475,p1707,20170713,5568,5568,0,0,0,5568,5568,0,0,0,0,0
476,p1707,20170714,5568,5568,0,0,0,5568,5568,0,0,0,0,0
477,p1708,20170103,6084,6084,0,0,0,6084,6084,0,0,0,0,2
478,p1708,20170104,6084,6084,0,0,0,6084,6084,0,0,0,0,2
479,p1708,20170105,6084,6084,0,0,0,6084,6084,0,0,0,0,2
480,p1708,20170106,6084,6084,0,0,0,6084,6084,0,0,0,0,2
481,p1708,20170109,6084,6084,0,0,0,6084,6084,0,0,0,0,2
482,p1708,20170110,6084,6084,0,0,0,6084,6084,0,0,0,0,2
483,p1708,20170111,6084,6084,0,0,0,6084,6084,0,0,0,0,2
484,p1708,20170112,6084,6084,0,0,0,6084,6084,0,0,0,0,2
485,p1708,20170113,6084,6084,0,0,0,6084,6084,0,0,0,0,2
486,p1708,20170116,6084,6084,0,0,0,6100,6100,16,16,0,0,2
487,p1708,20170117,6100,6100,6100,6324,6100,6324,6212,224,112,4,248480,2
488,p1708,20170118,6324,6212,0,0,0,6212,6212,0,0,0,0,2
489,p1708,20170119,6212,6212,0,0,0,6212,6212,0,0,0,0,2
490,p1708,20170120,6212,6212,0,0,0,6212,6212,0,0,0,0,2
491,p1708,20170123,6212,6212,0,0,0,6212,6212,0,0,0,0,2
492,p1708,20170124,6212,6212,6142,6190,6140,6188,6164,-24,-48,40,2465800,6
493,p1708,20170125,6188,6164,0,0,0,6164,6164,0,0,0,0,6
494,p1708,20170126,6164,6164,0,0,0,6036,6036,-128,-128,0,0,6
495,p1708,20170203,6036,6036,0,0,0,6036,6036,0,0,0,0,6
496,p1708,20170206,6036,6036,0,0,0,6036,6036,0,0,0,0,6
497,p1708,20170207,6036,6036,0,0,0,6036,6036,0,0,0,0,6
498,p1708,20170208,6036,6036,0,0,0,5964,5964,-72,-72,0,0,6
499,p1708,20170209,5964,5964,0,0,0,5960,5960,-4,-4,0,0,6
500,p1708,20170210,5960,5960,0,0,0,6032,6032,72,72,0,0,6
501,p1708,20170213,6032,6032,6086,6086,6050,6050,6080,18,48,12,729600,18
502,p1708,20170214,6050,6080,5950,5950,5950,5950,5950,-130,-130,2,119000,16
503,p1708,20170215,5950,5950,0,0,0,5950,5950,0,0,0,0,16
504,p1708,20170216,5950,5950,5948,5948,5948,5948,5948,-2,-2,2,118960,16
505,p1708,20170217,5948,5948,0,0,0,5818,5818,-130,-130,0,0,16
506,p1708,20170220,5818,5818,0,0,0,5764,5764,-54,-54,0,0,16
507,p1708,20170221,5764,5764,0,0,0,5560,5560,-204,-204,0,0,16
508,p1708,20170222,5560,5560,0,0,0,5482,5482,-78,-78,0,0,16
509,p1708,20170223,5482,5482,0,0,0,5566,5566,84,84,0,0,16
510,p1708,20170224,5566,5566,5642,5642,5640,5640,5640,74,74,4,225640,14
511,p1708,20170227,5640,5640,0,0,0,5640,5640,0,0,0,0,14
512,p1708,20170228,5640,5640,5676,5676,5676,5676,5676,36,36,6,340560,8
513,p1708,20170301,5676,5676,0,0,0,5676,5676,0,0,0,0,8
514,p1708,20170302,5676,5676,5756,5756,5756,5756,5756,80,80,2,115120,6
515,p1708,20170303,5756,5756,0,0,0,5756,5756,0,0,0,0,6
516,p1708,20170306,5756,5756,0,0,0,5756,5756,0,0,0,0,6
517,p1708,20170307,5756,5756,0,0,0,5756,5756,0,0,0,0,6
518,p1708,20170308,5756,5756,0,0,0,5756,5756,0,0,0,0,6
519,p1708,20170309,5756,5756,0,0,0,5756,5756,0,0,0,0,6
520,p1708,20170310,5756,5756,5786,5786,5786,5786,5786,30,30,2,115720,6
521,p1708,20170313,5786,5786,0,0,0,5778,5778,-8,-8,0,0,6
522,p1708,20170314,5778,5778,5528,5588,5498,5582,5546,-196,-232,24,1331280,8
523,p1708,20170315,5582,5546,5534,5546,5534,5546,5538,0,-8,6,332280,6
524,p1708,20170316,5546,5538,0,0,0,5538,5538,0,0,0,0,6
525,p1708,20170317,5538,5538,0,0,0,5538,5538,0,0,0,0,6
526,p1708,20170320,5538,5538,0,0,0,5464,5464,-74,-74,0,0,6
527,p1708,20170321,5464,5464,0,0,0,5464,5464,0,0,0,0,6
528,p1708,20170322,5464,5464,0,0,0,5464,5464,0,0,0,0,6
529,p1708,20170323,5464,5464,5610,5688,5610,5620,5658,156,194,20,1131600,6
530,p1708,20170324,5620,5658,0,0,0,5610,5610,-48,-48,0,0,6
531,p1708,20170327,5610,5610,0,0,0,5562,5562,-48,-48,0,0,6
532,p1708,20170328,5562,5562,0,0,0,5562,5562,0,0,0,0,6
533,p1708,20170329,5562,5562,0,0,0,5576,5576,14,14,0,0,6
534,p1708,20170330,5576,5576,0,0,0,5630,5630,54,54,0,0,6
535,p1708,20170331,5630,5630,0,0,0,5626,5626,-4,-4,0,0,6
536,p1708,20170405,5626,5626,5356,5490,5356,5490,5422,-136,-204,4,216920,8
537,p1708,20170406,5490,5422,0,0,0,5422,5422,0,0,0,0,8
538,p1708,20170407,5422,5422,0,0,0,5422,5422,0,0,0,0,8
539,p1708,20170410,5422,5422,0,0,0,5422,5422,0,0,0,0,8
540,p1708,20170411,5422,5422,5310,5310,5306,5306,5308,-116,-114,6,318520,14
541,p1708,20170412,5306,5308,5310,5310,5288,5288,5302,-20,-6,6,318160,10
542,p1708,20170413,5288,5302,0,0,0,5302,5302,0,0,0,0,10
543,p1708,20170414,5302,5302,0,0,0,5302,5302,0,0,0,0,10
544,p1708,20170417,5302,5302,5284,5284,5284,5284,5284,-18,-18,2,105680,8
545,p1708,20170418,5284,5284,0,0,0,5284,5284,0,0,0,0,8
546,p1708,20170419,5284,5284,0,0,0,5284,5284,0,0,0,0,8
547,p1708,20170420,5284,5284,5144,5144,5144,5144,5144,-140,-140,2,102880,6
548,p1708,20170421,5144,5144,0,0,0,5144,5144,0,0,0,0,6
549,p1708,20170424,5144,5144,5252,5252,5206,5206,5228,62,84,4,209160,6
550,p1708,20170425,5206,5228,0,0,0,5228,5228,0,0,0,0,6
551,p1708,20170426,5228,5228,0,0,0,5228,5228,0,0,0,0,6
552,p1708,20170427,5228,5228,0,0,0,5228,5228,0,0,0,0,6
553,p1708,20170428,5228,5228,0,0,0,5228,5228,0,0,0,0,6
554,p1708,20170502,5228,5228,0,0,0,5228,5228,0,0,0,0,6
555,p1708,20170503,5228,5228,0,0,0,5228,5228,0,0,0,0,6
556,p1708,20170504,5228,5228,0,0,0,5228,5228,0,0,0,0,6
557,p1708,20170505,5228,5228,0,0,0,5228,5228,0,0,0,0,6
558,p1708,20170508,5228,5228,0,0,0,5334,5334,106,106,0,0,6
559,p1708,20170509,5334,5334,5354,5408,5354,5408,5374,74,40,10,537560,6
560,p1708,20170510,5408,5374,0,0,0,5374,5374,0,0,0,0,6
561,p1708,20170511,5374,5374,5362,5406,5362,5406,5384,32,10,4,215360,6
562,p1708,20170512,5406,5384,0,0,0,5332,5332,-52,-52,0,0,6
563,p1708,20170515,5332,5332,0,0,0,5290,5290,-42,-42,0,0,6
564,p1708,20170516,5290,5290,0,0,0,5290,5290,0,0,0,0,6
565,p1708,20170517,5290,5290,0,0,0,5290,5290,0,0,0,0,6
566,p1708,20170518,5290,5290,5544,5546,5526,5546,5542,256,252,70,3880200,70
567,p1708,20170519,5546,5542,5524,5538,5496,5496,5530,-46,-12,62,3429120,10
568,p1708,20170522,5496,5530,0,0,0,5530,5530,0,0,0,0,10
569,p1708,20170523,5530,5530,0,0,0,5530,5530,0,0,0,0,10
570,p1708,20170524,5530,5530,0,0,0,5530,5530,0,0,0,0,10
571,p1708,20170525,5530,5530,0,0,0,5530,5530,0,0,0,0,10
572,p1708,20170526,5530,5530,0,0,0,5530,5530,0,0,0,0,10
573,p1708,20170531,5530,5530,5380,5396,5340,5340,5374,-190,-156,8,429920,6
574,p1708,20170601,5340,5374,0,0,0,5374,5374,0,0,0,0,6
575,p1708,20170602,5374,5374,0,0,0,5374,5374,0,0,0,0,6
576,p1708,20170605,5374,5374,0,0,0,5374,5374,0,0,0,0,6
577,p1708,20170606,5374,5374,0,0,0,5374,5374,0,0,0,0,6
578,p1708,20170607,5374,5374,5178,5178,5178,5178,5178,-196,-196,2,103560,8
579,p1708,20170608,5178,5178,5328,5328,5328,5328,5328,150,150,2,106560,8
580,p1708,20170609,5328,5328,0,0,0,5328,5328,0,0,0,0,8
581,p1708,20170612,5328,5328,0,0,0,5328,5328,0,0,0,0,8
582,p1708,20170613,5328,5328,0,0,0,5328,5328,0,0,0,0,8
583,p1708,20170614,5328,5328,0,0,0,5328,5328,0,0,0,0,8
584,p1708,20170615,5328,5328,0,0,0,5328,5328,0,0,0,0,8
585,p1708,20170616,5328,5328,5428,5428,5398,5400,5412,72,84,8,433080,6
586,p1708,20170619,5400,5412,0,0,0,5422,5422,10,10,0,0,6
587,p1708,20170620,5422,5422,0,0,0,5422,5422,0,0,0,0,6
588,p1708,20170621,5422,5422,0,0,0,5422,5422,0,0,0,0,6
589,p1708,20170622,5422,5422,0,0,0,5422,5422,0,0,0,0,6
590,p1708,20170623,5422,5422,0,0,0,5422,5422,0,0,0,0,6
591,p1708,20170626,5422,5422,5312,5352,5286,5286,5316,-136,-106,44,2339720,8
592,p1708,20170627,5286,5316,5384,5384,5298,5312,5332,-4,16,28,1493320,8
593,p1708,20170628,5312,5332,0,0,0,5332,5332,0,0,0,0,8
594,p1708,20170629,5332,5332,5332,5332,5332,5332,5332,0,0,6,319920,2
595,p1708,20170630,5332,5332,0,0,0,5332,5332,0,0,0,0,2
596,p1708,20170703,5332,5332,0,0,0,5370,5370,38,38,0,0,2
597,p1708,20170704,5370,5370,0,0,0,5370,5370,0,0,0,0,2
598,p1708,20170705,5370,5370,5460,5462,5350,5462,5404,92,34,8,432440,2
599,p1708,20170706,5462,5404,0,0,0,5404,5404,0,0,0,0,2
600,p1708,20170707,5404,5404,5420,5420,5420,5420,5420,16,16,2,108400,2
601,p1708,20170710,5420,5420,0,0,0,5420,5420,0,0,0,0,2
602,p1708,20170711,5420,5420,0,0,0,5420,5420,0,0,0,0,2
603,p1708,20170712,5420,5420,0,0,0,5420,5420,0,0,0,0,2
604,p1708,20170713,5420,5420,0,0,0,5420,5420,0,0,0,0,2
605,p1708,20170714,5420,5420,5378,5500,5378,5500,5438,80,18,4,217560,0
606,p1708,20170717,5500,5438,0,0,0,5438,5438,0,0,0,0,0
607,p1708,20170718,5438,5438,5376,5490,5372,5420,5412,-18,-26,16,866160,0
608,p1708,20170719,5420,5412,0,0,0,5412,5412,0,0,0,0,0
609,p1708,20170720,5412,5412,5678,5678,5278,5450,5468,38,56,6,328120,0
610,p1708,20170721,5450,5468,0,0,0,5468,5468,0,0,0,0,0
611,p1708,20170724,5468,5468,0,0,0,5468,5468,0,0,0,0,0
612,p1708,20170725,5468,5468,0,0,0,5468,5468,0,0,0,0,0
613,p1708,20170726,5468,5468,0,0,0,5468,5468,0,0,0,0,0
614,p1708,20170727,5468,5468,0,0,0,5468,5468,0,0,0,0,0
615,p1708,20170728,5468,5468,5740,5740,5520,5520,5630,52,162,8,450400,0
616,p1708,20170731,5520,5630,0,0,0,5630,5630,0,0,0,0,0
617,p1708,20170801,5630,5630,0,0,0,5630,5630,0,0,0,0,0
618,p1708,20170802,5630,5630,0,0,0,5630,5630,0,0,0,0,0
619,p1708,20170803,5630,5630,0,0,0,5630,5630,0,0,0,0,0
620,p1708,20170804,5630,5630,0,0,0,5630,5630,0,0,0,0,0
621,p1708,20170807,5630,5630,0,0,0,5630,5630,0,0,0,0,0
622,p1708,20170808,5630,5630,0,0,0,5630,5630,0,0,0,0,0
623,p1708,20170809,5630,5630,0,0,0,5630,5630,0,0,0,0,0
624,p1708,20170810,5630,5630,0,0,0,5630,5630,0,0,0,0,0
625,p1708,20170811,5630,5630,0,0,0,5630,5630,0,0,0,0,0
626,p1708,20170814,5630,5630,0,0,0,5630,5630,0,0,0,0,0
627,p1709,20170103,6042,6054,6046,6150,6016,6062,6106,8,52,39184,2393031000,122218
628,p1709,20170104,6062,6106,6078,6126,5944,6000,6024,-106,-82,55282,3330422160,117380
629,p1709,20170105,6000,6024,6010,6030,5938,5958,5988,-66,-36,39462,2363104440,120888
630,p1709,20170106,5958,5988,5940,6008,5890,5894,5958,-94,-30,40348,2404682920,121860
631,p1709,20170109,5894,5958,5914,5980,5896,5960,5940,2,-18,41446,2462396800,121460
632,p1709,20170110,5960,5940,5950,6028,5944,6012,5976,72,36,63062,3769112280,126490
633,p1709,20170111,6012,5976,5980,6100,5970,6066,6022,90,46,62818,3783191360,126678
634,p1709,20170112,6066,6022,6066,6118,6052,6084,6084,62,62,44884,2730930520,127888
635,p1709,20170113,6084,6084,6086,6156,6058,6078,6102,-6,18,44410,2710245320,137170
636,p1709,20170116,6078,6102,6072,6172,6052,6130,6116,28,14,55538,3397350520,142670
637,p1709,20170117,6130,6116,6144,6178,6092,6128,6132,12,16,42528,2608288360,148068
638,p1709,20170118,6128,6132,6170,6192,6096,6120,6126,-12,-6,37838,2318553720,149066
639,p1709,20170119,6120,6126,6120,6156,6082,6114,6126,-12,0,45802,2805876800,157856
640,p1709,20170120,6114,6126,6120,6132,6072,6090,6096,-36,-30,31686,1932182640,161268
641,p1709,20170123,6090,6096,6070,6096,6038,6078,6070,-18,-26,29384,1783615280,161066
642,p1709,20170124,6078,6070,6074,6210,6070,6174,6146,104,76,48888,3005548200,159816
643,p1709,20170125,6174,6146,6182,6184,6090,6110,6136,-36,-10,27952,1715503800,159972
644,p1709,20170126,6110,6136,6120,6144,6022,6032,6090,-104,-46,34500,2101468080,162590
645,p1709,20170203,6032,6090,6022,6072,5944,5952,6000,-138,-90,36228,2173769760,168206
646,p1709,20170206,5952,6000,5960,6000,5950,5952,5968,-48,-32,53562,3197062160,180314
647,p1709,20170207,5952,5968,5974,5996,5916,5930,5958,-38,-10,44124,2629729200,187858
648,p1709,20170208,5930,5958,5930,6020,5922,5996,5972,38,14,85938,5133336120,200156
649,p1709,20170209,5996,5972,5988,6002,5960,5962,5986,-10,14,62880,3764367240,215532
650,p1709,20170210,5962,5986,5962,6022,5952,6010,5996,24,10,89366,5359215520,233332
651,p1709,20170213,6010,5996,5970,6016,5876,5882,5954,-114,-42,174616,10397706160,259614
652,p1709,20170214,5882,5954,5880,5914,5810,5820,5868,-134,-86,128014,7512277120,290922
653,p1709,20170215,5820,5868,5848,5884,5812,5846,5850,-22,-18,120198,7033458880,284292
654,p1709,20170216,5846,5850,5850,5892,5800,5800,5854,-50,4,123432,7226596240,282736
655,p1709,20170217,5800,5854,5782,5802,5672,5694,5738,-160,-116,162190,9306710160,303256
656,p1709,20170220,5694,5738,5668,5726,5666,5710,5698,-28,-40,98094,5590231600,302402
657,p1709,20170221,5710,5698,5690,5722,5652,5686,5692,-12,-6,154862,8817567920,315958
658,p1709,20170222,5686,5692,5652,5668,5620,5650,5642,-42,-50,125452,7079440160,335598
659,p1709,20170223,5650,5642,5656,5680,5562,5578,5620,-64,-22,170654,9592718560,343898
660,p1709,20170224,5578,5620,5584,5628,5552,5618,5596,-2,-24,172472,9654356040,341456
661,p1709,20170227,5618,5596,5636,5670,5600,5622,5638,26,42,166392,9384206720,359064
662,p1709,20170228,5622,5638,5602,5638,5576,5594,5604,-44,-34,182162,10211426840,366782
663,p1709,20170301,5594,5604,5630,5736,5624,5684,5680,80,76,310532,17643294160,415554
664,p1709,20170302,5684,5680,5706,5752,5692,5724,5714,44,34,204798,11705103120,417074
665,p1709,20170303,5724,5714,5728,5750,5688,5732,5724,18,10,204682,11716197360,425244
666,p1709,20170306,5732,5724,5726,5786,5706,5758,5744,34,20,174296,10014333400,421110
667,p1709,20170307,5758,5744,5756,5762,5682,5700,5718,-44,-26,184320,10540193880,424496
668,p1709,20170308,5700,5718,5702,5702,5598,5642,5640,-76,-78,200338,11302817880,426744
669,p1709,20170309,5642,5640,5670,5688,5590,5664,5654,24,14,285264,16131736640,430212
670,p1709,20170310,5664,5654,5638,5638,5506,5540,5570,-114,-84,335674,18697965560,443028
671,p1709,20170313,5540,5570,5524,5576,5506,5552,5540,-18,-30,285498,15820626080,439858
672,p1709,20170314,5552,5540,5500,5510,5458,5472,5482,-68,-58,314476,17244082080,470034
673,p1709,20170315,5472,5482,5494,5536,5422,5512,5492,30,10,295668,16241197680,484168
674,p1709,20170316,5512,5492,5544,5600,5526,5594,5564,102,72,395994,22040489200,469070
675,p1709,20170317,5594,5564,5610,5640,5588,5612,5614,48,50,301080,16907813680,461810
676,p1709,20170320,5612,5614,5624,5650,5588,5642,5622,28,8,420608,23654585200,506716
677,p1709,20170321,5642,5622,5626,5668,5570,5626,5622,4,0,421094,23682041600,513692
678,p1709,20170322,5626,5622,5638,5682,5622,5646,5654,24,32,550390,31129303680,534208
679,p1709,20170323,5646,5654,5650,5670,5534,5540,5608,-114,-46,681240,38211242640,537928
680,p1709,20170324,5540,5608,5536,5578,5512,5516,5540,-92,-68,445620,24688839360,543190
681,p1709,20170327,5516,5540,5508,5526,5388,5408,5446,-132,-94,523268,28500404400,548034
682,p1709,20170328,5408,5446,5404,5438,5362,5416,5402,-30,-44,399324,21574494480,535240
683,p1709,20170329,5416,5402,5420,5454,5406,5442,5434,40,32,366364,19912008280,546628
684,p1709,20170330,5442,5434,5436,5456,5334,5350,5394,-84,-40,481304,25961888440,558152
685,p1709,20170331,5350,5394,5336,5388,5308,5328,5358,-66,-36,321718,17241842560,543712
686,p1709,20170405,5328,5358,5306,5408,5252,5396,5350,38,-8,435628,23314119560,556516
687,p1709,20170406,5396,5350,5402,5434,5380,5416,5406,66,56,461112,24928099600,563232
688,p1709,20170407,5416,5406,5420,5426,5286,5350,5368,-56,-38,553476,29712319800,547502
689,p1709,20170410,5350,5368,5358,5448,5220,5226,5338,-142,-30,1136852,60700359640,621774
690,p1709,20170411,5226,5338,5226,5244,5178,5234,5218,-104,-120,585982,30585770040,598330
691,p1709,20170412,5234,5218,5250,5262,5152,5172,5206,-46,-12,714768,37219972160,575762
692,p1709,20170413,5172,5206,5186,5258,5180,5246,5218,40,12,437962,22858552240,548612
693,p1709,20170414,5246,5218,5206,5234,5164,5216,5206,-2,-12,484178,25212523960,570874
694,p1709,20170417,5216,5206,5216,5276,5212,5228,5244,22,38,465114,24396196480,558590
695,p1709,20170418,5228,5244,5220,5260,5164,5176,5210,-68,-34,489398,25506179360,581082
696,p1709,20170419,5176,5210,5154,5162,5084,5126,5122,-84,-88,609456,31228410960,574438
697,p1709,20170420,5126,5122,5106,5160,5092,5146,5126,24,4,577654,29619587480,569572
698,p1709,20170421,5146,5126,5156,5178,5120,5164,5152,38,26,444644,22908323080,558444
699,p1709,20170424,5164,5152,5168,5194,5154,5190,5174,38,22,472172,24438114240,555330
700,p1709,20170425,5190,5174,5190,5204,5046,5070,5116,-104,-58,688554,35228962640,617132
701,p1709,20170426,5070,5116,5084,5142,5078,5110,5108,-6,-8,461340,23572330200,580294
702,p1709,20170427,5110,5108,5142,5216,5134,5172,5176,64,68,549684,28457496040,552420
703,p1709,20170428,5172,5176,5150,5186,5122,5178,5156,2,-20,364144,18780891720,544298
704,p1709,20170502,5178,5156,5196,5268,5192,5246,5234,90,78,306406,16043073880,535860
705,p1709,20170503,5246,5234,5246,5258,5214,5234,5234,0,0,289278,15145302640,518820
706,p1709,20170504,5234,5234,5210,5228,5132,5206,5184,-28,-50,534162,27691159760,531948
707,p1709,20170505,5206,5184,5206,5250,5160,5200,5210,16,26,633892,33036721760,532756
708,p1709,20170508,5200,5210,5240,5360,5240,5354,5318,144,108,909230,48354781120,605038
709,p1709,20170509,5354,5318,5336,5374,5318,5370,5338,52,20,463814,24759899880,609382
710,p1709,20170510,5370,5338,5360,5404,5332,5354,5368,16,30,535594,28754548800,605420
711,p1709,20170511,5354,5368,5350,5522,5308,5514,5414,146,46,998646,54073152360,587666
712,p1709,20170512,5514,5414,5500,5510,5450,5492,5476,78,62,510292,27945507280,579486
713,p1709,20170515,5492,5476,5462,5542,5454,5472,5488,-4,12,540334,29658660800,575022
714,p1709,20170516,5472,5488,5500,5528,5462,5494,5494,6,6,513082,28198085920,582738
715,p1709,20170517,5494,5494,5500,5556,5460,5536,5514,42,20,648530,35760112800,585490
716,p1709,20170518,5536,5514,5556,5572,5478,5504,5514,-10,0,492000,27137246000,586434
717,p1709,20170519,5504,5514,5450,5528,5416,5476,5486,-38,-28,641690,35209834840,584466
718,p1709,20170522,5476,5486,5500,5594,5496,5554,5554,68,68,521108,28951482360,581274
719,p1709,20170523,5554,5554,5552,5576,5474,5488,5530,-66,-24,474302,26229751480,551000
720,p1709,20170524,5488,5530,5476,5496,5426,5450,5460,-80,-70,535984,29265862920,527430
721,p1709,20170525,5450,5460,5458,5476,5402,5440,5450,-20,-10,404200,22029610480,503894
722,p1709,20170526,5440,5450,5462,5476,5364,5380,5414,-70,-36,497074,26921099400,489000
723,p1709,20170531,5380,5414,5310,5332,5240,5244,5288,-170,-126,403030,21313292440,479544
724,p1709,20170601,5244,5288,5254,5286,5204,5226,5252,-62,-36,498834,26200881400,457392
725,p1709,20170602,5226,5252,5252,5282,5228,5236,5254,-16,2,397992,20912387160,441658
726,p1709,20170605,5236,5254,5210,5338,5188,5268,5276,14,22,539716,28483552320,446938
727,p1709,20170606,5268,5276,5258,5280,5204,5244,5242,-32,-34,496398,26021191640,458318
728,p1709,20170607,5244,5242,5250,5286,5162,5178,5218,-64,-24,620098,32358168640,500640
729,p1709,20170608,5178,5218,5170,5200,5136,5162,5162,-56,-56,485754,25081340800,486996
730,p1709,20170609,5162,5162,5158,5204,5156,5174,5182,12,20,377858,19583292200,489368
731,p1709,20170612,5174,5182,5176,5318,5166,5316,5252,134,70,562506,29544481200,474652
732,p1709,20170613,5316,5252,5300,5324,5232,5240,5274,-12,22,418032,22052422760,476444
733,p1709,20170614,5240,5274,5212,5260,5196,5242,5232,-32,-42,387836,20296626240,483268
734,p1709,20170615,5242,5232,5252,5282,5218,5238,5246,6,14,392872,20611428120,479924
735,p1709,20170616,5238,5246,5260,5356,5244,5320,5308,74,62,543922,28872363240,492656
736,p1709,20170619,5320,5308,5332,5412,5312,5380,5366,72,58,478752,25695841680,505782
737,p1709,20170620,5380,5366,5366,5374,5252,5270,5314,-96,-52,462096,24564821160,485404
738,p1709,20170621,5270,5314,5240,5260,5188,5208,5212,-106,-102,452188,23570967080,477648
739,p1709,20170622,5208,5212,5212,5234,5162,5180,5196,-32,-16,338694,17600706000,479606
740,p1709,20170623,5180,5196,5188,5222,5168,5208,5196,12,0,321904,16727496520,468796
741,p1709,20170626,5208,5196,5206,5226,5188,5210,5204,14,8,254094,13225332880,470506
742,p1709,20170627,5210,5204,5202,5246,5184,5232,5218,28,14,343394,17920937840,457548
743,p1709,20170628,5232,5218,5240,5288,5192,5222,5234,4,16,493564,25834397000,464386
744,p1709,20170629,5222,5234,5210,5280,5202,5268,5250,34,16,497264,26111645240,429956
745,p1709,20170630,5268,5250,5276,5316,5250,5304,5286,54,36,472840,24994540920,438838
746,p1709,20170703,5304,5286,5280,5400,5266,5342,5332,56,46,453324,24179994400,419546
747,p1709,20170704,5342,5332,5352,5360,5256,5272,5296,-60,-36,372888,19750732040,407124
748,p1709,20170705,5272,5296,5292,5348,5288,5338,5320,42,24,355108,18895869520,403936
749,p1709,20170706,5338,5320,5350,5446,5342,5412,5404,92,84,615350,33260872040,419134
750,p1709,20170707,5412,5404,5412,5446,5372,5418,5410,14,6,320444,17341232160,400974
751,p1709,20170710,5418,5410,5410,5526,5402,5502,5468,92,58,373568,20429911520,408668
752,p1709,20170711,5502,5468,5516,5540,5462,5510,5504,42,36,413776,22779796920,382148
753,p1709,20170712,5510,5504,5484,5538,5458,5478,5496,-26,-8,334232,18372899680,381986
754,p1709,20170713,5478,5496,5492,5508,5432,5456,5466,-40,-30,328806,17975290440,368656
755,p1709,20170714,5456,5466,5436,5450,5356,5396,5398,-70,-68,355860,19212370080,357950
756,p1709,20170717,5396,5398,5420,5482,5410,5426,5438,28,40,326958,17786198240,349196
757,p1709,20170718,5426,5438,5440,5464,5330,5336,5394,-102,-44,460302,24829732800,353066
758,p1709,20170719,5336,5394,5366,5372,5306,5366,5342,-28,-52,364864,19492571320,333986
759,p1709,20170720,5366,5342,5370,5436,5370,5410,5406,68,64,374994,20274801840,326184
760,p1709,20170721,5410,5406,5450,5480,5380,5406,5432,0,26,408320,22180769640,304184
761,p1709,20170724,5406,5432,5404,5418,5300,5336,5352,-96,-80,269874,14448555120,291260
762,p1709,20170725,5336,5352,5344,5456,5334,5452,5398,100,46,232110,12533532080,258666
763,p1709,20170726,5452,5398,5456,5476,5394,5406,5430,8,32,194430,10561009840,238466
764,p1709,20170727,5406,5430,5444,5500,5404,5484,5462,54,32,164690,8998232840,219342
765,p1709,20170728,5484,5462,5496,5510,5420,5438,5464,-24,2,141342,7724511040,208868
766,p1709,20170731,5438,5464,5452,5522,5440,5498,5486,34,22,106290,5833119280,198140
767,p1709,20170801,5498,5486,5486,5568,5480,5498,5532,12,46,145430,8045734400,197336
768,p1709,20170802,5498,5532,5486,5504,5448,5466,5470,-66,-62,83552,4571107440,193384
769,p1709,20170803,5466,5470,5478,5496,5368,5382,5434,-88,-36,106348,5780550240,181344
770,p1709,20170804,5382,5434,5398,5402,5356,5394,5382,-40,-52,70156,3776512200,167050
771,p1709,20170807,5394,5382,5402,5434,5364,5388,5400,6,18,58112,3138857400,159378
772,p1709,20170808,5388,5400,5380,5450,5356,5448,5418,48,18,74926,4059706920,143880
773,p1709,20170809,5448,5418,5454,5486,5444,5484,5466,66,48,49574,2710184320,136312
774,p1709,20170810,5484,5466,5480,5496,5412,5486,5460,20,-6,57762,3154432280,129598
775,p1709,20170811,5486,5460,5494,5556,5414,5448,5466,-12,6,69900,3821895800,111730
776,p1709,20170814,5448,5466,5482,5536,5434,5510,5480,44,14,54120,2965923120,102098
777,p1709,20170815,5510,5480,5496,5498,5438,5446,5466,-34,-14,44198,2416198240,92858
778,p1709,20170816,5446,5466,5400,5430,5362,5368,5400,-98,-66,39498,2133124520,83882
779,p1709,20170817,5368,5400,5398,5414,5370,5402,5392,2,-8,25442,1371909200,76056
780,p1709,20170818,5402,5392,5404,5470,5390,5470,5424,78,32,20492,1111676440,70272
781,p1709,20170821,5470,5424,5472,5510,5458,5496,5490,72,66,28714,1576497520,59108
782,p1709,20170822,5496,5490,5510,5600,5486,5594,5540,104,50,27448,1520767800,48968
783,p1709,20170823,5594,5540,5576,5610,5534,5566,5566,26,26,17100,951988160,43256
784,p1709,20170824,5566,5566,5572,5612,5522,5610,5570,44,4,15048,838271120,36892
785,p1709,20170825,5610,5570,5620,5640,5560,5564,5596,-6,26,13238,741021840,30362
786,p1709,20170828,5564,5596,5562,5590,5480,5540,5550,-56,-46,15722,872584400,23186
787,p1709,20170829,5540,5550,5518,5536,5462,5468,5488,-82,-62,6278,344609000,19192
788,p1709,20170830,5468,5488,5466,5506,5446,5446,5476,-42,-12,8134,445568720,14316
789,p1709,20170831,5446,5476,5460,5490,5434,5454,5452,-22,-24,8246,449649840,11620
790,p1709,20170901,5454,5452,5490,5528,5490,5520,5510,68,58,694,38250600,11378
791,p1709,20170904,5520,5510,5510,5560,5510,5560,5534,50,24,230,12730400,11188
792,p1709,20170905,5560,5534,5556,5590,5482,5590,5552,56,18,432,23987680,10918
793,p1709,20170906,5590,5552,0,0,0,5552,5552,0,0,0,0,10918
794,p1709,20170907,5552,5552,5550,5550,5550,5550,5550,-2,-2,36,1998000,10882
795,p1709,20170908,5550,5550,5560,5560,5560,5560,5560,10,10,800,44480000,10882
796,p1709,20170911,5560,5560,5574,5680,5560,5680,5602,120,42,232,12996640,10800
797,p1709,20170912,5680,5602,5668,5668,5668,5668,5668,66,66,48,2720640,10800
798,p1709,20170913,5668,5668,5780,5790,5780,5790,5784,122,116,100,5784000,10800
799,p1709,20170914,5790,5784,5780,5780,5780,5780,5558,-4,-226,20,1156000,0
800,p1710,20170103,6172,6172,0,0,0,6172,6172,0,0,0,0,4
801,p1710,20170104,6172,6172,0,0,0,6090,6090,-82,-82,0,0,4
802,p1710,20170105,6090,6090,0,0,0,6054,6054,-36,-36,0,0,4
803,p1710,20170106,6054,6054,0,0,0,6054,6054,0,0,0,0,4
804,p1710,20170109,6054,6054,0,0,0,6054,6054,0,0,0,0,4
805,p1710,20170110,6054,6054,0,0,0,6054,6054,0,0,0,0,4
806,p1710,20170111,6054,6054,0,0,0,6054,6054,0,0,0,0,4
807,p1710,20170112,6054,6054,0,0,0,6116,6116,62,62,0,0,4
808,p1710,20170113,6116,6116,0,0,0,6134,6134,18,18,0,0,4
809,p1710,20170116,6134,6134,0,0,0,6134,6134,0,0,0,0,4
810,p1710,20170117,6134,6134,0,0,0,6134,6134,0,0,0,0,4
811,p1710,20170118,6134,6134,0,0,0,6134,6134,0,0,0,0,4
812,p1710,20170119,6134,6134,0,0,0,6134,6134,0,0,0,0,4
813,p1710,20170120,6134,6134,0,0,0,6134,6134,0,0,0,0,4
814,p1710,20170123,6134,6134,0,0,0,6134,6134,0,0,0,0,4
815,p1710,20170124,6134,6134,6100,6176,6100,6140,6126,6,-8,120,7351200,4
816,p1710,20170125,6140,6126,0,0,0,6126,6126,0,0,0,0,4
817,p1710,20170126,6126,6126,6234,6234,6230,6230,6232,104,106,8,498640,12
818,p1710,20170203,6230,6232,0,0,0,6232,6232,0,0,0,0,12
819,p1710,20170206,6232,6232,0,0,0,6232,6232,0,0,0,0,12
820,p1710,20170207,6232,6232,0,0,0,6232,6232,0,0,0,0,12
821,p1710,20170208,6232,6232,0,0,0,6144,6144,-88,-88,0,0,12
822,p1710,20170209,6144,6144,0,0,0,6144,6144,0,0,0,0,12
823,p1710,20170210,6144,6144,0,0,0,6144,6144,0,0,0,0,12
824,p1710,20170213,6144,6144,6032,6040,6032,6040,6036,-104,-108,4,241440,12
825,p1710,20170214,6040,6036,5954,5954,5954,5954,5954,-82,-82,2,119080,12
826,p1710,20170215,5954,5954,0,0,0,5954,5954,0,0,0,0,12
827,p1710,20170216,5954,5954,0,0,0,5904,5904,-50,-50,0,0,12
828,p1710,20170217,5904,5904,0,0,0,5772,5772,-132,-132,0,0,12
829,p1710,20170220,5772,5772,0,0,0,5772,5772,0,0,0,0,12
830,p1710,20170221,5772,5772,5644,5698,5644,5698,5656,-74,-116,16,905200,18
831,p1710,20170222,5698,5656,0,0,0,5656,5656,0,0,0,0,18
832,p1710,20170223,5656,5656,5636,5650,5636,5650,5640,-6,-16,12,676880,16
833,p1710,20170224,5650,5640,5506,5586,5506,5586,5544,-54,-96,12,665320,20
834,p1710,20170227,5586,5544,5596,5596,5596,5596,5596,52,52,2,111920,20
835,p1710,20170228,5596,5596,5596,5598,5560,5586,5588,-10,-8,12,670640,22
836,p1710,20170301,5586,5588,5610,5654,5610,5654,5620,66,32,8,449680,22
837,p1710,20170302,5654,5620,5740,5740,5724,5724,5738,104,118,18,1032880,10
838,p1710,20170303,5724,5738,0,0,0,5738,5738,0,0,0,0,10
839,p1710,20170306,5738,5738,5786,5786,5786,5786,5786,48,48,2,115720,10
840,p1710,20170307,5786,5786,5770,5770,5674,5674,5722,-112,-64,4,228880,6
841,p1710,20170308,5674,5722,0,0,0,5722,5722,0,0,0,0,6
842,p1710,20170309,5722,5722,0,0,0,5722,5722,0,0,0,0,6
843,p1710,20170310,5722,5722,0,0,0,5722,5722,0,0,0,0,6
844,p1710,20170313,5722,5722,0,0,0,5722,5722,0,0,0,0,6
845,p1710,20170314,5722,5722,0,0,0,5542,5542,-180,-180,0,0,6
846,p1710,20170315,5542,5542,0,0,0,5542,5542,0,0,0,0,6
847,p1710,20170316,5542,5542,5682,5682,5570,5570,5640,28,98,458,25838720,12
848,p1710,20170317,5570,5640,5616,5616,5616,5616,5616,-24,-24,2,112320,10
849,p1710,20170320,5616,5616,5346,5670,5346,5606,5540,-10,-76,6,332440,10
850,p1710,20170321,5606,5540,5552,5552,5552,5552,5552,12,12,2,111040,12
851,p1710,20170322,5552,5552,5684,5684,5684,5684,5684,132,132,2,113680,10
852,p1710,20170323,5684,5684,5620,5620,5524,5524,5562,-160,-122,22,1223640,10
853,p1710,20170324,5524,5562,0,0,0,5562,5562,0,0,0,0,10
854,p1710,20170327,5562,5562,0,0,0,5562,5562,0,0,0,0,10
855,p1710,20170328,5562,5562,0,0,0,5562,5562,0,0,0,0,10
856,p1710,20170329,5562,5562,5452,5452,5452,5452,5452,-110,-110,2,109040,10
857,p1710,20170330,5452,5452,5368,5368,5368,5368,5368,-84,-84,2,107360,10
858,p1710,20170331,5368,5368,5384,5384,5384,5384,5384,16,16,2,107680,10
859,p1710,20170405,5384,5384,0,0,0,5384,5384,0,0,0,0,10
860,p1710,20170406,5384,5384,0,0,0,5384,5384,0,0,0,0,10
861,p1710,20170407,5384,5384,0,0,0,5384,5384,0,0,0,0,10
862,p1710,20170410,5384,5384,5436,5436,5386,5386,5410,2,26,4,216440,10
863,p1710,20170411,5386,5410,0,0,0,5246,5246,-164,-164,0,0,10
864,p1710,20170412,5246,5246,0,0,0,5246,5246,0,0,0,0,10
865,p1710,20170413,5246,5246,0,0,0,5246,5246,0,0,0,0,10
866,p1710,20170414,5246,5246,5198,5198,5148,5168,5172,-78,-74,10,517200,10
867,p1710,20170417,5168,5172,0,0,0,5172,5172,0,0,0,0,10
868,p1710,20170418,5172,5172,5262,5262,5262,5262,5262,90,90,4,210480,12
869,p1710,20170419,5262,5262,0,0,0,5262,5262,0,0,0,0,12
870,p1710,20170420,5262,5262,0,0,0,5162,5162,-100,-100,0,0,12
871,p1710,20170421,5162,5162,0,0,0,5162,5162,0,0,0,0,12
872,p1710,20170424,5162,5162,0,0,0,5162,5162,0,0,0,0,12
873,p1710,20170425,5162,5162,0,0,0,5162,5162,0,0,0,0,12
874,p1710,20170426,5162,5162,0,0,0,5162,5162,0,0,0,0,12
875,p1710,20170427,5162,5162,5186,5186,5138,5146,5162,-16,0,14,722680,10
876,p1710,20170428,5146,5162,0,0,0,5162,5162,0,0,0,0,10
877,p1710,20170502,5162,5162,0,0,0,5162,5162,0,0,0,0,10
878,p1710,20170503,5162,5162,0,0,0,5162,5162,0,0,0,0,10
879,p1710,20170504,5162,5162,0,0,0,5114,5114,-48,-48,0,0,10
880,p1710,20170505,5114,5114,5114,5234,5114,5214,5170,100,56,184,9515080,14
881,p1710,20170508,5214,5170,0,0,0,5276,5276,106,106,0,0,14
882,p1710,20170509,5276,5276,0,0,0,5276,5276,0,0,0,0,14
883,p1710,20170510,5276,5276,5308,5308,5308,5308,5308,32,32,4,212320,14
884,p1710,20170511,5308,5308,5350,5350,5350,5350,5350,42,42,2,107000,14
885,p1710,20170512,5350,5350,5472,5472,5354,5354,5412,4,62,4,216520,14
886,p1710,20170515,5354,5412,5402,5458,5402,5458,5430,46,18,4,217200,16
887,p1710,20170516,5458,5430,5478,5478,5462,5462,5472,32,42,12,656680,16
888,p1710,20170517,5462,5472,5488,5498,5486,5498,5494,26,22,14,769160,10
889,p1710,20170518,5498,5494,0,0,0,5494,5494,0,0,0,0,10
890,p1710,20170519,5494,5494,0,0,0,5494,5494,0,0,0,0,10
891,p1710,20170522,5494,5494,0,0,0,5494,5494,0,0,0,0,10
892,p1710,20170523,5494,5494,0,0,0,5492,5492,-2,-2,0,0,10
893,p1710,20170524,5492,5492,0,0,0,5468,5468,-24,-24,0,0,10
894,p1710,20170525,5468,5468,0,0,0,5442,5442,-26,-26,0,0,10
895,p1710,20170526,5442,5442,0,0,0,5442,5442,0,0,0,0,10
896,p1710,20170531,5442,5442,0,0,0,5254,5254,-188,-188,0,0,10
897,p1710,20170601,5254,5254,0,0,0,5254,5254,0,0,0,0,10
898,p1710,20170602,5254,5254,5254,5254,5238,5238,5248,-16,-6,6,314920,12
899,p1710,20170605,5238,5248,5268,5268,5268,5268,5268,20,20,4,210720,10
900,p1710,20170606,5268,5268,0,0,0,5268,5268,0,0,0,0,10
901,p1710,20170607,5268,5268,0,0,0,5268,5268,0,0,0,0,10
902,p1710,20170608,5268,5268,5132,5174,5132,5174,5152,-94,-116,4,206120,8
903,p1710,20170609,5174,5152,0,0,0,5152,5152,0,0,0,0,8
904,p1710,20170612,5152,5152,0,0,0,5220,5220,68,68,0,0,8
905,p1710,20170613,5220,5220,0,0,0,5220,5220,0,0,0,0,8
906,p1710,20170614,5220,5220,5258,5258,5210,5210,5234,-10,14,8,418720,6
907,p1710,20170615,5210,5234,5268,5268,5210,5242,5248,8,14,38,1994240,20
908,p1710,20170616,5242,5248,5236,5360,5236,5300,5326,52,78,140,7458480,6
909,p1710,20170619,5300,5326,0,0,0,5330,5330,4,4,0,0,6
910,p1710,20170620,5330,5330,0,0,0,5330,5330,0,0,0,0,6
911,p1710,20170621,5330,5330,0,0,0,5330,5330,0,0,0,0,6
912,p1710,20170622,5330,5330,0,0,0,5302,5302,-28,-28,0,0,6
913,p1710,20170623,5302,5302,0,0,0,5302,5302,0,0,0,0,6
914,p1710,20170626,5302,5302,0,0,0,5302,5302,0,0,0,0,6
915,p1710,20170627,5302,5302,5194,5236,5194,5218,5216,-84,-86,6,312960,6
916,p1710,20170628,5218,5216,0,0,0,5216,5216,0,0,0,0,6
917,p1710,20170629,5216,5216,0,0,0,5230,5230,14,14,0,0,6
918,p1710,20170630,5230,5230,0,0,0,5264,5264,34,34,0,0,6
919,p1710,20170703,5264,5264,0,0,0,5292,5292,28,28,0,0,6
920,p1710,20170704,5292,5292,5344,5344,5240,5240,5270,-52,-22,40,2108440,6
921,p1710,20170705,5240,5270,5340,5340,5340,5340,5340,70,70,2,106800,4
922,p1710,20170706,5340,5340,0,0,0,5340,5340,0,0,0,0,4
923,p1710,20170707,5340,5340,0,0,0,5340,5340,0,0,0,0,4
924,p1710,20170710,5340,5340,0,0,0,5396,5396,56,56,0,0,4
925,p1710,20170711,5396,5396,0,0,0,5396,5396,0,0,0,0,4
926,p1710,20170712,5396,5396,0,0,0,5396,5396,0,0,0,0,4
927,p1710,20170713,5396,5396,0,0,0,5368,5368,-28,-28,0,0,4
928,p1710,20170714,5368,5368,0,0,0,5368,5368,0,0,0,0,4
929,p1710,20170717,5368,5368,0,0,0,5368,5368,0,0,0,0,4
930,p1710,20170718,5368,5368,5446,5446,5310,5310,5358,-58,-10,6,321520,6
931,p1710,20170719,5310,5358,5364,5374,5320,5374,5352,16,-6,6,321160,8
932,p1710,20170720,5374,5352,0,0,0,5416,5416,64,64,0,0,8
933,p1710,20170721,5416,5416,5448,5470,5448,5470,5458,54,42,4,218360,8
934,p1710,20170724,5470,5458,5370,5370,5312,5312,5340,-146,-118,4,213640,4
935,p1710,20170725,5312,5340,0,0,0,5340,5340,0,0,0,0,4
936,p1710,20170726,5340,5340,0,0,0,5340,5340,0,0,0,0,4
937,p1710,20170727,5340,5340,0,0,0,5370,5370,30,30,0,0,4
938,p1710,20170728,5370,5370,0,0,0,5370,5370,0,0,0,0,4
939,p1710,20170731,5370,5370,0,0,0,5390,5390,20,20,0,0,4
940,p1710,20170801,5390,5390,0,0,0,5434,5434,44,44,0,0,4
941,p1710,20170802,5434,5434,5660,5660,5322,5486,5488,52,54,16,878080,8
942,p1710,20170803,5486,5488,0,0,0,5488,5488,0,0,0,0,8
943,p1710,20170804,5488,5488,0,0,0,5488,5488,0,0,0,0,8
944,p1710,20170807,5488,5488,0,0,0,5488,5488,0,0,0,0,8
945,p1710,20170808,5488,5488,0,0,0,5488,5488,0,0,0,0,8
946,p1710,20170809,5488,5488,5542,5542,5392,5426,5452,-62,-36,6,327200,4
947,p1710,20170810,5426,5452,0,0,0,5452,5452,0,0,0,0,4
948,p1710,20170811,5452,5452,5474,5474,5366,5366,5420,-86,-32,4,216800,4
949,p1710,20170814,5366,5420,0,0,0,5432,5432,12,12,0,0,4
950,p1710,20170815,5432,5432,0,0,0,5432,5432,0,0,0,0,4
951,p1710,20170816,5432,5432,0,0,0,5432,5432,0,0,0,0,4
952,p1710,20170817,5432,5432,0,0,0,5432,5432,0,0,0,0,4
953,p1710,20170818,5432,5432,5302,5370,5302,5370,5336,-62,-96,4,213440,2
954,p1710,20170821,5370,5336,0,0,0,5400,5400,64,64,0,0,2
955,p1710,20170822,5400,5400,0,0,0,5448,5448,48,48,0,0,2
956,p1710,20170823,5448,5448,0,0,0,5472,5472,24,24,0,0,2
957,p1710,20170824,5472,5472,0,0,0,5474,5474,2,2,0,0,2
958,p1710,20170825,5474,5474,0,0,0,5498,5498,24,24,0,0,2
959,p1710,20170828,5498,5498,5454,5454,5454,5454,5454,-44,-44,10,545400,12
960,p1710,20170829,5454,5454,5530,5530,5528,5528,5528,74,74,4,221160,8
961,p1710,20170830,5528,5528,5526,5526,5526,5526,5526,-2,-2,6,331560,2
962,p1710,20170831,5526,5526,0,0,0,5526,5526,0,0,0,0,2
963,p1710,20170901,5526,5526,0,0,0,5526,5526,0,0,0,0,2
964,p1710,20170904,5526,5526,0,0,0,5526,5526,0,0,0,0,2
965,p1710,20170905,5526,5526,0,0,0,5542,5542,16,16,0,0,2
966,p1710,20170906,5542,5542,0,0,0,5542,5542,0,0,0,0,2
967,p1710,20170907,5542,5542,5566,5566,5566,5566,5566,24,24,2,111320,0
968,p1710,20170908,5566,5566,0,0,0,5576,5576,10,10,0,0,0
969,p1710,20170911,5576,5576,0,0,0,5618,5618,42,42,0,0,0
970,p1710,20170912,5618,5618,0,0,0,5618,5618,0,0,0,0,0
971,p1710,20170913,5618,5618,0,0,0,5732,5732,114,114,0,0,0
972,p1710,20170914,5732,5732,0,0,0,5510,5510,-222,-222,0,0,0
973,p1710,20170915,5510,5510,5688,5774,5688,5774,5730,264,220,80,4584240,0
974,p1710,20170918,5774,5730,0,0,0,5730,5730,0,0,0,0,0
975,p1710,20170919,5730,5730,0,0,0,5730,5730,0,0,0,0,0
976,p1710,20170920,5730,5730,0,0,0,5730,5730,0,0,0,0,0
977,p1710,20170921,5730,5730,0,0,0,5730,5730,0,0,0,0,0
978,p1710,20170922,5730,5730,0,0,0,5730,5730,0,0,0,0,0
979,p1710,20170925,5730,5730,0,0,0,5730,5730,0,0,0,0,0
980,p1710,20170926,5730,5730,0,0,0,5730,5730,0,0,0,0,0
981,p1710,20170927,5730,5730,0,0,0,5730,5730,0,0,0,0,0
982,p1710,20170928,5730,5730,5688,5688,5512,5512,5600,-218,-130,4,224000,0
983,p1710,20170929,5512,5600,0,0,0,5600,5600,0,0,0,0,0
984,p1710,20171009,5600,5600,0,0,0,5600,5600,0,0,0,0,0
985,p1710,20171010,5600,5600,0,0,0,5600,5600,0,0,0,0,0
986,p1710,20171011,5600,5600,0,0,0,5600,5600,0,0,0,0,0
987,p1710,20171012,5600,5600,0,0,0,5600,5600,0,0,0,0,0
988,p1710,20171013,5600,5600,0,0,0,5600,5600,0,0,0,0,0
989,p1710,20171016,5600,5600,0,0,0,5600,5600,0,0,0,0,0
990,p1710,20171017,5600,5600,0,0,0,5600,5600,0,0,0,0,0
991,p1710,20171018,5600,5600,0,0,0,5600,5600,0,0,0,0,0
992,p1710,20171019,5600,5600,0,0,0,5600,5600,0,0,0,0,0
993,p1710,20171020,5600,5600,0,0,0,5600,5600,0,0,0,0,0
994,p1711,20170103,6154,6154,0,0,0,6154,6154,0,0,0,0,0
995,p1711,20170104,6154,6154,6078,6078,6024,6024,6050,-130,-104,4,242040,2
996,p1711,20170105,6024,6050,0,0,0,6050,6050,0,0,0,0,2
997,p1711,20170106,6050,6050,0,0,0,6050,6050,0,0,0,0,2
998,p1711,20170109,6050,6050,0,0,0,6050,6050,0,0,0,0,2
999,p1711,20170110,6050,6050,0,0,0,6086,6086,36,36,0,0,2
1000,p1711,20170111,6086,6086,0,0,0,6086,6086,0,0,0,0,2
1001,p1711,20170112,6086,6086,0,0,0,6086,6086,0,0,0,0,2
1002,p1711,20170113,6086,6086,0,0,0,6086,6086,0,0,0,0,2
1003,p1711,20170116,6086,6086,0,0,0,6118,6118,32,32,0,0,2
1004,p1711,20170117,6118,6118,0,0,0,6118,6118,0,0,0,0,2
1005,p1711,20170118,6118,6118,0,0,0,6118,6118,0,0,0,0,2
1006,p1711,20170119,6118,6118,0,0,0,6118,6118,0,0,0,0,2
1007,p1711,20170120,6118,6118,0,0,0,6118,6118,0,0,0,0,2
1008,p1711,20170123,6118,6118,0,0,0,6118,6118,0,0,0,0,2
1009,p1711,20170124,6118,6118,6100,6240,6070,6198,6148,80,30,130,7993480,0
1010,p1711,20170125,6198,6148,0,0,0,6148,6148,0,0,0,0,0
1011,p1711,20170126,6148,6148,0,0,0,6148,6148,0,0,0,0,0
1012,p1711,20170203,6148,6148,0,0,0,6148,6148,0,0,0,0,0
1013,p1711,20170206,6148,6148,0,0,0,6116,6116,-32,-32,0,0,0
1014,p1711,20170207,6116,6116,0,0,0,6106,6106,-10,-10,0,0,0
1015,p1711,20170208,6106,6106,0,0,0,6106,6106,0,0,0,0,0
1016,p1711,20170209,6106,6106,0,0,0,6106,6106,0,0,0,0,0
1017,p1711,20170210,6106,6106,0,0,0,6106,6106,0,0,0,0,0
1018,p1711,20170213,6106,6106,0,0,0,6000,6000,-106,-106,0,0,0
1019,p1711,20170214,6000,6000,0,0,0,5920,5920,-80,-80,0,0,0
1020,p1711,20170215,5920,5920,0,0,0,5920,5920,0,0,0,0,0
1021,p1711,20170216,5920,5920,0,0,0,5918,5918,-2,-2,0,0,0
1022,p1711,20170217,5918,5918,0,0,0,5802,5802,-116,-116,0,0,0
1023,p1711,20170220,5802,5802,0,0,0,5802,5802,0,0,0,0,0
1024,p1711,20170221,5802,5802,0,0,0,5686,5686,-116,-116,0,0,0
1025,p1711,20170222,5686,5686,0,0,0,5686,5686,0,0,0,0,0
1026,p1711,20170223,5686,5686,0,0,0,5670,5670,-16,-16,0,0,0
1027,p1711,20170224,5670,5670,0,0,0,5670,5670,0,0,0,0,0
1028,p1711,20170227,5670,5670,0,0,0,5658,5658,-12,-12,0,0,0
1029,p1711,20170228,5658,5658,0,0,0,5654,5654,-4,-4,0,0,0
1030,p1711,20170301,5654,5654,0,0,0,5654,5654,0,0,0,0,0
1031,p1711,20170302,5654,5654,0,0,0,5702,5702,48,48,0,0,0
1032,p1711,20170303,5702,5702,0,0,0,5702,5702,0,0,0,0,0
1033,p1711,20170306,5702,5702,0,0,0,5702,5702,0,0,0,0,0
1034,p1711,20170307,5702,5702,0,0,0,5702,5702,0,0,0,0,0
1035,p1711,20170308,5702,5702,0,0,0,5702,5702,0,0,0,0,0
1036,p1711,20170309,5702,5702,0,0,0,5702,5702,0,0,0,0,0
1037,p1711,20170310,5702,5702,0,0,0,5618,5618,-84,-84,0,0,0
1038,p1711,20170313,5618,5618,0,0,0,5618,5618,0,0,0,0,0
1039,p1711,20170314,5618,5618,5486,5840,5340,5506,5606,-112,-12,1310,73440120,190
1040,p1711,20170315,5506,5606,5540,5606,5540,5580,5584,-26,-22,100,5585680,146
1041,p1711,20170316,5580,5584,5608,5608,5568,5580,5576,-4,-8,62,3458320,126
1042,p1711,20170317,5580,5576,5596,5596,5588,5588,5590,12,14,6,335440,120
1043,p1711,20170320,5588,5590,0,0,0,5590,5590,0,0,0,0,120
1044,p1711,20170321,5590,5590,0,0,0,5590,5590,0,0,0,0,120
1045,p1711,20170322,5590,5590,5614,5614,5586,5610,5602,20,12,6,336200,124
1046,p1711,20170323,5610,5602,0,0,0,5482,5482,-120,-120,0,0,124
1047,p1711,20170324,5482,5482,0,0,0,5482,5482,0,0,0,0,124
1048,p1711,20170327,5482,5482,0,0,0,5482,5482,0,0,0,0,124
1049,p1711,20170328,5482,5482,5340,5340,5340,5340,5340,-142,-142,10,534000,114
1050,p1711,20170329,5340,5340,5100,5436,5100,5430,5392,90,52,18,970560,114
1051,p1711,20170330,5430,5392,5392,5400,5340,5340,5376,-52,-16,16,860400,126
1052,p1711,20170331,5340,5376,0,0,0,5376,5376,0,0,0,0,126
1053,p1711,20170405,5376,5376,0,0,0,5376,5376,0,0,0,0,126
1054,p1711,20170406,5376,5376,5460,5550,5380,5426,5432,50,56,42,2282080,122
1055,p1711,20170407,5426,5432,5406,5406,5404,5404,5404,-28,-28,6,324280,122
1056,p1711,20170410,5404,5404,5248,5274,5178,5252,5246,-152,-158,14,734600,132
1057,p1711,20170411,5252,5246,5286,5292,5236,5236,5252,-10,6,60,3151760,166
1058,p1711,20170412,5236,5252,5254,5254,5248,5248,5248,-4,-4,8,419960,166
1059,p1711,20170413,5248,5248,0,0,0,5248,5248,0,0,0,0,166
1060,p1711,20170414,5248,5248,0,0,0,5248,5248,0,0,0,0,166
1061,p1711,20170417,5248,5248,0,0,0,5248,5248,0,0,0,0,166
1062,p1711,20170418,5248,5248,0,0,0,5248,5248,0,0,0,0,166
1063,p1711,20170419,5248,5248,5150,5174,5150,5174,5160,-74,-88,8,412880,166
1064,p1711,20170420,5174,5160,5160,5160,5160,5160,5160,0,0,4,206400,166
1065,p1711,20170421,5160,5160,0,0,0,5160,5160,0,0,0,0,166
1066,p1711,20170424,5160,5160,5198,5198,5198,5198,5198,38,38,6,311880,166
1067,p1711,20170425,5198,5198,0,0,0,5140,5140,-58,-58,0,0,166
1068,p1711,20170426,5140,5140,0,0,0,5140,5140,0,0,0,0,166
1069,p1711,20170427,5140,5140,0,0,0,5140,5140,0,0,0,0,166
1070,p1711,20170428,5140,5140,5228,5228,5220,5226,5224,86,84,22,1149480,166
1071,p1711,20170502,5226,5224,0,0,0,5224,5224,0,0,0,0,166
1072,p1711,20170503,5224,5224,0,0,0,5224,5224,0,0,0,0,166
1073,p1711,20170504,5224,5224,0,0,0,5224,5224,0,0,0,0,166
1074,p1711,20170505,5224,5224,0,0,0,5224,5224,0,0,0,0,166
1075,p1711,20170508,5224,5224,5296,5356,5296,5340,5336,116,112,10,533680,156
1076,p1711,20170509,5340,5336,5408,5408,5408,5408,5408,72,72,2,108160,158
1077,p1711,20170510,5408,5408,5394,5442,5386,5442,5404,34,-4,8,432320,154
1078,p1711,20170511,5442,5404,5368,5504,5368,5440,5428,36,24,12,651440,154
1079,p1711,20170512,5440,5428,5444,5448,5444,5448,5444,20,16,12,653360,146
1080,p1711,20170515,5448,5444,5478,5478,5456,5456,5462,12,18,6,327800,146
1081,p1711,20170516,5456,5462,0,0,0,5462,5462,0,0,0,0,146
1082,p1711,20170517,5462,5462,0,0,0,5462,5462,0,0,0,0,146
1083,p1711,20170518,5462,5462,0,0,0,5462,5462,0,0,0,0,146
1084,p1711,20170519,5462,5462,0,0,0,5462,5462,0,0,0,0,146
1085,p1711,20170522,5462,5462,0,0,0,5462,5462,0,0,0,0,146
1086,p1711,20170523,5462,5462,5442,5446,5440,5440,5442,-22,-20,32,1741520,128
1087,p1711,20170524,5440,5442,0,0,0,5374,5374,-68,-68,0,0,128
1088,p1711,20170525,5374,5374,0,0,0,5366,5366,-8,-8,0,0,128
1089,p1711,20170526,5366,5366,5390,5390,5390,5390,5390,24,24,2,107800,128
1090,p1711,20170531,5390,5390,5160,5160,5160,5160,5160,-230,-230,2,103200,128
1091,p1711,20170601,5160,5160,0,0,0,5148,5148,-12,-12,0,0,128
1092,p1711,20170602,5148,5148,0,0,0,5148,5148,0,0,0,0,128
1093,p1711,20170605,5148,5148,0,0,0,5148,5148,0,0,0,0,128
1094,p1711,20170606,5148,5148,0,0,0,5148,5148,0,0,0,0,128
1095,p1711,20170607,5148,5148,0,0,0,5108,5108,-40,-40,0,0,128
1096,p1711,20170608,5108,5108,0,0,0,5094,5094,-14,-14,0,0,128
1097,p1711,20170609,5094,5094,0,0,0,5094,5094,0,0,0,0,128
1098,p1711,20170612,5094,5094,5140,5140,5140,5140,5140,46,46,2,102800,126
1099,p1711,20170613,5140,5140,0,0,0,5140,5140,0,0,0,0,126
1100,p1711,20170614,5140,5140,0,0,0,5140,5140,0,0,0,0,126
1101,p1711,20170615,5140,5140,5178,5178,5118,5118,5148,-22,8,4,205920,124
1102,p1711,20170616,5118,5148,0,0,0,5148,5148,0,0,0,0,124
1103,p1711,20170619,5148,5148,5220,5240,5220,5240,5230,92,82,12,627600,118
1104,p1711,20170620,5240,5230,0,0,0,5230,5230,0,0,0,0,118
1105,p1711,20170621,5230,5230,5140,5140,5140,5140,5140,-90,-90,6,308400,114
1106,p1711,20170622,5140,5140,0,0,0,5140,5140,0,0,0,0,114
1107,p1711,20170623,5140,5140,0,0,0,5140,5140,0,0,0,0,114
1108,p1711,20170626,5140,5140,0,0,0,5140,5140,0,0,0,0,114
1109,p1711,20170627,5140,5140,0,0,0,5058,5058,-82,-82,0,0,114
1110,p1711,20170628,5058,5058,0,0,0,5058,5058,0,0,0,0,114
1111,p1711,20170629,5058,5058,0,0,0,5072,5072,14,14,0,0,114
1112,p1711,20170630,5072,5072,0,0,0,5106,5106,34,34,0,0,114
1113,p1711,20170703,5106,5106,5170,5170,5170,5170,5170,64,64,2,103400,114
1114,p1711,20170704,5170,5170,5134,5238,5134,5238,5186,68,16,4,207440,114
1115,p1711,20170705,5238,5186,0,0,0,5186,5186,0,0,0,0,114
1116,p1711,20170706,5186,5186,5238,5254,5238,5254,5252,68,66,88,4623200,30
1117,p1711,20170707,5254,5252,0,0,0,5252,5252,0,0,0,0,30
1118,p1711,20170710,5252,5252,0,0,0,5308,5308,56,56,0,0,30
1119,p1711,20170711,5308,5308,0,0,0,5308,5308,0,0,0,0,30
1120,p1711,20170712,5308,5308,0,0,0,5320,5320,12,12,0,0,30
1121,p1711,20170713,5320,5320,0,0,0,5292,5292,-28,-28,0,0,30
1122,p1711,20170714,5292,5292,0,0,0,5292,5292,0,0,0,0,30
1123,p1711,20170717,5292,5292,0,0,0,5292,5292,0,0,0,0,30
1124,p1711,20170718,5292,5292,0,0,0,5292,5292,0,0,0,0,30
1125,p1711,20170719,5292,5292,5272,5282,5272,5282,5276,-10,-16,18,949800,16
1126,p1711,20170720,5282,5276,0,0,0,5338,5338,62,62,0,0,16
1127,p1711,20170721,5338,5338,5370,5382,5370,5382,5374,44,36,6,322440,14
1128,p1711,20170724,5382,5374,5350,5354,5350,5354,5352,-20,-22,6,321160,8
1129,p1711,20170725,5354,5352,5404,5404,5404,5404,5404,52,52,2,108080,6
1130,p1711,20170726,5404,5404,5406,5406,5406,5406,5406,2,2,2,108120,4
1131,p1711,20170727,5406,5406,0,0,0,5428,5428,22,22,0,0,4
1132,p1711,20170728,5428,5428,0,0,0,5428,5428,0,0,0,0,4
1133,p1711,20170731,5428,5428,0,0,0,5448,5448,20,20,0,0,4
1134,p1711,20170801,5448,5448,0,0,0,5448,5448,0,0,0,0,4
1135,p1711,20170802,5448,5448,0,0,0,5448,5448,0,0,0,0,4
1136,p1711,20170803,5448,5448,0,0,0,5448,5448,0,0,0,0,4
1137,p1711,20170804,5448,5448,0,0,0,5448,5448,0,0,0,0,4
1138,p1711,20170807,5448,5448,0,0,0,5448,5448,0,0,0,0,4
1139,p1711,20170808,5448,5448,5426,5450,5424,5450,5436,2,-12,8,435000,6
1140,p1711,20170809,5450,5436,5460,5460,5460,5460,5460,24,24,2,109200,8
1141,p1711,20170810,5460,5460,0,0,0,5460,5460,0,0,0,0,8
1142,p1711,20170811,5460,5460,5536,5536,5408,5498,5484,38,24,8,438800,10
1143,p1711,20170814,5498,5484,5486,5508,5478,5508,5484,24,0,10,548560,4
1144,p1711,20170815,5508,5484,0,0,0,5484,5484,0,0,0,0,4
1145,p1711,20170816,5484,5484,0,0,0,5418,5418,-66,-66,0,0,4
1146,p1711,20170817,5418,5418,0,0,0,5418,5418,0,0,0,0,4
1147,p1711,20170818,5418,5418,0,0,0,5418,5418,0,0,0,0,4
1148,p1711,20170821,5418,5418,0,0,0,5418,5418,0,0,0,0,4
1149,p1711,20170822,5418,5418,0,0,0,5466,5466,48,48,0,0,4
1150,p1711,20170823,5466,5466,0,0,0,5490,5490,24,24,0,0,4
1151,p1711,20170824,5490,5490,0,0,0,5492,5492,2,2,0,0,4
1152,p1711,20170825,5492,5492,0,0,0,5516,5516,24,24,0,0,4
1153,p1711,20170828,5516,5516,0,0,0,5472,5472,-44,-44,0,0,4
1154,p1711,20170829,5472,5472,0,0,0,5546,5546,74,74,0,0,4
1155,p1711,20170830,5546,5546,0,0,0,5546,5546,0,0,0,0,4
1156,p1711,20170831,5546,5546,0,0,0,5546,5546,0,0,0,0,4
1157,p1711,20170901,5546,5546,0,0,0,5604,5604,58,58,0,0,4
1158,p1711,20170904,5604,5604,0,0,0,5604,5604,0,0,0,0,4
1159,p1711,20170905,5604,5604,5610,5610,5610,5610,5610,6,6,2,112200,4
1160,p1711,20170906,5610,5610,0,0,0,5610,5610,0,0,0,0,4
1161,p1711,20170907,5610,5610,0,0,0,5610,5610,0,0,0,0,4
1162,p1711,20170908,5610,5610,0,0,0,5610,5610,0,0,0,0,4
1163,p1711,20170911,5610,5610,0,0,0,5652,5652,42,42,0,0,4
1164,p1711,20170912,5652,5652,0,0,0,5718,5718,66,66,0,0,4
1165,p1711,20170913,5718,5718,0,0,0,5834,5834,116,116,0,0,4
1166,p1711,20170914,5834,5834,0,0,0,5608,5608,-226,-226,0,0,4
1167,p1711,20170915,5608,5608,0,0,0,5830,5830,222,222,0,0,4
1168,p1711,20170918,5830,5830,0,0,0,5830,5830,0,0,0,0,4
1169,p1711,20170919,5830,5830,0,0,0,5830,5830,0,0,0,0,4
1170,p1711,20170920,5830,5830,0,0,0,5830,5830,0,0,0,0,4
1171,p1711,20170921,5830,5830,0,0,0,5830,5830,0,0,0,0,4
1172,p1711,20170922,5830,5830,0,0,0,5830,5830,0,0,0,0,4
1173,p1711,20170925,5830,5830,0,0,0,5830,5830,0,0,0,0,4
1174,p1711,20170926,5830,5830,0,0,0,5830,5830,0,0,0,0,4
1175,p1711,20170927,5830,5830,0,0,0,5830,5830,0,0,0,0,4
1176,p1711,20170928,5830,5830,0,0,0,5698,5698,-132,-132,0,0,4
1177,p1711,20170929,5698,5698,0,0,0,5698,5698,0,0,0,0,4
1178,p1711,20171009,5698,5698,0,0,0,5698,5698,0,0,0,0,4
1179,p1711,20171010,5698,5698,0,0,0,5698,5698,0,0,0,0,4
1180,p1711,20171011,5698,5698,0,0,0,5698,5698,0,0,0,0,4
1181,p1711,20171012,5698,5698,0,0,0,5698,5698,0,0,0,0,4
1182,p1711,20171013,5698,5698,0,0,0,5698,5698,0,0,0,0,4
1183,p1711,20171016,5698,5698,0,0,0,5698,5698,0,0,0,0,4
1184,p1711,20171017,5698,5698,0,0,0,5698,5698,0,0,0,0,4
1185,p1711,20171018,5698,5698,0,0,0,5698,5698,0,0,0,0,4
1186,p1711,20171019,5698,5698,0,0,0,5698,5698,0,0,0,0,4
1187,p1711,20171020,5698,5698,0,0,0,5698,5698,0,0,0,0,4
1188,p1711,20171023,5698,5698,0,0,0,5698,5698,0,0,0,0,4
1189,p1711,20171024,5698,5698,0,0,0,5698,5698,0,0,0,0,4
1190,p1711,20171025,5698,5698,0,0,0,5698,5698,0,0,0,0,4
1191,p1711,20171026,5698,5698,5928,5928,5698,5698,5798,0,100,10,579840,0
1192,p1711,20171027,5698,5798,0,0,0,5798,5798,0,0,0,0,0
1193,p1711,20171030,5798,5798,0,0,0,5798,5798,0,0,0,0,0
1194,p1711,20171031,5798,5798,0,0,0,5798,5798,0,0,0,0,0
1195,p1711,20171101,5798,5798,0,0,0,5798,5798,0,0,0,0,0
1196,p1711,20171102,5798,5798,0,0,0,5798,5798,0,0,0,0,0
1197,p1711,20171103,5798,5798,0,0,0,5798,5798,0,0,0,0,0
1198,p1711,20171106,5798,5798,0,0,0,5798,5798,0,0,0,0,0
1199,p1711,20171107,5798,5798,0,0,0,5798,5798,0,0,0,0,0
1200,p1711,20171108,5798,5798,0,0,0,5798,5798,0,0,0,0,0
1201,p1711,20171109,5798,5798,0,0,0,5798,5798,0,0,0,0,0
1202,p1711,20171110,5798,5798,0,0,0,5798,5798,0,0,0,0,0
1203,p1711,20171113,5798,5798,0,0,0,5798,5798,0,0,0,0,0
1204,p1711,20171114,5798,5798,0,0,0,5798,5798,0,0,0,0,0
1205,p1712,20170103,6108,6108,0,0,0,6108,6108,0,0,0,0,0
1206,p1712,20170104,6108,6108,6080,6080,5998,5998,6038,-110,-70,4,241560,2
1207,p1712,20170105,5998,6038,0,0,0,6038,6038,0,0,0,0,2
1208,p1712,20170106,6038,6038,0,0,0,6008,6008,-30,-30,0,0,2
1209,p1712,20170109,6008,6008,0,0,0,6008,6008,0,0,0,0,2
1210,p1712,20170110,6008,6008,0,0,0,6044,6044,36,36,0,0,2
1211,p1712,20170111,6044,6044,0,0,0,6044,6044,0,0,0,0,2
1212,p1712,20170112,6044,6044,0,0,0,6044,6044,0,0,0,0,2
1213,p1712,20170113,6044,6044,0,0,0,6044,6044,0,0,0,0,2
1214,p1712,20170116,6044,6044,6164,6164,6164,6164,6164,120,120,2,123280,2
1215,p1712,20170117,6164,6164,0,0,0,6164,6164,0,0,0,0,2
1216,p1712,20170118,6164,6164,0,0,0,6164,6164,0,0,0,0,2
1217,p1712,20170119,6164,6164,0,0,0,6164,6164,0,0,0,0,2
1218,p1712,20170120,6164,6164,0,0,0,6164,6164,0,0,0,0,2
1219,p1712,20170123,6164,6164,0,0,0,6164,6164,0,0,0,0,2
1220,p1712,20170124,6164,6164,6002,6100,6000,6034,6058,-130,-106,70,4241920,4
1221,p1712,20170125,6034,6058,0,0,0,6058,6058,0,0,0,0,4
1222,p1712,20170126,6058,6058,0,0,0,6058,6058,0,0,0,0,4
1223,p1712,20170203,6058,6058,0,0,0,6058,6058,0,0,0,0,4
1224,p1712,20170206,6058,6058,5918,5918,5918,5918,5918,-140,-140,4,236720,8
1225,p1712,20170207,5918,5918,0,0,0,5918,5918,0,0,0,0,8
1226,p1712,20170208,5918,5918,5864,5948,5864,5948,5926,30,8,8,474160,8
1227,p1712,20170209,5948,5926,0,0,0,5926,5926,0,0,0,0,8
1228,p1712,20170210,5926,5926,0,0,0,5926,5926,0,0,0,0,8
1229,p1712,20170213,5926,5926,0,0,0,5926,5926,0,0,0,0,8
1230,p1712,20170214,5926,5926,0,0,0,5846,5846,-80,-80,0,0,8
1231,p1712,20170215,5846,5846,0,0,0,5846,5846,0,0,0,0,8
1232,p1712,20170216,5846,5846,0,0,0,5838,5838,-8,-8,0,0,8
1233,p1712,20170217,5838,5838,5680,5680,5680,5680,5680,-158,-158,4,227200,4
1234,p1712,20170220,5680,5680,0,0,0,5680,5680,0,0,0,0,4
1235,p1712,20170221,5680,5680,0,0,0,5566,5566,-114,-114,0,0,4
1236,p1712,20170222,5566,5566,0,0,0,5566,5566,0,0,0,0,4
1237,p1712,20170223,5566,5566,0,0,0,5566,5566,0,0,0,0,4
1238,p1712,20170224,5566,5566,0,0,0,5566,5566,0,0,0,0,4
1239,p1712,20170227,5566,5566,0,0,0,5566,5566,0,0,0,0,4
1240,p1712,20170228,5566,5566,0,0,0,5566,5566,0,0,0,0,4
1241,p1712,20170301,5566,5566,0,0,0,5598,5598,32,32,0,0,4
1242,p1712,20170302,5598,5598,5710,5710,5710,5710,5710,112,112,4,228400,4
1243,p1712,20170303,5710,5710,0,0,0,5710,5710,0,0,0,0,4
1244,p1712,20170306,5710,5710,0,0,0,5710,5710,0,0,0,0,4
1245,p1712,20170307,5710,5710,0,0,0,5710,5710,0,0,0,0,4
1246,p1712,20170308,5710,5710,0,0,0,5710,5710,0,0,0,0,4
1247,p1712,20170309,5710,5710,0,0,0,5710,5710,0,0,0,0,4
1248,p1712,20170310,5710,5710,0,0,0,5626,5626,-84,-84,0,0,4
1249,p1712,20170313,5626,5626,0,0,0,5626,5626,0,0,0,0,4
1250,p1712,20170314,5626,5626,0,0,0,5614,5614,-12,-12,0,0,4
1251,p1712,20170315,5614,5614,0,0,0,5614,5614,0,0,0,0,4
1252,p1712,20170316,5614,5614,0,0,0,5614,5614,0,0,0,0,4
1253,p1712,20170317,5614,5614,0,0,0,5614,5614,0,0,0,0,4
1254,p1712,20170320,5614,5614,0,0,0,5614,5614,0,0,0,0,4
1255,p1712,20170321,5614,5614,0,0,0,5614,5614,0,0,0,0,4
1256,p1712,20170322,5614,5614,0,0,0,5614,5614,0,0,0,0,4
1257,p1712,20170323,5614,5614,5590,5590,5578,5578,5584,-36,-30,4,223360,4
1258,p1712,20170324,5578,5584,0,0,0,5518,5518,-66,-66,0,0,4
1259,p1712,20170327,5518,5518,0,0,0,5426,5426,-92,-92,0,0,4
1260,p1712,20170328,5426,5426,0,0,0,5426,5426,0,0,0,0,4
1261,p1712,20170329,5426,5426,0,0,0,5426,5426,0,0,0,0,4
1262,p1712,20170330,5426,5426,0,0,0,5410,5410,-16,-16,0,0,4
1263,p1712,20170331,5410,5410,0,0,0,5426,5426,16,16,0,0,4
1264,p1712,20170405,5426,5426,0,0,0,5418,5418,-8,-8,0,0,4
1265,p1712,20170406,5418,5418,0,0,0,5418,5418,0,0,0,0,4
1266,p1712,20170407,5418,5418,0,0,0,5392,5392,-26,-26,0,0,4
1267,p1712,20170410,5392,5392,0,0,0,5236,5236,-156,-156,0,0,4
1268,p1712,20170411,5236,5236,0,0,0,5236,5236,0,0,0,0,4
1269,p1712,20170412,5236,5236,0,0,0,5234,5234,-2,-2,0,0,4
1270,p1712,20170413,5234,5234,0,0,0,5234,5234,0,0,0,0,4
1271,p1712,20170414,5234,5234,0,0,0,5162,5162,-72,-72,0,0,4
1272,p1712,20170417,5162,5162,0,0,0,5198,5198,36,36,0,0,4
1273,p1712,20170418,5198,5198,0,0,0,5198,5198,0,0,0,0,4
1274,p1712,20170419,5198,5198,0,0,0,5112,5112,-86,-86,0,0,4
1275,p1712,20170420,5112,5112,0,0,0,5112,5112,0,0,0,0,4
1276,p1712,20170421,5112,5112,0,0,0,5112,5112,0,0,0,0,4
1277,p1712,20170424,5112,5112,0,0,0,5148,5148,36,36,0,0,4
1278,p1712,20170425,5148,5148,0,0,0,5092,5092,-56,-56,0,0,4
1279,p1712,20170426,5092,5092,0,0,0,5092,5092,0,0,0,0,4
1280,p1712,20170427,5092,5092,0,0,0,5092,5092,0,0,0,0,4
1281,p1712,20170428,5092,5092,0,0,0,5174,5174,82,82,0,0,4
1282,p1712,20170502,5174,5174,0,0,0,5174,5174,0,0,0,0,4
1283,p1712,20170503,5174,5174,0,0,0,5174,5174,0,0,0,0,4
1284,p1712,20170504,5174,5174,5082,5180,5082,5180,5130,6,-44,8,410480,2
1285,p1712,20170505,5180,5130,0,0,0,5186,5186,56,56,0,0,2
1286,p1712,20170508,5186,5186,5302,5302,5204,5254,5252,68,66,6,315200,2
1287,p1712,20170509,5254,5252,0,0,0,5252,5252,0,0,0,0,2
1288,p1712,20170510,5252,5252,0,0,0,5252,5252,0,0,0,0,2
1289,p1712,20170511,5252,5252,5288,5378,5288,5378,5332,126,80,8,426640,2
1290,p1712,20170512,5378,5332,0,0,0,5332,5332,0,0,0,0,2
1291,p1712,20170515,5332,5332,0,0,0,5332,5332,0,0,0,0,2
1292,p1712,20170516,5332,5332,0,0,0,5372,5372,40,40,0,0,2
1293,p1712,20170517,5372,5372,0,0,0,5372,5372,0,0,0,0,2
1294,p1712,20170518,5372,5372,0,0,0,5372,5372,0,0,0,0,2
1295,p1712,20170519,5372,5372,0,0,0,5372,5372,0,0,0,0,2
1296,p1712,20170522,5372,5372,0,0,0,5372,5372,0,0,0,0,2
1297,p1712,20170523,5372,5372,0,0,0,5354,5354,-18,-18,0,0,2
1298,p1712,20170524,5354,5354,0,0,0,5288,5288,-66,-66,0,0,2
1299,p1712,20170525,5288,5288,0,0,0,5288,5288,0,0,0,0,2
1300,p1712,20170526,5288,5288,0,0,0,5310,5310,22,22,0,0,2
1301,p1712,20170531,5310,5310,5046,5108,5046,5108,5076,-202,-234,12,609240,2
1302,p1712,20170601,5108,5076,0,0,0,5076,5076,0,0,0,0,2
1303,p1712,20170602,5076,5076,0,0,0,5076,5076,0,0,0,0,2
1304,p1712,20170605,5076,5076,0,0,0,5076,5076,0,0,0,0,2
1305,p1712,20170606,5076,5076,0,0,0,5076,5076,0,0,0,0,2
1306,p1712,20170607,5076,5076,0,0,0,5076,5076,0,0,0,0,2
1307,p1712,20170608,5076,5076,0,0,0,5076,5076,0,0,0,0,2
1308,p1712,20170609,5076,5076,0,0,0,5076,5076,0,0,0,0,2
1309,p1712,20170612,5076,5076,0,0,0,5076,5076,0,0,0,0,2
1310,p1712,20170613,5076,5076,0,0,0,5076,5076,0,0,0,0,2
1311,p1712,20170614,5076,5076,0,0,0,5076,5076,0,0,0,0,2
1312,p1712,20170615,5076,5076,0,0,0,5082,5082,6,6,0,0,2
1313,p1712,20170616,5082,5082,0,0,0,5156,5156,74,74,0,0,2
1314,p1712,20170619,5156,5156,0,0,0,5192,5192,36,36,0,0,2
1315,p1712,20170620,5192,5192,0,0,0,5192,5192,0,0,0,0,2
1316,p1712,20170621,5192,5192,0,0,0,5104,5104,-88,-88,0,0,2
1317,p1712,20170622,5104,5104,5130,5130,5040,5040,5084,-64,-20,4,203400,2
1318,p1712,20170623,5040,5084,0,0,0,5084,5084,0,0,0,0,2
1319,p1712,20170626,5084,5084,0,0,0,5084,5084,0,0,0,0,2
1320,p1712,20170627,5084,5084,0,0,0,5084,5084,0,0,0,0,2
1321,p1712,20170628,5084,5084,0,0,0,5084,5084,0,0,0,0,2
1322,p1712,20170629,5084,5084,0,0,0,5098,5098,14,14,0,0,2
1323,p1712,20170630,5098,5098,0,0,0,5098,5098,0,0,0,0,2
1324,p1712,20170703,5098,5098,0,0,0,5160,5160,62,62,0,0,2
1325,p1712,20170704,5160,5160,0,0,0,5174,5174,14,14,0,0,2
1326,p1712,20170705,5174,5174,0,0,0,5242,5242,68,68,0,0,2
1327,p1712,20170706,5242,5242,0,0,0,5242,5242,0,0,0,0,2
1328,p1712,20170707,5242,5242,0,0,0,5242,5242,0,0,0,0,2
1329,p1712,20170710,5242,5242,5378,5378,5378,5378,5378,136,136,2,107560,4
1330,p1712,20170711,5378,5378,5342,5342,5342,5342,5342,-36,-36,2,106840,2
1331,p1712,20170712,5342,5342,0,0,0,5342,5342,0,0,0,0,2
1332,p1712,20170713,5342,5342,0,0,0,5314,5314,-28,-28,0,0,2
1333,p1712,20170714,5314,5314,0,0,0,5314,5314,0,0,0,0,2
1334,p1712,20170717,5314,5314,0,0,0,5314,5314,0,0,0,0,2
1335,p1712,20170718,5314,5314,0,0,0,5286,5286,-28,-28,0,0,2
1336,p1712,20170719,5286,5286,5308,5308,5268,5268,5288,-18,2,4,211520,2
1337,p1712,20170720,5268,5288,0,0,0,5350,5350,62,62,0,0,2
1338,p1712,20170721,5350,5350,5380,5380,5380,5380,5380,30,30,2,107600,2
1339,p1712,20170724,5380,5380,0,0,0,5358,5358,-22,-22,0,0,2
1340,p1712,20170725,5358,5358,5300,5414,5300,5360,5386,2,28,18,969480,0
1341,p1712,20170726,5360,5386,0,0,0,5386,5386,0,0,0,0,0
1342,p1712,20170727,5386,5386,0,0,0,5436,5436,50,50,0,0,0
1343,p1712,20170728,5436,5436,5462,5520,5420,5420,5468,-16,32,34,1859720,2
1344,p1712,20170731,5420,5468,0,0,0,5468,5468,0,0,0,0,2
1345,p1712,20170801,5468,5468,0,0,0,5468,5468,0,0,0,0,2
1346,p1712,20170802,5468,5468,0,0,0,5468,5468,0,0,0,0,2
1347,p1712,20170803,5468,5468,5474,5474,5436,5436,5454,-32,-14,4,218200,2
1348,p1712,20170804,5436,5454,0,0,0,5454,5454,0,0,0,0,2
1349,p1712,20170807,5454,5454,5328,5402,5328,5402,5364,-52,-90,4,214600,2
1350,p1712,20170808,5402,5364,0,0,0,5354,5354,-10,-10,0,0,2
1351,p1712,20170809,5354,5354,5508,5508,5408,5466,5454,112,100,136,7417880,2
1352,p1712,20170810,5466,5454,0,0,0,5454,5454,0,0,0,0,2
1353,p1712,20170811,5454,5454,0,0,0,5434,5434,-20,-20,0,0,2
1354,p1712,20170814,5434,5434,0,0,0,5434,5434,0,0,0,0,2
1355,p1712,20170815,5434,5434,0,0,0,5434,5434,0,0,0,0,2
1356,p1712,20170816,5434,5434,5326,5360,5326,5360,5340,-74,-94,36,1922800,2
1357,p1712,20170817,5360,5340,0,0,0,5340,5340,0,0,0,0,2
1358,p1712,20170818,5340,5340,0,0,0,5340,5340,0,0,0,0,2
1359,p1712,20170821,5340,5340,0,0,0,5404,5404,64,64,0,0,2
1360,p1712,20170822,5404,5404,0,0,0,5452,5452,48,48,0,0,2
1361,p1712,20170823,5452,5452,0,0,0,5556,5556,104,104,0,0,2
1362,p1712,20170824,5556,5556,0,0,0,5556,5556,0,0,0,0,2
1363,p1712,20170825,5556,5556,0,0,0,5556,5556,0,0,0,0,2
1364,p1712,20170828,5556,5556,0,0,0,5556,5556,0,0,0,0,2
1365,p1712,20170829,5556,5556,0,0,0,5536,5536,-20,-20,0,0,2
1366,p1712,20170830,5536,5536,0,0,0,5536,5536,0,0,0,0,2
1367,p1712,20170831,5536,5536,0,0,0,5536,5536,0,0,0,0,2
1368,p1712,20170901,5536,5536,0,0,0,5536,5536,0,0,0,0,2
1369,p1712,20170904,5536,5536,0,0,0,5536,5536,0,0,0,0,2
1370,p1712,20170905,5536,5536,5504,5556,5504,5556,5530,20,-6,4,221200,2
1371,p1712,20170906,5556,5530,0,0,0,5530,5530,0,0,0,0,2
1372,p1712,20170907,5530,5530,0,0,0,5530,5530,0,0,0,0,2
1373,p1712,20170908,5530,5530,0,0,0,5530,5530,0,0,0,0,2
1374,p1712,20170911,5530,5530,0,0,0,5570,5570,40,40,0,0,2
1375,p1712,20170912,5570,5570,0,0,0,5670,5670,100,100,0,0,2
1376,p1712,20170913,5670,5670,0,0,0,5786,5786,116,116,0,0,2
1377,p1712,20170914,5786,5786,0,0,0,5786,5786,0,0,0,0,2
1378,p1712,20170915,5786,5786,0,0,0,5800,5800,14,14,0,0,2
1379,p1712,20170918,5800,5800,0,0,0,5800,5800,0,0,0,0,2
1380,p1712,20170919,5800,5800,0,0,0,5800,5800,0,0,0,0,2
1381,p1712,20170920,5800,5800,0,0,0,5800,5800,0,0,0,0,2
1382,p1712,20170921,5800,5800,0,0,0,5800,5800,0,0,0,0,2
1383,p1712,20170922,5800,5800,0,0,0,5712,5712,-88,-88,0,0,2
1384,p1712,20170925,5712,5712,0,0,0,5712,5712,0,0,0,0,2
1385,p1712,20170926,5712,5712,0,0,0,5712,5712,0,0,0,0,2
1386,p1712,20170927,5712,5712,0,0,0,5712,5712,0,0,0,0,2
1387,p1712,20170928,5712,5712,0,0,0,5600,5600,-112,-112,0,0,2
1388,p1712,20170929,5600,5600,0,0,0,5600,5600,0,0,0,0,2
1389,p1712,20171009,5600,5600,0,0,0,5600,5600,0,0,0,0,2
1390,p1712,20171010,5600,5600,0,0,0,5600,5600,0,0,0,0,2
1391,p1712,20171011,5600,5600,0,0,0,5600,5600,0,0,0,0,2
1392,p1712,20171012,5600,5600,0,0,0,5600,5600,0,0,0,0,2
1393,p1712,20171013,5600,5600,0,0,0,5600,5600,0,0,0,0,2
1394,p1712,20171016,5600,5600,0,0,0,5600,5600,0,0,0,0,2
1395,p1712,20171017,5600,5600,0,0,0,5600,5600,0,0,0,0,2
1396,p1712,20171018,5600,5600,0,0,0,5600,5600,0,0,0,0,2
1397,p1712,20171019,5600,5600,0,0,0,5600,5600,0,0,0,0,2
1398,p1712,20171020,5600,5600,0,0,0,5600,5600,0,0,0,0,2
1399,p1712,20171023,5600,5600,0,0,0,5600,5600,0,0,0,0,2
1400,p1712,20171024,5600,5600,0,0,0,5700,5700,100,100,0,0,2
1401,p1712,20171025,5700,5700,0,0,0,5700,5700,0,0,0,0,2
1402,p1712,20171026,5700,5700,0,0,0,5700,5700,0,0,0,0,2
1403,p1712,20171027,5700,5700,0,0,0,5700,5700,0,0,0,0,2
1404,p1712,20171030,5700,5700,5642,5718,5642,5718,5680,18,-20,12,681600,2
1405,p1712,20171031,5718,5680,0,0,0,5680,5680,0,0,0,0,2
1406,p1712,20171101,5680,5680,0,0,0,5680,5680,0,0,0,0,2
1407,p1712,20171102,5680,5680,5670,5738,5670,5728,5706,48,26,8,456520,0
1408,p1712,20171103,5728,5706,0,0,0,5706,5706,0,0,0,0,0
1409,p1712,20171106,5706,5706,0,0,0,5706,5706,0,0,0,0,0
1410,p1712,20171107,5706,5706,0,0,0,5706,5706,0,0,0,0,0
1411,p1712,20171108,5706,5706,0,0,0,5706,5706,0,0,0,0,0
1412,p1712,20171109,5706,5706,0,0,0,5706,5706,0,0,0,0,0
1413,p1712,20171110,5706,5706,0,0,0,5706,5706,0,0,0,0,0
1414,p1712,20171113,5706,5706,0,0,0,5706,5706,0,0,0,0,0
1415,p1712,20171114,5706,5706,0,0,0,5706,5706,0,0,0,0,0
1416,p1712,20171115,5706,5706,0,0,0,5706,5706,0,0,0,0,0
1417,p1712,20171116,5706,5706,0,0,0,5706,5706,0,0,0,0,0
1418,p1712,20171117,5706,5706,0,0,0,5706,5706,0,0,0,0,0
1419,p1712,20171120,5706,5706,0,0,0,5706,5706,0,0,0,0,0
1420,p1712,20171121,5706,5706,5582,5582,5426,5426,5504,-280,-202,4,220160,0
1421,p1712,20171122,5426,5504,0,0,0,5504,5504,0,0,0,0,0
1422,p1712,20171123,5504,5504,0,0,0,5504,5504,0,0,0,0,0
1423,p1712,20171124,5504,5504,0,0,0,5504,5504,0,0,0,0,0
1424,p1712,20171127,5504,5504,0,0,0,5504,5504,0,0,0,0,0
1425,p1712,20171128,5504,5504,0,0,0,5504,5504,0,0,0,0,0
1426,p1712,20171129,5504,5504,0,0,0,5504,5504,0,0,0,0,0
1427,p1712,20171130,5504,5504,0,0,0,5504,5504,0,0,0,0,0
1428,p1712,20171201,5504,5504,0,0,0,5504,5504,0,0,0,0,0
1429,p1712,20171204,5504,5504,0,0,0,5504,5504,0,0,0,0,0
1430,p1712,20171205,5504,5504,0,0,0,5504,5504,0,0,0,0,0
1431,p1712,20171206,5504,5504,0,0,0,5504,5504,0,0,0,0,0
1432,p1712,20171207,5504,5504,0,0,0,5504,5504,0,0,0,0,0
1433,p1712,20171208,5504,5504,0,0,0,5504,5504,0,0,0,0,0
1434,p1712,20171211,5504,5504,0,0,0,5504,5504,0,0,0,0,0
1435,p1712,20171212,5504,5504,0,0,0,5504,5504,0,0,0,0,0
1436,p1712,20171213,5504,5504,0,0,0,5504,5504,0,0,0,0,0
1437,p1712,20171214,5504,5504,0,0,0,5504,5504,0,0,0,0,0
1438,p1801,20170117,6164,6164,6164,6164,6046,6070,6090,-94,-74,2180,132797400,1664
1439,p1801,20170118,6070,6090,6086,6110,6044,6062,6070,-28,-20,1192,72374560,2178
1440,p1801,20170119,6062,6070,6062,6086,6032,6046,6064,-24,-6,880,53366200,2390
1441,p1801,20170120,6046,6064,6066,6068,6020,6026,6040,-38,-24,1044,63063080,2896
1442,p1801,20170123,6026,6040,6022,6032,5980,6016,6008,-24,-32,946,56847040,3422
1443,p1801,20170124,6016,6008,6012,6110,5962,6080,6064,72,56,1408,85405320,3082
1444,p1801,20170125,6080,6064,6086,6086,6016,6024,6042,-40,-22,1614,97524440,3990
1445,p1801,20170126,6024,6042,6018,6048,5956,5960,6002,-82,-40,1296,77802840,4660
1446,p1801,20170203,5960,6002,5960,5998,5888,5890,5920,-112,-82,1288,76273920,5326
1447,p1801,20170206,5890,5920,5910,5940,5890,5898,5912,-22,-8,3256,192517360,7154
1448,p1801,20170207,5898,5912,5900,5932,5860,5874,5898,-38,-14,3492,206014520,8960
1449,p1801,20170208,5874,5898,5878,5944,5872,5924,5906,26,8,5544,327474880,8826
1450,p1801,20170209,5924,5906,5922,5934,5902,5906,5920,0,14,3122,184855480,10136
1451,p1801,20170210,5906,5920,5920,5952,5898,5932,5930,12,10,5818,345106760,11030
1452,p1801,20170213,5932,5930,5916,5944,5812,5816,5876,-114,-54,14030,824565800,18774
1453,p1801,20170214,5816,5876,5834,5842,5740,5758,5796,-118,-80,10620,615620880,23154
1454,p1801,20170215,5758,5796,5770,5804,5746,5782,5782,-14,-14,7090,410053400,24984
1455,p1801,20170216,5782,5782,5786,5814,5742,5742,5786,-40,4,11796,682629520,28562
1456,p1801,20170217,5742,5786,5742,5742,5642,5644,5692,-142,-94,21154,1204138240,35380
1457,p1801,20170220,5644,5692,5640,5676,5622,5650,5650,-42,-42,8728,493132320,37758
1458,p1801,20170221,5650,5650,5630,5666,5614,5636,5642,-14,-8,11684,659295720,42026
1459,p1801,20170222,5636,5642,5626,5628,5580,5596,5596,-46,-46,14122,790283960,46732
1460,p1801,20170223,5596,5596,5596,5622,5520,5530,5570,-66,-26,10596,590360640,49112
1461,p1801,20170224,5530,5570,5550,5596,5516,5584,5562,14,-8,23320,1297406880,55382
1462,p1801,20170227,5584,5562,5600,5640,5582,5606,5608,44,46,19504,1093786760,60768
1463,p1801,20170228,5606,5608,5588,5632,5570,5588,5602,-20,-6,20740,1161891040,66312
1464,p1801,20170301,5588,5602,5612,5710,5612,5672,5666,70,64,25742,1458623840,72170
1465,p1801,20170302,5672,5666,5698,5736,5686,5714,5706,48,40,10154,579541560,72790
1466,p1801,20170303,5714,5706,5720,5732,5680,5720,5712,14,6,9524,544098120,72962
1467,p1801,20170306,5720,5712,5710,5762,5696,5736,5722,24,10,9070,519157160,73936
1468,p1801,20170307,5736,5722,5746,5746,5660,5682,5694,-40,-28,10870,618991360,75830
1469,p1801,20170308,5682,5694,5684,5684,5584,5632,5628,-62,-66,12550,706377400,77300
1470,p1801,20170309,5632,5628,5638,5668,5566,5632,5632,4,4,18936,1066551440,75036
1471,p1801,20170310,5632,5632,5600,5612,5502,5528,5556,-104,-76,21204,1178255840,77866
1472,p1801,20170313,5528,5556,5556,5564,5492,5542,5530,-14,-26,19758,1092932640,76722
1473,p1801,20170314,5542,5530,5518,5518,5456,5466,5478,-64,-52,14416,789772000,79446
1474,p1801,20170315,5466,5478,5484,5522,5416,5498,5486,20,8,15566,854117440,80078
1475,p1801,20170316,5498,5486,5540,5564,5502,5554,5538,68,52,31454,1742168440,81812
1476,p1801,20170317,5554,5538,5566,5600,5544,5562,5568,24,30,13354,743731200,81702
1477,p1801,20170320,5562,5568,5574,5592,5542,5582,5568,14,0,14824,825619000,86750
1478,p1801,20170321,5582,5568,5580,5604,5516,5564,5562,-4,-6,17258,960218480,86682
1479,p1801,20170322,5564,5562,5568,5614,5548,5566,5582,4,20,22362,1248577680,86762
1480,p1801,20170323,5566,5582,5576,5588,5464,5472,5532,-110,-50,28134,1556687560,87038
1481,p1801,20170324,5472,5532,5472,5512,5444,5448,5468,-84,-64,18136,991947960,88646
1482,p1801,20170327,5448,5468,5436,5460,5312,5338,5362,-130,-106,25004,1341156600,88972
1483,p1801,20170328,5338,5362,5330,5360,5288,5310,5326,-52,-36,22918,1221006120,90788
1484,p1801,20170329,5310,5326,5326,5360,5316,5346,5342,20,16,19592,1046876720,94020
1485,p1801,20170330,5346,5342,5348,5358,5262,5268,5308,-74,-34,30698,1629766520,95282
1486,p1801,20170331,5268,5308,5260,5326,5236,5268,5296,-40,-12,23854,1263383240,92252
1487,p1801,20170405,5268,5296,5250,5324,5200,5316,5274,20,-22,24916,1314102560,99156
1488,p1801,20170406,5316,5274,5328,5350,5306,5328,5328,54,54,25228,1344218560,104824
1489,p1801,20170407,5328,5328,5332,5344,5212,5264,5280,-64,-48,32964,1740910760,111108
1490,p1801,20170410,5264,5280,5260,5356,5156,5160,5250,-120,-30,70236,3688270200,124920
1491,p1801,20170411,5160,5250,5162,5182,5120,5160,5152,-90,-98,40286,2076083520,124482
1492,p1801,20170412,5160,5152,5174,5186,5072,5096,5124,-56,-28,66982,3432871760,130684
1493,p1801,20170413,5096,5124,5106,5182,5100,5162,5138,38,14,41070,2110759760,132376
1494,p1801,20170414,5162,5138,5134,5160,5096,5130,5130,-8,-8,38570,1979205720,134466
1495,p1801,20170417,5130,5130,5136,5190,5130,5148,5164,18,34,44944,2321054240,133250
1496,p1801,20170418,5148,5164,5148,5182,5094,5100,5136,-64,-28,47902,2460543280,138102
1497,p1801,20170419,5100,5136,5084,5084,5004,5046,5044,-90,-92,48298,2436496400,140458
1498,p1801,20170420,5046,5044,5020,5064,5008,5052,5036,8,-8,64502,3249389360,148562
1499,p1801,20170421,5052,5036,5064,5080,5028,5068,5058,32,22,34692,1755044960,147556
1500,p1801,20170424,5068,5058,5080,5094,5058,5090,5078,32,20,48886,2482672680,148028
1501,p1801,20170425,5090,5078,5088,5100,4984,5000,5040,-78,-38,80572,4060876720,160060
1502,p1801,20170426,5000,5040,5016,5056,5002,5030,5030,-10,-10,50816,2556755120,159036
1503,p1801,20170427,5030,5030,5060,5134,5048,5084,5092,54,62,47372,2412426960,159438
1504,p1801,20170428,5084,5092,5074,5094,5044,5086,5072,-6,-20,30606,1552839240,162196
1505,p1801,20170502,5086,5072,5096,5174,5096,5150,5140,78,68,22530,1158454720,160238
1506,p1801,20170503,5150,5140,5156,5174,5134,5160,5150,20,10,35834,1845589200,163768
1507,p1801,20170504,5160,5150,5140,5150,5062,5116,5104,-34,-46,57430,2931404480,166092
1508,p1801,20170505,5116,5104,5112,5154,5074,5104,5116,0,12,57294,2932190760,169298
1509,p1801,20170508,5104,5116,5140,5242,5140,5216,5200,100,84,90346,4699385280,166464
1510,p1801,20170509,5216,5200,5198,5226,5182,5220,5200,20,0,42452,2208060200,169140
1511,p1801,20170510,5220,5200,5220,5246,5178,5198,5214,-2,14,46438,2421482400,174722
1512,p1801,20170511,5198,5214,5198,5304,5136,5298,5216,84,2,97718,5097925480,177514
1513,p1801,20170512,5298,5216,5292,5304,5250,5282,5272,66,56,38872,2050095520,178888
1514,p1801,20170515,5282,5272,5260,5308,5244,5264,5268,-8,-4,43564,2295156200,180928
1515,p1801,20170516,5264,5268,5284,5308,5266,5288,5288,20,20,57036,3016515800,183406
1516,p1801,20170517,5288,5288,5296,5330,5260,5324,5298,36,10,58728,3112328560,185610
1517,p1801,20170518,5324,5298,5338,5352,5268,5290,5304,-8,6,42102,2233418520,184730
1518,p1801,20170519,5290,5304,5250,5288,5210,5242,5256,-62,-48,65362,3435506920,183470
1519,p1801,20170522,5242,5256,5262,5324,5262,5298,5296,42,40,47918,2538624280,183304
1520,p1801,20170523,5298,5296,5296,5302,5222,5228,5266,-68,-30,41266,2173722040,185392
1521,p1801,20170524,5228,5266,5222,5240,5170,5184,5202,-82,-64,57044,2968446280,190582
1522,p1801,20170525,5184,5202,5188,5210,5152,5176,5190,-26,-12,45760,2375308320,196484
1523,p1801,20170526,5176,5190,5182,5204,5100,5100,5144,-90,-46,50584,2602252160,197644
1524,p1801,20170531,5100,5144,5032,5078,4986,4988,5036,-156,-108,71742,3613161640,212042
1525,p1801,20170601,4988,5036,5000,5020,4942,4950,4984,-86,-52,75766,3777491480,232284
1526,p1801,20170602,4950,4984,4984,5024,4972,4978,4990,-6,6,99688,4975685680,263342
1527,p1801,20170605,4978,4990,4968,5064,4932,5006,5010,16,20,86048,4311216080,272426
1528,p1801,20170606,5006,5010,5002,5020,4960,4994,4988,-16,-22,77860,3884766160,282314
1529,p1801,20170607,4994,4988,5008,5032,4950,4962,4982,-26,-6,95656,4766886400,291930
1530,p1801,20170608,4962,4982,4966,4968,4912,4950,4936,-32,-46,93908,4636754240,308136
1531,p1801,20170609,4950,4936,4948,4998,4944,4984,4978,48,42,83390,4152188400,321276
1532,p1801,20170612,4984,4978,4996,5084,4982,5076,5044,98,66,111986,5648963680,319060
1533,p1801,20170613,5076,5044,5060,5080,5010,5018,5046,-26,2,78066,3940399760,332720
1534,p1801,20170614,5018,5046,5006,5040,4990,5034,5020,-12,-26,81260,4080471000,338716
1535,p1801,20170615,5034,5020,5038,5088,5030,5042,5056,22,36,102336,5174523960,348422
1536,p1801,20170616,5042,5056,5052,5128,5038,5104,5092,48,36,96618,4921258440,339570
1537,p1801,20170619,5104,5092,5120,5188,5092,5170,5150,78,58,92424,4761192360,348748
1538,p1801,20170620,5170,5150,5150,5166,5062,5078,5114,-72,-36,87012,4450971400,357318
1539,p1801,20170621,5078,5114,5056,5076,5022,5036,5040,-78,-74,92892,4683445320,372604
1540,p1801,20170622,5036,5040,5038,5050,4990,5004,5018,-36,-22,65078,3266492320,375840
1541,p1801,20170623,5004,5018,5002,5030,4988,5020,5008,2,-10,68018,3406818200,385178
1542,p1801,20170626,5020,5008,5020,5028,4998,5012,5010,4,2,64178,3215905360,392180
1543,p1801,20170627,5012,5010,5006,5052,5002,5044,5026,34,16,75750,3808360120,399666
1544,p1801,20170628,5044,5026,5056,5090,5024,5042,5052,16,26,135412,6843151720,404350
1545,p1801,20170629,5042,5052,5034,5096,5026,5084,5072,32,20,122998,6240014960,399736
1546,p1801,20170630,5084,5072,5100,5128,5066,5100,5098,28,26,146770,7483718560,401216
1547,p1801,20170703,5100,5098,5090,5198,5070,5158,5140,60,42,151738,7800202200,402176
1548,p1801,20170704,5158,5140,5170,5176,5078,5090,5114,-50,-26,147040,7519740680,417320
1549,p1801,20170705,5090,5114,5110,5150,5100,5144,5126,30,12,136886,7016862360,421222
1550,p1801,20170706,5144,5126,5144,5240,5144,5208,5200,82,74,232110,12073555960,439690
1551,p1801,20170707,5208,5200,5208,5238,5180,5210,5206,10,6,121864,6346645760,439302
1552,p1801,20170710,5210,5206,5210,5308,5202,5280,5262,74,56,159762,8408555760,433944
1553,p1801,20170711,5280,5262,5286,5332,5262,5304,5298,42,36,176154,9333154960,441702
1554,p1801,20170712,5304,5298,5294,5336,5272,5292,5302,-6,4,154706,8204392800,456478
1555,p1801,20170713,5292,5302,5290,5314,5242,5266,5276,-36,-26,149450,7885883240,461800
1556,p1801,20170714,5266,5276,5264,5264,5190,5222,5218,-54,-58,177030,9240854240,468362
1557,p1801,20170717,5222,5218,5244,5292,5234,5250,5258,32,40,169840,8930552120,486502
1558,p1801,20170718,5250,5258,5250,5288,5194,5202,5242,-56,-16,260226,13643675960,490414
1559,p1801,20170719,5202,5242,5216,5230,5172,5220,5206,-22,-36,240748,12534015400,504170
1560,p1801,20170720,5220,5206,5224,5294,5222,5284,5266,78,60,262536,13826084720,518554
1561,p1801,20170721,5284,5266,5302,5360,5280,5312,5318,46,52,373900,19887859320,521680
1562,p1801,20170724,5312,5318,5310,5332,5218,5252,5266,-66,-52,276120,14541060080,522138
1563,p1801,20170725,5252,5266,5250,5388,5250,5382,5326,116,60,467908,24927638840,576074
1564,p1801,20170726,5382,5326,5386,5410,5340,5348,5374,22,48,555790,29868456640,604918
1565,p1801,20170727,5348,5374,5366,5458,5360,5450,5418,76,44,571472,30969598440,674214
1566,p1801,20170728,5450,5418,5464,5482,5360,5388,5416,-30,-2,652824,35364532320,644186
1567,p1801,20170731,5388,5416,5396,5486,5386,5462,5446,46,30,455722,24820810120,658230
1568,p1801,20170801,5462,5446,5452,5520,5418,5428,5468,-18,22,639394,34963752280,682640
1569,p1801,20170802,5428,5468,5422,5432,5364,5402,5394,-66,-74,524876,28313118080,692522
1570,p1801,20170803,5402,5394,5418,5428,5302,5318,5372,-76,-22,562406,30220164520,695974
1571,p1801,20170804,5318,5372,5312,5356,5286,5352,5332,-20,-40,458926,24473143000,679780
1572,p1801,20170807,5352,5332,5354,5396,5304,5320,5354,-12,22,519744,27828278960,687466
1573,p1801,20170808,5320,5354,5304,5390,5276,5384,5346,30,-8,602034,32185277000,655810
1574,p1801,20170809,5384,5346,5396,5442,5386,5440,5412,94,66,532790,28840199840,665658
1575,p1801,20170810,5440,5412,5426,5442,5340,5418,5400,6,-12,660588,35676421600,680548
1576,p1801,20170811,5418,5400,5436,5504,5346,5376,5414,-24,14,849954,46021945120,645728
1577,p1801,20170814,5376,5414,5410,5486,5370,5456,5430,42,16,728956,39585628400,683484
1578,p1801,20170815,5456,5430,5432,5446,5368,5376,5404,-54,-26,675858,36528866280,653880
1579,p1801,20170816,5376,5404,5356,5358,5284,5292,5318,-112,-86,553938,29464024120,660174
1580,p1801,20170817,5292,5318,5312,5354,5300,5340,5326,22,8,464302,24732989600,650636
1581,p1801,20170818,5340,5326,5342,5420,5324,5416,5362,90,36,512204,27470887280,642148
1582,p1801,20170821,5416,5362,5420,5464,5406,5448,5440,86,78,660692,35948277840,658566
1583,p1801,20170822,5448,5440,5468,5570,5442,5564,5508,124,68,857840,47250259680,738086
1584,p1801,20170823,5564,5508,5548,5594,5516,5542,5544,34,36,706090,39153268840,702638
1585,p1801,20170824,5542,5544,5558,5594,5496,5578,5548,34,4,672482,37309350080,737946
1586,p1801,20170825,5578,5548,5600,5622,5532,5536,5576,-12,28,519590,28982323600,700546
1587,p1801,20170828,5536,5576,5540,5582,5520,5536,5550,-40,-26,478822,26580753920,702272
1588,p1801,20170829,5536,5550,5536,5540,5468,5486,5504,-64,-46,494042,27194981800,667140
1589,p1801,20170830,5486,5504,5468,5534,5442,5452,5490,-52,-14,497518,27314471640,676332
1590,p1801,20170831,5452,5490,5452,5496,5442,5470,5466,-20,-24,381230,20845463200,648126
1591,p1801,20170901,5470,5466,5472,5538,5462,5524,5510,58,44,481790,26552574120,670060
1592,p1801,20170904,5524,5510,5526,5564,5498,5534,5534,24,24,498114,27571634280,667182
1593,p1801,20170905,5534,5534,5536,5568,5478,5566,5518,32,-16,548036,30248768320,668960
1594,p1801,20170906,5566,5518,5572,5592,5520,5556,5556,38,38,602118,33458470400,663900
1595,p1801,20170907,5556,5556,5540,5564,5490,5538,5526,-18,-30,595016,32885823280,647234
1596,p1801,20170908,5538,5526,5576,5578,5498,5504,5532,-22,6,603218,33370099840,622016
1597,p1801,20170911,5504,5532,5498,5654,5456,5650,5570,118,38,944312,52598743280,645038
1598,p1801,20170912,5650,5570,5650,5672,5606,5662,5642,92,72,543842,30693507560,610334
1599,p1801,20170913,5662,5642,5680,5780,5662,5690,5716,48,74,724178,41401442000,580636
1600,p1801,20170914,5690,5716,5730,5830,5706,5808,5772,92,56,784166,45268791400,594618
1601,p1801,20170915,5808,5772,5788,5798,5732,5784,5770,12,-2,589044,33990228360,547542
1602,p1801,20170918,5784,5770,5776,5776,5708,5744,5740,-26,-30,460988,26462877840,531410
1603,p1801,20170919,5744,5740,5708,5804,5692,5760,5752,20,12,467298,26888166960,560560
1604,p1801,20170920,5760,5752,5730,5762,5686,5720,5722,-32,-30,490428,28062998960,543454
1605,p1801,20170921,5720,5722,5726,5750,5662,5666,5704,-56,-18,591308,33739162280,537214
1606,p1801,20170922,5666,5704,5648,5662,5608,5628,5636,-76,-68,431190,24302314800,503638
1607,p1801,20170925,5628,5636,5644,5692,5572,5592,5626,-44,-10,517390,29110230040,511008
1608,p1801,20170926,5592,5626,5588,5624,5574,5606,5600,-20,-26,306022,17142186240,500796
1609,p1801,20170927,5606,5600,5642,5672,5612,5638,5640,38,40,398952,22506249040,489840
1610,p1801,20170928,5638,5640,5640,5642,5450,5494,5520,-146,-120,753768,41620726880,457882
1611,p1801,20170929,5494,5520,5500,5542,5476,5524,5512,4,-8,356540,19656888920,398540
1612,p1801,20171009,5524,5512,5574,5620,5558,5582,5588,70,76,289002,16153056720,398558
1613,p1801,20171010,5582,5588,5582,5582,5528,5546,5554,-42,-34,351192,19505322000,434358
1614,p1801,20171011,5546,5554,5518,5550,5502,5510,5520,-44,-34,310136,17122182800,425692
1615,p1801,20171012,5510,5520,5516,5578,5508,5576,5548,56,28,297890,16528054640,428018
1616,p1801,20171013,5576,5548,5560,5584,5472,5584,5528,36,-20,548438,30322705040,416284
1617,p1801,20171016,5584,5528,5600,5630,5558,5600,5602,72,74,373826,20945722160,421424
1618,p1801,20171017,5600,5602,5596,5646,5574,5616,5604,14,2,305104,17102728680,421472
1619,p1801,20171018,5616,5604,5598,5598,5518,5552,5560,-52,-44,377122,20970590400,432580
1620,p1801,20171019,5552,5560,5558,5592,5484,5486,5548,-74,-12,433016,24026592720,452766
1621,p1801,20171020,5486,5548,5500,5608,5488,5596,5546,48,-2,398432,22102699440,427654
1622,p1801,20171023,5596,5546,5608,5660,5586,5654,5626,108,80,413692,23276552680,429308
1623,p1801,20171024,5654,5626,5670,5706,5654,5688,5680,62,54,370464,21046527760,415298
1624,p1801,20171025,5688,5680,5672,5744,5652,5712,5692,32,12,450180,25625895280,432776
1625,p1801,20171026,5712,5692,5720,5724,5672,5688,5688,-4,-4,263684,15002424680,419856
1626,p1801,20171027,5688,5688,5688,5726,5666,5706,5696,18,8,316448,18031030120,416080
1627,p1801,20171030,5706,5696,5694,5778,5652,5746,5722,50,26,383624,21956095680,412066
1628,p1801,20171031,5746,5722,5740,5752,5702,5728,5726,6,4,243128,13925320120,396408
1629,p1801,20171101,5728,5726,5706,5738,5642,5654,5702,-72,-24,314428,17929455680,398188
1630,p1801,20171102,5654,5702,5678,5710,5662,5698,5688,-4,-14,260312,14808937720,380022
1631,p1801,20171103,5698,5688,5686,5686,5636,5654,5654,-34,-34,261120,14767450600,370998
1632,p1801,20171106,5654,5654,5646,5678,5582,5634,5626,-20,-28,321478,18088973400,352614
1633,p1801,20171107,5634,5626,5626,5680,5614,5658,5648,32,22,235846,13322935880,333358
1634,p1801,20171108,5658,5648,5644,5654,5592,5606,5624,-42,-24,252856,14222552040,332730
1635,p1801,20171109,5606,5624,5650,5720,5632,5710,5678,86,54,339328,19270503560,312518
1636,p1801,20171110,5710,5678,5688,5698,5598,5600,5646,-78,-32,275238,15542105920,304628
1637,p1801,20171113,5600,5646,5624,5644,5606,5630,5624,-16,-22,202922,11412360800,301170
1638,p1801,20171114,5630,5624,5604,5608,5528,5546,5556,-78,-68,279654,15538670120,285518
1639,p1801,20171115,5546,5556,5514,5538,5466,5478,5506,-78,-50,287180,15816038800,281482
1640,p1801,20171116,5478,5506,5484,5524,5438,5492,5486,-14,-20,219568,12047664080,268052
1641,p1801,20171117,5492,5486,5492,5510,5472,5478,5490,-8,4,171232,9400922160,260564
1642,p1801,20171120,5478,5490,5484,5496,5402,5434,5440,-56,-50,258516,14064599280,262174
1643,p1801,20171121,5434,5440,5400,5434,5382,5388,5406,-52,-34,218776,11828087080,243020
1644,p1801,20171122,5388,5406,5402,5446,5392,5402,5424,-4,18,207566,11259123680,244678
1645,p1801,20171123,5402,5424,5424,5438,5358,5394,5408,-30,-16,200444,10841028640,209852
1646,p1801,20171124,5394,5408,5374,5416,5374,5388,5398,-20,-10,114270,6169911800,190570
1647,p1801,20171127,5388,5398,5396,5408,5286,5306,5338,-92,-60,124568,6650506720,176844
1648,p1801,20171128,5306,5338,5310,5338,5294,5320,5318,-18,-20,61594,3276383360,157556
1649,p1801,20171129,5320,5318,5326,5344,5284,5312,5310,-6,-8,68942,3661620760,145596
1650,p1801,20171130,5312,5310,5300,5354,5284,5320,5314,10,4,59858,3181581080,133034
1651,p1801,20171201,5320,5314,5344,5358,5312,5346,5336,32,22,42074,2245772760,124218
1652,p1801,20171204,5346,5336,5350,5386,5320,5372,5352,36,16,54248,2904104680,117426
1653,p1801,20171205,5372,5352,5344,5366,5258,5284,5318,-68,-34,40052,2130011640,109878
1654,p1801,20171206,5284,5318,5294,5310,5260,5294,5288,-24,-30,30068,1590216120,106402
1655,p1801,20171207,5294,5288,5258,5276,5178,5198,5224,-90,-64,38408,2006728640,97938
1656,p1801,20171208,5198,5224,5154,5240,5154,5218,5212,-6,-12,24130,1257847840,94416
1657,p1801,20171211,5218,5212,5212,5240,5188,5204,5212,-8,0,29058,1514941400,90014
1658,p1801,20171212,5204,5212,5186,5244,5186,5212,5220,0,8,32396,1691693040,81914
1659,p1801,20171213,5212,5220,5206,5222,5196,5204,5210,-16,-10,22442,1169528640,72466
1660,p1801,20171214,5204,5210,5200,5220,5096,5110,5162,-100,-48,47522,2453420040,54700
1661,p1801,20171215,5110,5162,5124,5162,5112,5152,5136,-10,-26,20798,1068521000,46812
1662,p1801,20171218,5152,5136,5182,5200,5160,5182,5176,46,40,16560,857450280,44460
1663,p1801,20171219,5182,5176,5176,5176,5128,5146,5148,-30,-28,13344,687092160,42254
1664,p1801,20171220,5146,5148,5156,5188,5146,5158,5164,10,16,12658,653825320,36632
1665,p1801,20171221,5158,5164,5148,5152,5040,5044,5088,-120,-76,20826,1059987640,31260
1666,p1801,20171222,5044,5088,5026,5042,4946,4962,4974,-126,-114,19732,981850720,24748
1667,p1801,20171225,4962,4974,4982,5008,4950,4994,4988,20,14,11446,571030560,18822
1668,p1801,20171226,4994,4988,4994,5006,4986,4996,5000,8,12,4892,244633800,16614
1669,p1801,20171227,4996,5000,5008,5050,5002,5050,5024,50,24,5784,290606480,12844
1670,p1801,20171228,5050,5024,5050,5068,5020,5044,5048,20,24,4690,236766360,9354
1671,p1801,20171229,5044,5048,5036,5050,4796,4946,4970,-102,-78,7984,396882000,7182
1672,p1802,20170217,5786,5786,0,0,0,5786,5786,0,0,0,0,0
1673,p1802,20170220,5786,5786,0,0,0,5786,5786,0,0,0,0,0
1674,p1802,20170221,5786,5786,0,0,0,5786,5786,0,0,0,0,0
1675,p1802,20170222,5786,5786,0,0,0,5786,5786,0,0,0,0,0
1676,p1802,20170223,5786,5786,0,0,0,5778,5778,-8,-8,0,0,0
1677,p1802,20170224,5778,5778,0,0,0,5778,5778,0,0,0,0,0
1678,p1802,20170227,5778,5778,5650,5746,5532,5532,5642,-246,-136,6,338560,4
1679,p1802,20170228,5532,5642,5600,5772,5600,5772,5686,130,44,4,227440,6
1680,p1802,20170301,5772,5686,0,0,0,5686,5686,0,0,0,0,6
1681,p1802,20170302,5686,5686,0,0,0,5704,5704,18,18,0,0,6
1682,p1802,20170303,5704,5704,0,0,0,5704,5704,0,0,0,0,6
1683,p1802,20170306,5704,5704,5826,5826,5826,5826,5826,122,122,2,116520,8
1684,p1802,20170307,5826,5826,5708,5708,5708,5708,5708,-118,-118,2,114160,6
1685,p1802,20170308,5708,5708,0,0,0,5708,5708,0,0,0,0,6
1686,p1802,20170309,5708,5708,5708,5708,5708,5708,5708,0,0,2,114160,6
1687,p1802,20170310,5708,5708,0,0,0,5632,5632,-76,-76,0,0,6
1688,p1802,20170313,5632,5632,0,0,0,5632,5632,0,0,0,0,6
1689,p1802,20170314,5632,5632,0,0,0,5620,5620,-12,-12,0,0,6
1690,p1802,20170315,5620,5620,0,0,0,5628,5628,8,8,0,0,6
1691,p1802,20170316,5628,5628,0,0,0,5680,5680,52,52,0,0,6
1692,p1802,20170317,5680,5680,0,0,0,5680,5680,0,0,0,0,6
1693,p1802,20170320,5680,5680,0,0,0,5680,5680,0,0,0,0,6
1694,p1802,20170321,5680,5680,0,0,0,5680,5680,0,0,0,0,6
1695,p1802,20170322,5680,5680,0,0,0,5700,5700,20,20,0,0,6
1696,p1802,20170323,5700,5700,0,0,0,5650,5650,-50,-50,0,0,6
1697,p1802,20170324,5650,5650,0,0,0,5586,5586,-64,-64,0,0,6
1698,p1802,20170327,5586,5586,0,0,0,5478,5478,-108,-108,0,0,6
1699,p1802,20170328,5478,5478,0,0,0,5442,5442,-36,-36,0,0,6
1700,p1802,20170329,5442,5442,0,0,0,5442,5442,0,0,0,0,6
1701,p1802,20170330,5442,5442,0,0,0,5408,5408,-34,-34,0,0,6
1702,p1802,20170331,5408,5408,0,0,0,5396,5396,-12,-12,0,0,6
1703,p1802,20170405,5396,5396,0,0,0,5396,5396,0,0,0,0,6
1704,p1802,20170406,5396,5396,0,0,0,5450,5450,54,54,0,0,6
1705,p1802,20170407,5450,5450,0,0,0,5402,5402,-48,-48,0,0,6
1706,p1802,20170410,5402,5402,0,0,0,5372,5372,-30,-30,0,0,6
1707,p1802,20170411,5372,5372,0,0,0,5272,5272,-100,-100,0,0,6
1708,p1802,20170412,5272,5272,0,0,0,5244,5244,-28,-28,0,0,6
1709,p1802,20170413,5244,5244,0,0,0,5258,5258,14,14,0,0,6
1710,p1802,20170414,5258,5258,0,0,0,5250,5250,-8,-8,0,0,6
1711,p1802,20170417,5250,5250,0,0,0,5284,5284,34,34,0,0,6
1712,p1802,20170418,5284,5284,0,0,0,5256,5256,-28,-28,0,0,6
1713,p1802,20170419,5256,5256,0,0,0,5162,5162,-94,-94,0,0,6
1714,p1802,20170420,5162,5162,0,0,0,5154,5154,-8,-8,0,0,6
1715,p1802,20170421,5154,5154,0,0,0,5154,5154,0,0,0,0,6
1716,p1802,20170424,5154,5154,0,0,0,5174,5174,20,20,0,0,6
1717,p1802,20170425,5174,5174,0,0,0,5136,5136,-38,-38,0,0,6
1718,p1802,20170426,5136,5136,0,0,0,5136,5136,0,0,0,0,6
1719,p1802,20170427,5136,5136,0,0,0,5136,5136,0,0,0,0,6
1720,p1802,20170428,5136,5136,0,0,0,5136,5136,0,0,0,0,6
1721,p1802,20170502,5136,5136,0,0,0,5204,5204,68,68,0,0,6
1722,p1802,20170503,5204,5204,0,0,0,5204,5204,0,0,0,0,6
1723,p1802,20170504,5204,5204,0,0,0,5204,5204,0,0,0,0,6
1724,p1802,20170505,5204,5204,0,0,0,5204,5204,0,0,0,0,6
1725,p1802,20170508,5204,5204,0,0,0,5288,5288,84,84,0,0,6
1726,p1802,20170509,5288,5288,0,0,0,5288,5288,0,0,0,0,6
1727,p1802,20170510,5288,5288,0,0,0,5302,5302,14,14,0,0,6
1728,p1802,20170511,5302,5302,0,0,0,5304,5304,2,2,0,0,6
1729,p1802,20170512,5304,5304,0,0,0,5360,5360,56,56,0,0,6
1730,p1802,20170515,5360,5360,0,0,0,5360,5360,0,0,0,0,6
1731,p1802,20170516,5360,5360,0,0,0,5380,5380,20,20,0,0,6
1732,p1802,20170517,5380,5380,0,0,0,5390,5390,10,10,0,0,6
1733,p1802,20170518,5390,5390,0,0,0,5396,5396,6,6,0,0,6
1734,p1802,20170519,5396,5396,0,0,0,5348,5348,-48,-48,0,0,6
1735,p1802,20170522,5348,5348,0,0,0,5388,5388,40,40,0,0,6
1736,p1802,20170523,5388,5388,0,0,0,5358,5358,-30,-30,0,0,6
1737,p1802,20170524,5358,5358,0,0,0,5294,5294,-64,-64,0,0,6
1738,p1802,20170525,5294,5294,0,0,0,5282,5282,-12,-12,0,0,6
1739,p1802,20170526,5282,5282,0,0,0,5236,5236,-46,-46,0,0,6
1740,p1802,20170531,5236,5236,0,0,0,5128,5128,-108,-108,0,0,6
1741,p1802,20170601,5128,5128,0,0,0,5076,5076,-52,-52,0,0,6
1742,p1802,20170602,5076,5076,0,0,0,5076,5076,0,0,0,0,6
1743,p1802,20170605,5076,5076,0,0,0,5096,5096,20,20,0,0,6
1744,p1802,20170606,5096,5096,0,0,0,5074,5074,-22,-22,0,0,6
1745,p1802,20170607,5074,5074,0,0,0,5068,5068,-6,-6,0,0,6
1746,p1802,20170608,5068,5068,0,0,0,5022,5022,-46,-46,0,0,6
1747,p1802,20170609,5022,5022,0,0,0,5064,5064,42,42,0,0,6
1748,p1802,20170612,5064,5064,0,0,0,5130,5130,66,66,0,0,6
1749,p1802,20170613,5130,5130,0,0,0,5132,5132,2,2,0,0,6
1750,p1802,20170614,5132,5132,0,0,0,5106,5106,-26,-26,0,0,6
1751,p1802,20170615,5106,5106,0,0,0,5142,5142,36,36,0,0,6
1752,p1802,20170616,5142,5142,0,0,0,5142,5142,0,0,0,0,6
1753,p1802,20170619,5142,5142,0,0,0,5200,5200,58,58,0,0,6
1754,p1802,20170620,5200,5200,0,0,0,5198,5198,-2,-2,0,0,6
1755,p1802,20170621,5198,5198,0,0,0,5124,5124,-74,-74,0,0,6
1756,p1802,20170622,5124,5124,0,0,0,5102,5102,-22,-22,0,0,6
1757,p1802,20170623,5102,5102,0,0,0,5092,5092,-10,-10,0,0,6
1758,p1802,20170626,5092,5092,0,0,0,5092,5092,0,0,0,0,6
1759,p1802,20170627,5092,5092,0,0,0,5092,5092,0,0,0,0,6
1760,p1802,20170628,5092,5092,0,0,0,5092,5092,0,0,0,0,6
1761,p1802,20170629,5092,5092,0,0,0,5112,5112,20,20,0,0,6
1762,p1802,20170630,5112,5112,5208,5208,5196,5196,5202,84,90,4,208080,10
1763,p1802,20170703,5196,5202,0,0,0,5244,5244,42,42,0,0,10
1764,p1802,20170704,5244,5244,5134,5222,5134,5222,5192,-22,-52,6,311560,12
1765,p1802,20170705,5222,5192,0,0,0,5204,5204,12,12,0,0,12
1766,p1802,20170706,5204,5204,5310,5310,5310,5310,5310,106,106,2,106200,10
1767,p1802,20170707,5310,5310,0,0,0,5310,5310,0,0,0,0,10
1768,p1802,20170710,5310,5310,5360,5360,5360,5360,5360,50,50,4,214400,14
1769,p1802,20170711,5360,5360,0,0,0,5396,5396,36,36,0,0,14
1770,p1802,20170712,5396,5396,0,0,0,5396,5396,0,0,0,0,14
1771,p1802,20170713,5396,5396,5292,5292,5292,5292,5292,-104,-104,4,211680,10
1772,p1802,20170714,5292,5292,0,0,0,5292,5292,0,0,0,0,10
1773,p1802,20170717,5292,5292,0,0,0,5332,5332,40,40,0,0,10
1774,p1802,20170718,5332,5332,5288,5288,5288,5288,5288,-44,-44,2,105760,10
1775,p1802,20170719,5288,5288,0,0,0,5288,5288,0,0,0,0,10
1776,p1802,20170720,5288,5288,0,0,0,5348,5348,60,60,0,0,10
1777,p1802,20170721,5348,5348,5440,5440,5370,5370,5388,22,40,8,431080,8
1778,p1802,20170724,5370,5388,5354,5354,5282,5282,5318,-106,-70,4,212720,8
1779,p1802,20170725,5282,5318,0,0,0,5378,5378,60,60,0,0,8
1780,p1802,20170726,5378,5378,5510,5510,5396,5442,5448,64,70,30,1634760,10
1781,p1802,20170727,5442,5448,5442,5496,5442,5496,5468,48,20,4,218760,10
1782,p1802,20170728,5496,5468,0,0,0,5468,5468,0,0,0,0,10
1783,p1802,20170731,5468,5468,0,0,0,5498,5498,30,30,0,0,10
1784,p1802,20170801,5498,5498,0,0,0,5498,5498,0,0,0,0,10
1785,p1802,20170802,5498,5498,0,0,0,5498,5498,0,0,0,0,10
1786,p1802,20170803,5498,5498,0,0,0,5476,5476,-22,-22,0,0,10
1787,p1802,20170804,5476,5476,5426,5426,5426,5426,5426,-50,-50,2,108520,12
1788,p1802,20170807,5426,5426,5414,5414,5414,5414,5414,-12,-12,2,108280,10
1789,p1802,20170808,5414,5414,0,0,0,5406,5406,-8,-8,0,0,10
1790,p1802,20170809,5406,5406,0,0,0,5406,5406,0,0,0,0,10
1791,p1802,20170810,5406,5406,0,0,0,5406,5406,0,0,0,0,10
1792,p1802,20170811,5406,5406,5378,5378,5378,5378,5378,-28,-28,2,107560,10
1793,p1802,20170814,5378,5378,0,0,0,5392,5392,14,14,0,0,10
1794,p1802,20170815,5392,5392,0,0,0,5400,5400,8,8,0,0,10
1795,p1802,20170816,5400,5400,5416,5416,5416,5416,5416,16,16,2,108320,8
1796,p1802,20170817,5416,5416,0,0,0,5416,5416,0,0,0,0,8
1797,p1802,20170818,5416,5416,0,0,0,5416,5416,0,0,0,0,8
1798,p1802,20170821,5416,5416,0,0,0,5416,5416,0,0,0,0,8
1799,p1802,20170822,5416,5416,5592,5608,5592,5608,5600,192,184,4,224000,4
1800,p1802,20170823,5608,5600,0,0,0,5600,5600,0,0,0,0,4
1801,p1802,20170824,5600,5600,0,0,0,5600,5600,0,0,0,0,4
1802,p1802,20170825,5600,5600,0,0,0,5600,5600,0,0,0,0,4
1803,p1802,20170828,5600,5600,0,0,0,5600,5600,0,0,0,0,4
1804,p1802,20170829,5600,5600,0,0,0,5568,5568,-32,-32,0,0,4
1805,p1802,20170830,5568,5568,0,0,0,5568,5568,0,0,0,0,4
1806,p1802,20170831,5568,5568,5548,5548,5510,5510,5528,-58,-40,4,221160,4
1807,p1802,20170901,5510,5528,0,0,0,5572,5572,44,44,0,0,4
1808,p1802,20170904,5572,5572,0,0,0,5572,5572,0,0,0,0,4
1809,p1802,20170905,5572,5572,0,0,0,5572,5572,0,0,0,0,4
1810,p1802,20170906,5572,5572,0,0,0,5572,5572,0,0,0,0,4
1811,p1802,20170907,5572,5572,0,0,0,5572,5572,0,0,0,0,4
1812,p1802,20170908,5572,5572,0,0,0,5572,5572,0,0,0,0,4
1813,p1802,20170911,5572,5572,5718,5772,5718,5772,5744,200,172,4,229800,8
1814,p1802,20170912,5772,5744,5668,5668,5668,5668,5668,-76,-76,4,226720,4
1815,p1802,20170913,5668,5668,0,0,0,5742,5742,74,74,0,0,4
1816,p1802,20170914,5742,5742,0,0,0,5798,5798,56,56,0,0,4
1817,p1802,20170915,5798,5798,0,0,0,5802,5802,4,4,0,0,4
1818,p1802,20170918,5802,5802,5840,5840,5806,5806,5822,4,20,4,232920,4
1819,p1802,20170919,5806,5822,0,0,0,5822,5822,0,0,0,0,4
1820,p1802,20170920,5822,5822,5808,5808,5766,5768,5780,-54,-42,6,346840,4
1821,p1802,20170921,5768,5780,0,0,0,5780,5780,0,0,0,0,4
1822,p1802,20170922,5780,5780,0,0,0,5716,5716,-64,-64,0,0,4
1823,p1802,20170925,5716,5716,0,0,0,5716,5716,0,0,0,0,4
1824,p1802,20170926,5716,5716,0,0,0,5716,5716,0,0,0,0,4
1825,p1802,20170927,5716,5716,0,0,0,5716,5716,0,0,0,0,4
1826,p1802,20170928,5716,5716,0,0,0,5578,5578,-138,-138,0,0,4
1827,p1802,20170929,5578,5578,0,0,0,5578,5578,0,0,0,0,4
1828,p1802,20171009,5578,5578,0,0,0,5654,5654,76,76,0,0,4
1829,p1802,20171010,5654,5654,5568,5572,5556,5572,5562,-82,-92,14,778880,12
1830,p1802,20171011,5572,5562,5552,5576,5552,5576,5568,14,6,6,334080,6
1831,p1802,20171012,5576,5568,5532,5532,5532,5532,5532,-36,-36,2,110640,6
1832,p1802,20171013,5532,5532,5590,5596,5590,5596,5594,64,62,6,335640,4
1833,p1802,20171016,5596,5594,0,0,0,5594,5594,0,0,0,0,4
1834,p1802,20171017,5594,5594,0,0,0,5594,5594,0,0,0,0,4
1835,p1802,20171018,5594,5594,5638,5638,5590,5590,5614,-4,20,4,224560,4
1836,p1802,20171019,5590,5614,0,0,0,5602,5602,-12,-12,0,0,4
1837,p1802,20171020,5602,5602,5584,5584,5584,5584,5584,-18,-18,2,111680,4
1838,p1802,20171023,5584,5584,5748,5748,5672,5672,5710,88,126,12,685200,4
1839,p1802,20171024,5672,5710,0,0,0,5710,5710,0,0,0,0,4
1840,p1802,20171025,5710,5710,5694,5790,5694,5790,5742,80,32,4,229680,4
1841,p1802,20171026,5790,5742,0,0,0,5742,5742,0,0,0,0,4
1842,p1802,20171027,5742,5742,0,0,0,5742,5742,0,0,0,0,4
1843,p1802,20171030,5742,5742,0,0,0,5742,5742,0,0,0,0,4
1844,p1802,20171031,5742,5742,0,0,0,5742,5742,0,0,0,0,4
1845,p1802,20171101,5742,5742,0,0,0,5742,5742,0,0,0,0,4
1846,p1802,20171102,5742,5742,0,0,0,5742,5742,0,0,0,0,4
1847,p1802,20171103,5742,5742,0,0,0,5742,5742,0,0,0,0,4
1848,p1802,20171106,5742,5742,0,0,0,5742,5742,0,0,0,0,4
1849,p1802,20171107,5742,5742,5752,5760,5698,5698,5722,-44,-20,28,1602520,2
1850,p1802,20171108,5698,5722,0,0,0,5698,5698,-24,-24,0,0,2
1851,p1802,20171109,5698,5698,0,0,0,5698,5698,0,0,0,0,2
1852,p1802,20171110,5698,5698,0,0,0,5666,5666,-32,-32,0,0,2
1853,p1802,20171113,5666,5666,0,0,0,5666,5666,0,0,0,0,2
1854,p1802,20171114,5666,5666,0,0,0,5598,5598,-68,-68,0,0,2
1855,p1802,20171115,5598,5598,0,0,0,5598,5598,0,0,0,0,2
1856,p1802,20171116,5598,5598,0,0,0,5578,5578,-20,-20,0,0,2
1857,p1802,20171117,5578,5578,0,0,0,5578,5578,0,0,0,0,2
1858,p1802,20171120,5578,5578,0,0,0,5528,5528,-50,-50,0,0,2
1859,p1802,20171121,5528,5528,0,0,0,5494,5494,-34,-34,0,0,2
1860,p1802,20171122,5494,5494,0,0,0,5494,5494,0,0,0,0,2
1861,p1802,20171123,5494,5494,0,0,0,5474,5474,-20,-20,0,0,2
1862,p1802,20171124,5474,5474,0,0,0,5474,5474,0,0,0,0,2
1863,p1802,20171127,5474,5474,0,0,0,5414,5414,-60,-60,0,0,2
1864,p1802,20171128,5414,5414,0,0,0,5414,5414,0,0,0,0,2
1865,p1802,20171129,5414,5414,0,0,0,5414,5414,0,0,0,0,2
1866,p1802,20171130,5414,5414,0,0,0,5414,5414,0,0,0,0,2
1867,p1802,20171201,5414,5414,0,0,0,5414,5414,0,0,0,0,2
1868,p1802,20171204,5414,5414,0,0,0,5414,5414,0,0,0,0,2
1869,p1802,20171205,5414,5414,0,0,0,5414,5414,0,0,0,0,2
1870,p1802,20171206,5414,5414,0,0,0,5414,5414,0,0,0,0,2
1871,p1802,20171207,5414,5414,0,0,0,5350,5350,-64,-64,0,0,2
1872,p1802,20171208,5350,5350,0,0,0,5338,5338,-12,-12,0,0,2
1873,p1802,20171211,5338,5338,0,0,0,5338,5338,0,0,0,0,2
1874,p1802,20171212,5338,5338,0,0,0,5346,5346,8,8,0,0,2
1875,p1802,20171213,5346,5346,0,0,0,5336,5336,-10,-10,0,0,2
1876,p1802,20171214,5336,5336,0,0,0,5288,5288,-48,-48,0,0,2
1877,p1802,20171215,5288,5288,0,0,0,5262,5262,-26,-26,0,0,2
1878,p1802,20171218,5262,5262,0,0,0,5262,5262,0,0,0,0,2
1879,p1802,20171219,5262,5262,0,0,0,5234,5234,-28,-28,0,0,2
1880,p1802,20171220,5234,5234,0,0,0,5234,5234,0,0,0,0,2
1881,p1802,20171221,5234,5234,0,0,0,5158,5158,-76,-76,0,0,2
1882,p1802,20171222,5158,5158,0,0,0,5044,5044,-114,-114,0,0,2
1883,p1802,20171225,5044,5044,5170,5170,5044,5044,5106,0,62,24,1225440,6
1884,p1802,20171226,5044,5106,5048,5048,5048,5048,5048,-58,-58,2,100960,4
1885,p1802,20171227,5048,5048,0,0,0,5072,5072,24,24,0,0,4
1886,p1802,20171228,5072,5072,0,0,0,5096,5096,24,24,0,0,4
1887,p1802,20171229,5096,5096,4946,5202,4946,5198,5090,102,-6,18,916320,0
1888,p1803,20170315,5620,5620,0,0,0,5620,5620,0,0,0,0,0
1889,p1803,20170316,5620,5620,0,0,0,5620,5620,0,0,0,0,0
1890,p1803,20170317,5620,5620,0,0,0,5620,5620,0,0,0,0,0
1891,p1803,20170320,5620,5620,0,0,0,5620,5620,0,0,0,0,0
1892,p1803,20170321,5620,5620,0,0,0,5620,5620,0,0,0,0,0
1893,p1803,20170322,5620,5620,0,0,0,5620,5620,0,0,0,0,0
1894,p1803,20170323,5620,5620,0,0,0,5580,5580,-40,-40,0,0,0
1895,p1803,20170324,5580,5580,0,0,0,5516,5516,-64,-64,0,0,0
1896,p1803,20170327,5516,5516,0,0,0,5410,5410,-106,-106,0,0,0
1897,p1803,20170328,5410,5410,0,0,0,5410,5410,0,0,0,0,0
1898,p1803,20170329,5410,5410,0,0,0,5426,5426,16,16,0,0,0
1899,p1803,20170330,5426,5426,0,0,0,5392,5392,-34,-34,0,0,0
1900,p1803,20170331,5392,5392,0,0,0,5380,5380,-12,-12,0,0,0
1901,p1803,20170405,5380,5380,0,0,0,5358,5358,-22,-22,0,0,0
1902,p1803,20170406,5358,5358,0,0,0,5412,5412,54,54,0,0,0
1903,p1803,20170407,5412,5412,0,0,0,5364,5364,-48,-48,0,0,0
1904,p1803,20170410,5364,5364,0,0,0,5334,5334,-30,-30,0,0,0
1905,p1803,20170411,5334,5334,0,0,0,5334,5334,0,0,0,0,0
1906,p1803,20170412,5334,5334,0,0,0,5306,5306,-28,-28,0,0,0
1907,p1803,20170413,5306,5306,0,0,0,5306,5306,0,0,0,0,0
1908,p1803,20170414,5306,5306,0,0,0,5298,5298,-8,-8,0,0,0
1909,p1803,20170417,5298,5298,5280,5280,5280,5280,5280,-18,-18,10,528000,10
1910,p1803,20170418,5280,5280,0,0,0,5252,5252,-28,-28,0,0,10
1911,p1803,20170419,5252,5252,0,0,0,5158,5158,-94,-94,0,0,10
1912,p1803,20170420,5158,5158,0,0,0,5150,5150,-8,-8,0,0,10
1913,p1803,20170421,5150,5150,0,0,0,5150,5150,0,0,0,0,10
1914,p1803,20170424,5150,5150,0,0,0,5150,5150,0,0,0,0,10
1915,p1803,20170425,5150,5150,0,0,0,5150,5150,0,0,0,0,10
1916,p1803,20170426,5150,5150,0,0,0,5140,5140,-10,-10,0,0,10
1917,p1803,20170427,5140,5140,0,0,0,5140,5140,0,0,0,0,10
1918,p1803,20170428,5140,5140,0,0,0,5140,5140,0,0,0,0,10
1919,p1803,20170502,5140,5140,0,0,0,5140,5140,0,0,0,0,10
1920,p1803,20170503,5140,5140,0,0,0,5150,5150,10,10,0,0,10
1921,p1803,20170504,5150,5150,0,0,0,5150,5150,0,0,0,0,10
1922,p1803,20170505,5150,5150,0,0,0,5150,5150,0,0,0,0,10
1923,p1803,20170508,5150,5150,5202,5202,5202,5202,5202,52,52,10,520200,0
1924,p1803,20170509,5202,5202,0,0,0,5202,5202,0,0,0,0,0
1925,p1803,20170510,5202,5202,0,0,0,5216,5216,14,14,0,0,0
1926,p1803,20170511,5216,5216,0,0,0,5218,5218,2,2,0,0,0
1927,p1803,20170512,5218,5218,0,0,0,5274,5274,56,56,0,0,0
1928,p1803,20170515,5274,5274,0,0,0,5270,5270,-4,-4,0,0,0
1929,p1803,20170516,5270,5270,0,0,0,5290,5290,20,20,0,0,0
1930,p1803,20170517,5290,5290,0,0,0,5300,5300,10,10,0,0,0
1931,p1803,20170518,5300,5300,0,0,0,5306,5306,6,6,0,0,0
1932,p1803,20170519,5306,5306,0,0,0,5306,5306,0,0,0,0,0
1933,p1803,20170522,5306,5306,0,0,0,5346,5346,40,40,0,0,0
1934,p1803,20170523,5346,5346,0,0,0,5316,5316,-30,-30,0,0,0
1935,p1803,20170524,5316,5316,0,0,0,5252,5252,-64,-64,0,0,0
1936,p1803,20170525,5252,5252,0,0,0,5252,5252,0,0,0,0,0
1937,p1803,20170526,5252,5252,5494,5494,5352,5352,5422,100,170,4,216920,4
1938,p1803,20170531,5352,5422,5154,5154,5154,5154,5154,-268,-268,2,103080,4
1939,p1803,20170601,5154,5154,0,0,0,5102,5102,-52,-52,0,0,4
1940,p1803,20170602,5102,5102,0,0,0,5102,5102,0,0,0,0,4
1941,p1803,20170605,5102,5102,0,0,0,5102,5102,0,0,0,0,4
1942,p1803,20170606,5102,5102,0,0,0,5102,5102,0,0,0,0,4
1943,p1803,20170607,5102,5102,0,0,0,5096,5096,-6,-6,0,0,4
1944,p1803,20170608,5096,5096,0,0,0,5050,5050,-46,-46,0,0,4
1945,p1803,20170609,5050,5050,0,0,0,5092,5092,42,42,0,0,4
1946,p1803,20170612,5092,5092,5058,5058,5058,5058,5058,-34,-34,2,101160,4
1947,p1803,20170613,5058,5058,0,0,0,5060,5060,2,2,0,0,4
1948,p1803,20170614,5060,5060,0,0,0,5034,5034,-26,-26,0,0,4
1949,p1803,20170615,5034,5034,0,0,0,5070,5070,36,36,0,0,4
1950,p1803,20170616,5070,5070,0,0,0,5070,5070,0,0,0,0,4
1951,p1803,20170619,5070,5070,0,0,0,5126,5126,56,56,0,0,4
1952,p1803,20170620,5126,5126,0,0,0,5126,5126,0,0,0,0,4
1953,p1803,20170621,5126,5126,0,0,0,5052,5052,-74,-74,0,0,4
1954,p1803,20170622,5052,5052,0,0,0,5052,5052,0,0,0,0,4
1955,p1803,20170623,5052,5052,0,0,0,5052,5052,0,0,0,0,4
1956,p1803,20170626,5052,5052,0,0,0,5054,5054,2,2,0,0,4
1957,p1803,20170627,5054,5054,0,0,0,5070,5070,16,16,0,0,4
1958,p1803,20170628,5070,5070,0,0,0,5070,5070,0,0,0,0,4
1959,p1803,20170629,5070,5070,0,0,0,5090,5090,20,20,0,0,4
1960,p1803,20170630,5090,5090,0,0,0,5178,5178,88,88,0,0,4
1961,p1803,20170703,5178,5178,0,0,0,5178,5178,0,0,0,0,4
1962,p1803,20170704,5178,5178,0,0,0,5128,5128,-50,-50,0,0,4
1963,p1803,20170705,5128,5128,5244,5244,5136,5136,5190,8,62,4,207600,4
1964,p1803,20170706,5136,5190,0,0,0,5294,5294,104,104,0,0,4
1965,p1803,20170707,5294,5294,0,0,0,5294,5294,0,0,0,0,4
1966,p1803,20170710,5294,5294,0,0,0,5342,5342,48,48,0,0,4
1967,p1803,20170711,5342,5342,0,0,0,5342,5342,0,0,0,0,4
1968,p1803,20170712,5342,5342,0,0,0,5342,5342,0,0,0,0,4
1969,p1803,20170713,5342,5342,0,0,0,5240,5240,-102,-102,0,0,4
1970,p1803,20170714,5240,5240,0,0,0,5240,5240,0,0,0,0,4
1971,p1803,20170717,5240,5240,0,0,0,5280,5280,40,40,0,0,4
1972,p1803,20170718,5280,5280,0,0,0,5280,5280,0,0,0,0,4
1973,p1803,20170719,5280,5280,0,0,0,5280,5280,0,0,0,0,4
1974,p1803,20170720,5280,5280,5280,5368,5268,5268,5304,-12,24,6,318320,2
1975,p1803,20170721,5268,5304,0,0,0,5304,5304,0,0,0,0,2
1976,p1803,20170724,5304,5304,0,0,0,5236,5236,-68,-68,0,0,2
1977,p1803,20170725,5236,5236,0,0,0,5294,5294,58,58,0,0,2
1978,p1803,20170726,5294,5294,5456,5468,5392,5422,5426,128,132,120,6512520,14
1979,p1803,20170727,5422,5426,5428,5428,5428,5428,5428,2,2,12,651360,2
1980,p1803,20170728,5428,5428,0,0,0,5428,5428,0,0,0,0,2
1981,p1803,20170731,5428,5428,0,0,0,5458,5458,30,30,0,0,2
1982,p1803,20170801,5458,5458,5524,5524,5524,5524,5524,66,66,2,110480,0
1983,p1803,20170802,5524,5524,0,0,0,5450,5450,-74,-74,0,0,0
1984,p1803,20170803,5450,5450,0,0,0,5428,5428,-22,-22,0,0,0
1985,p1803,20170804,5428,5428,0,0,0,5428,5428,0,0,0,0,0
1986,p1803,20170807,5428,5428,0,0,0,5428,5428,0,0,0,0,0
1987,p1803,20170808,5428,5428,0,0,0,5428,5428,0,0,0,0,0
1988,p1803,20170809,5428,5428,0,0,0,5494,5494,66,66,0,0,0
1989,p1803,20170810,5494,5494,0,0,0,5494,5494,0,0,0,0,0
1990,p1803,20170811,5494,5494,0,0,0,5494,5494,0,0,0,0,0
1991,p1803,20170814,5494,5494,0,0,0,5494,5494,0,0,0,0,0
1992,p1803,20170815,5494,5494,0,0,0,5468,5468,-26,-26,0,0,0
1993,p1803,20170816,5468,5468,0,0,0,5484,5484,16,16,0,0,0
1994,p1803,20170817,5484,5484,0,0,0,5484,5484,0,0,0,0,0
1995,p1803,20170818,5484,5484,0,0,0,5484,5484,0,0,0,0,0
1996,p1803,20170821,5484,5484,0,0,0,5484,5484,0,0,0,0,0
1997,p1803,20170822,5484,5484,0,0,0,5670,5670,186,186,0,0,0
1998,p1803,20170823,5670,5670,0,0,0,5706,5706,36,36,0,0,0
1999,p1803,20170824,5706,5706,0,0,0,5710,5710,4,4,0,0,0
2000,p1803,20170825,5710,5710,5648,5648,5580,5580,5614,-130,-96,4,224560,0
2001,p1803,20170828,5580,5614,0,0,0,5614,5614,0,0,0,0,0
2002,p1803,20170829,5614,5614,0,0,0,5568,5568,-46,-46,0,0,0
2003,p1803,20170830,5568,5568,0,0,0,5568,5568,0,0,0,0,0
2004,p1803,20170831,5568,5568,0,0,0,5528,5528,-40,-40,0,0,0
2005,p1803,20170901,5528,5528,0,0,0,5572,5572,44,44,0,0,0
2006,p1803,20170904,5572,5572,0,0,0,5572,5572,0,0,0,0,0
2007,p1803,20170905,5572,5572,5584,5630,5430,5544,5518,-28,-54,194,10706240,6
2008,p1803,20170906,5544,5518,5624,5624,5624,5624,5624,106,106,4,224960,2
2009,p1803,20170907,5624,5624,0,0,0,5594,5594,-30,-30,0,0,2
2010,p1803,20170908,5594,5594,5632,5632,5632,5632,5632,38,38,2,112640,2
2011,p1803,20170911,5632,5632,0,0,0,5632,5632,0,0,0,0,2
2012,p1803,20170912,5632,5632,0,0,0,5558,5558,-74,-74,0,0,2
2013,p1803,20170913,5558,5558,0,0,0,5630,5630,72,72,0,0,2
2014,p1803,20170914,5630,5630,0,0,0,5684,5684,54,54,0,0,2
2015,p1803,20170915,5684,5684,0,0,0,5684,5684,0,0,0,0,2
2016,p1803,20170918,5684,5684,0,0,0,5702,5702,18,18,0,0,2
2017,p1803,20170919,5702,5702,0,0,0,5712,5712,10,10,0,0,2
2018,p1803,20170920,5712,5712,0,0,0,5672,5672,-40,-40,0,0,2
2019,p1803,20170921,5672,5672,0,0,0,5656,5656,-16,-16,0,0,2
2020,p1803,20170922,5656,5656,0,0,0,5656,5656,0,0,0,0,2
2021,p1803,20170925,5656,5656,0,0,0,5656,5656,0,0,0,0,2
2022,p1803,20170926,5656,5656,0,0,0,5656,5656,0,0,0,0,2
2023,p1803,20170927,5656,5656,0,0,0,5656,5656,0,0,0,0,2
2024,p1803,20170928,5656,5656,0,0,0,5536,5536,-120,-120,0,0,2
2025,p1803,20170929,5536,5536,0,0,0,5528,5528,-8,-8,0,0,2
2026,p1803,20171009,5528,5528,0,0,0,5604,5604,76,76,0,0,2
2027,p1803,20171010,5604,5604,0,0,0,5604,5604,0,0,0,0,2
2028,p1803,20171011,5604,5604,0,0,0,5604,5604,0,0,0,0,2
2029,p1803,20171012,5604,5604,0,0,0,5568,5568,-36,-36,0,0,2
2030,p1803,20171013,5568,5568,0,0,0,5568,5568,0,0,0,0,2
2031,p1803,20171016,5568,5568,0,0,0,5642,5642,74,74,0,0,2
2032,p1803,20171017,5642,5642,0,0,0,5642,5642,0,0,0,0,2
2033,p1803,20171018,5642,5642,0,0,0,5642,5642,0,0,0,0,2
2034,p1803,20171019,5642,5642,0,0,0,5642,5642,0,0,0,0,2
2035,p1803,20171020,5642,5642,0,0,0,5642,5642,0,0,0,0,2
2036,p1803,20171023,5642,5642,0,0,0,5642,5642,0,0,0,0,2
2037,p1803,20171024,5642,5642,0,0,0,5696,5696,54,54,0,0,2
2038,p1803,20171025,5696,5696,0,0,0,5696,5696,0,0,0,0,2
2039,p1803,20171026,5696,5696,0,0,0,5696,5696,0,0,0,0,2
2040,p1803,20171027,5696,5696,0,0,0,5696,5696,0,0,0,0,2
2041,p1803,20171030,5696,5696,0,0,0,5722,5722,26,26,0,0,2
2042,p1803,20171031,5722,5722,0,0,0,5722,5722,0,0,0,0,2
2043,p1803,20171101,5722,5722,0,0,0,5722,5722,0,0,0,0,2
2044,p1803,20171102,5722,5722,0,0,0,5722,5722,0,0,0,0,2
2045,p1803,20171103,5722,5722,0,0,0,5722,5722,0,0,0,0,2
2046,p1803,20171106,5722,5722,0,0,0,5722,5722,0,0,0,0,2
2047,p1803,20171107,5722,5722,0,0,0,5722,5722,0,0,0,0,2
2048,p1803,20171108,5722,5722,0,0,0,5722,5722,0,0,0,0,2
2049,p1803,20171109,5722,5722,0,0,0,5722,5722,0,0,0,0,2
2050,p1803,20171110,5722,5722,5692,5692,5660,5660,5676,-62,-46,4,227040,2
2051,p1803,20171113,5660,5676,0,0,0,5676,5676,0,0,0,0,2
2052,p1803,20171114,5676,5676,0,0,0,5676,5676,0,0,0,0,2
2053,p1803,20171115,5676,5676,0,0,0,5626,5626,-50,-50,0,0,2
2054,p1803,20171116,5626,5626,0,0,0,5626,5626,0,0,0,0,2
2055,p1803,20171117,5626,5626,0,0,0,5630,5630,4,4,0,0,2
2056,p1803,20171120,5630,5630,0,0,0,5580,5580,-50,-50,0,0,2
2057,p1803,20171121,5580,5580,0,0,0,5546,5546,-34,-34,0,0,2
2058,p1803,20171122,5546,5546,0,0,0,5546,5546,0,0,0,0,2
2059,p1803,20171123,5546,5546,0,0,0,5530,5530,-16,-16,0,0,2
2060,p1803,20171124,5530,5530,0,0,0,5520,5520,-10,-10,0,0,2
2061,p1803,20171127,5520,5520,0,0,0,5460,5460,-60,-60,0,0,2
2062,p1803,20171128,5460,5460,0,0,0,5440,5440,-20,-20,0,0,2
2063,p1803,20171129,5440,5440,0,0,0,5440,5440,0,0,0,0,2
2064,p1803,20171130,5440,5440,0,0,0,5440,5440,0,0,0,0,2
2065,p1803,20171201,5440,5440,5420,5420,5420,5420,5420,-20,-20,2,108400,4
2066,p1803,20171204,5420,5420,5378,5378,5378,5378,5378,-42,-42,2,107560,2
2067,p1803,20171205,5378,5378,0,0,0,5378,5378,0,0,0,0,2
2068,p1803,20171206,5378,5378,0,0,0,5378,5378,0,0,0,0,2
2069,p1803,20171207,5378,5378,0,0,0,5314,5314,-64,-64,0,0,2
2070,p1803,20171208,5314,5314,0,0,0,5314,5314,0,0,0,0,2
2071,p1803,20171211,5314,5314,0,0,0,5314,5314,0,0,0,0,2
2072,p1803,20171212,5314,5314,0,0,0,5314,5314,0,0,0,0,2
2073,p1803,20171213,5314,5314,0,0,0,5314,5314,0,0,0,0,2
2074,p1803,20171214,5314,5314,0,0,0,5266,5266,-48,-48,0,0,2
2075,p1803,20171215,5266,5266,0,0,0,5240,5240,-26,-26,0,0,2
2076,p1803,20171218,5240,5240,0,0,0,5240,5240,0,0,0,0,2
2077,p1803,20171219,5240,5240,0,0,0,5212,5212,-28,-28,0,0,2
2078,p1803,20171220,5212,5212,0,0,0,5212,5212,0,0,0,0,2
2079,p1803,20171221,5212,5212,0,0,0,5136,5136,-76,-76,0,0,2
2080,p1803,20171222,5136,5136,0,0,0,5022,5022,-114,-114,0,0,2
2081,p1803,20171225,5022,5022,0,0,0,5082,5082,60,60,0,0,2
2082,p1803,20171226,5082,5082,0,0,0,5026,5026,-56,-56,0,0,2
2083,p1803,20171227,5026,5026,0,0,0,5050,5050,24,24,0,0,2
2084,p1803,20171228,5050,5050,0,0,0,5074,5074,24,24,0,0,2
2085,p1803,20171229,5074,5074,5132,5132,5132,5132,5132,58,58,2,102640,2
2086,p1804,20170419,5252,5252,0,0,0,5252,5252,0,0,0,0,0
2087,p1804,20170420,5252,5252,5136,5180,5136,5180,5154,-72,-98,14,721680,14
2088,p1804,20170421,5180,5154,5168,5168,5166,5166,5166,12,12,4,206680,12
2089,p1804,20170424,5166,5166,5182,5182,5178,5178,5180,12,14,4,207200,10
2090,p1804,20170425,5178,5180,0,0,0,5142,5142,-38,-38,0,0,10
2091,p1804,20170426,5142,5142,5180,5180,5178,5178,5178,36,36,4,207160,14
2092,p1804,20170427,5178,5178,0,0,0,5178,5178,0,0,0,0,14
2093,p1804,20170428,5178,5178,0,0,0,5178,5178,0,0,0,0,14
2094,p1804,20170502,5178,5178,0,0,0,5246,5246,68,68,0,0,14
2095,p1804,20170503,5246,5246,0,0,0,5250,5250,4,4,0,0,14
2096,p1804,20170504,5250,5250,0,0,0,5204,5204,-46,-46,0,0,14
2097,p1804,20170505,5204,5204,0,0,0,5204,5204,0,0,0,0,14
2098,p1804,20170508,5204,5204,0,0,0,5204,5204,0,0,0,0,14
2099,p1804,20170509,5204,5204,0,0,0,5204,5204,0,0,0,0,14
2100,p1804,20170510,5204,5204,0,0,0,5218,5218,14,14,0,0,14
2101,p1804,20170511,5218,5218,5348,5380,5320,5380,5342,162,124,8,427360,18
2102,p1804,20170512,5380,5342,5408,5408,5408,5408,5408,66,66,2,108160,18
2103,p1804,20170515,5408,5408,0,0,0,5408,5408,0,0,0,0,18
2104,p1804,20170516,5408,5408,0,0,0,5408,5408,0,0,0,0,18
2105,p1804,20170517,5408,5408,0,0,0,5418,5418,10,10,0,0,18
2106,p1804,20170518,5418,5418,0,0,0,5418,5418,0,0,0,0,18
2107,p1804,20170519,5418,5418,0,0,0,5370,5370,-48,-48,0,0,18
2108,p1804,20170522,5370,5370,0,0,0,5410,5410,40,40,0,0,18
2109,p1804,20170523,5410,5410,5350,5350,5350,5350,5350,-60,-60,2,107000,16
2110,p1804,20170524,5350,5350,5346,5346,5346,5346,5346,-4,-4,2,106920,14
2111,p1804,20170525,5346,5346,0,0,0,5334,5334,-12,-12,0,0,14
2112,p1804,20170526,5334,5334,0,0,0,5506,5506,172,172,0,0,14
2113,p1804,20170531,5506,5506,0,0,0,5234,5234,-272,-272,0,0,14
2114,p1804,20170601,5234,5234,0,0,0,5180,5180,-54,-54,0,0,14
2115,p1804,20170602,5180,5180,0,0,0,5186,5186,6,6,0,0,14
2116,p1804,20170605,5186,5186,0,0,0,5206,5206,20,20,0,0,14
2117,p1804,20170606,5206,5206,0,0,0,5184,5184,-22,-22,0,0,14
2118,p1804,20170607,5184,5184,0,0,0,5178,5178,-6,-6,0,0,14
2119,p1804,20170608,5178,5178,0,0,0,5132,5132,-46,-46,0,0,14
2120,p1804,20170609,5132,5132,0,0,0,5174,5174,42,42,0,0,14
2121,p1804,20170612,5174,5174,0,0,0,5174,5174,0,0,0,0,14
2122,p1804,20170613,5174,5174,0,0,0,5176,5176,2,2,0,0,14
2123,p1804,20170614,5176,5176,0,0,0,5150,5150,-26,-26,0,0,14
2124,p1804,20170615,5150,5150,0,0,0,5186,5186,36,36,0,0,14
2125,p1804,20170616,5186,5186,5328,5328,5222,5222,5286,36,100,208,10994960,14
2126,p1804,20170619,5222,5286,5252,5376,5200,5352,5292,66,6,18,952600,14
2127,p1804,20170620,5352,5292,5260,5298,5260,5298,5278,6,-14,4,211160,14
2128,p1804,20170621,5298,5278,0,0,0,5278,5278,0,0,0,0,14
2129,p1804,20170622,5278,5278,5212,5212,5212,5212,5212,-66,-66,2,104240,14
2130,p1804,20170623,5212,5212,0,0,0,5212,5212,0,0,0,0,14
2131,p1804,20170626,5212,5212,0,0,0,5212,5212,0,0,0,0,14
2132,p1804,20170627,5212,5212,0,0,0,5228,5228,16,16,0,0,14
2133,p1804,20170628,5228,5228,0,0,0,5228,5228,0,0,0,0,14
2134,p1804,20170629,5228,5228,0,0,0,5248,5248,20,20,0,0,14
2135,p1804,20170630,5248,5248,0,0,0,5248,5248,0,0,0,0,14
2136,p1804,20170703,5248,5248,0,0,0,5248,5248,0,0,0,0,14
2137,p1804,20170704,5248,5248,0,0,0,5196,5196,-52,-52,0,0,14
2138,p1804,20170705,5196,5196,0,0,0,5258,5258,62,62,0,0,14
2139,p1804,20170706,5258,5258,0,0,0,5364,5364,106,106,0,0,14
2140,p1804,20170707,5364,5364,0,0,0,5370,5370,6,6,0,0,14
2141,p1804,20170710,5370,5370,0,0,0,5420,5420,50,50,0,0,14
2142,p1804,20170711,5420,5420,0,0,0,5456,5456,36,36,0,0,14
2143,p1804,20170712,5456,5456,0,0,0,5456,5456,0,0,0,0,14
2144,p1804,20170713,5456,5456,0,0,0,5456,5456,0,0,0,0,14
2145,p1804,20170714,5456,5456,0,0,0,5456,5456,0,0,0,0,14
2146,p1804,20170717,5456,5456,0,0,0,5456,5456,0,0,0,0,14
2147,p1804,20170718,5456,5456,0,0,0,5456,5456,0,0,0,0,14
2148,p1804,20170719,5456,5456,0,0,0,5456,5456,0,0,0,0,14
2149,p1804,20170720,5456,5456,0,0,0,5456,5456,0,0,0,0,14
2150,p1804,20170721,5456,5456,0,0,0,5456,5456,0,0,0,0,14
2151,p1804,20170724,5456,5456,0,0,0,5456,5456,0,0,0,0,14
2152,p1804,20170725,5456,5456,0,0,0,5456,5456,0,0,0,0,14
2153,p1804,20170726,5456,5456,0,0,0,5468,5468,12,12,0,0,14
2154,p1804,20170727,5468,5468,0,0,0,5470,5470,2,2,0,0,14
2155,p1804,20170728,5470,5470,0,0,0,5468,5468,-2,-2,0,0,14
2156,p1804,20170731,5468,5468,0,0,0,5574,5574,106,106,0,0,14
2157,p1804,20170801,5574,5574,5646,5646,5646,5646,5646,72,72,4,225840,10
2158,p1804,20170802,5646,5646,0,0,0,5620,5620,-26,-26,0,0,10
2159,p1804,20170803,5620,5620,0,0,0,5620,5620,0,0,0,0,10
2160,p1804,20170804,5620,5620,0,0,0,5620,5620,0,0,0,0,10
2161,p1804,20170807,5620,5620,0,0,0,5620,5620,0,0,0,0,10
2162,p1804,20170808,5620,5620,0,0,0,5620,5620,0,0,0,0,10
2163,p1804,20170809,5620,5620,0,0,0,5620,5620,0,0,0,0,10
2164,p1804,20170810,5620,5620,0,0,0,5620,5620,0,0,0,0,10
2165,p1804,20170811,5620,5620,0,0,0,5620,5620,0,0,0,0,10
2166,p1804,20170814,5620,5620,0,0,0,5620,5620,0,0,0,0,10
2167,p1804,20170815,5620,5620,0,0,0,5620,5620,0,0,0,0,10
2168,p1804,20170816,5620,5620,0,0,0,5560,5560,-60,-60,0,0,10
2169,p1804,20170817,5560,5560,0,0,0,5560,5560,0,0,0,0,10
2170,p1804,20170818,5560,5560,0,0,0,5560,5560,0,0,0,0,10
2171,p1804,20170821,5560,5560,0,0,0,5560,5560,0,0,0,0,10
2172,p1804,20170822,5560,5560,0,0,0,5560,5560,0,0,0,0,10
2173,p1804,20170823,5560,5560,0,0,0,5560,5560,0,0,0,0,10
2174,p1804,20170824,5560,5560,0,0,0,5652,5652,92,92,0,0,10
2175,p1804,20170825,5652,5652,0,0,0,5652,5652,0,0,0,0,10
2176,p1804,20170828,5652,5652,0,0,0,5656,5656,4,4,0,0,10
2177,p1804,20170829,5656,5656,0,0,0,5656,5656,0,0,0,0,10
2178,p1804,20170830,5656,5656,0,0,0,5656,5656,0,0,0,0,10
2179,p1804,20170831,5656,5656,0,0,0,5656,5656,0,0,0,0,10
2180,p1804,20170901,5656,5656,0,0,0,5656,5656,0,0,0,0,10
2181,p1804,20170904,5656,5656,0,0,0,5656,5656,0,0,0,0,10
2182,p1804,20170905,5656,5656,0,0,0,5656,5656,0,0,0,0,10
2183,p1804,20170906,5656,5656,0,0,0,5656,5656,0,0,0,0,10
2184,p1804,20170907,5656,5656,0,0,0,5656,5656,0,0,0,0,10
2185,p1804,20170908,5656,5656,0,0,0,5656,5656,0,0,0,0,10
2186,p1804,20170911,5656,5656,5552,5552,5552,5552,5552,-104,-104,2,111040,10
2187,p1804,20170912,5552,5552,0,0,0,5552,5552,0,0,0,0,10
2188,p1804,20170913,5552,5552,5798,5798,5756,5756,5784,204,232,6,347040,12
2189,p1804,20170914,5756,5784,0,0,0,5784,5784,0,0,0,0,12
2190,p1804,20170915,5784,5784,0,0,0,5784,5784,0,0,0,0,12
2191,p1804,20170918,5784,5784,0,0,0,5784,5784,0,0,0,0,12
2192,p1804,20170919,5784,5784,0,0,0,5784,5784,0,0,0,0,12
2193,p1804,20170920,5784,5784,0,0,0,5784,5784,0,0,0,0,12
2194,p1804,20170921,5784,5784,5702,5702,5702,5702,5702,-82,-82,2,114040,10
2195,p1804,20170922,5702,5702,0,0,0,5702,5702,0,0,0,0,10
2196,p1804,20170925,5702,5702,0,0,0,5702,5702,0,0,0,0,10
2197,p1804,20170926,5702,5702,0,0,0,5702,5702,0,0,0,0,10
2198,p1804,20170927,5702,5702,0,0,0,5702,5702,0,0,0,0,10
2199,p1804,20170928,5702,5702,5584,5584,5584,5584,5584,-118,-118,2,111680,10
2200,p1804,20170929,5584,5584,0,0,0,5584,5584,0,0,0,0,10
2201,p1804,20171009,5584,5584,0,0,0,5584,5584,0,0,0,0,10
2202,p1804,20171010,5584,5584,0,0,0,5584,5584,0,0,0,0,10
2203,p1804,20171011,5584,5584,0,0,0,5584,5584,0,0,0,0,10
2204,p1804,20171012,5584,5584,0,0,0,5584,5584,0,0,0,0,10
2205,p1804,20171013,5584,5584,0,0,0,5584,5584,0,0,0,0,10
2206,p1804,20171016,5584,5584,0,0,0,5584,5584,0,0,0,0,10
2207,p1804,20171017,5584,5584,0,0,0,5616,5616,32,32,0,0,10
2208,p1804,20171018,5616,5616,0,0,0,5616,5616,0,0,0,0,10
2209,p1804,20171019,5616,5616,0,0,0,5616,5616,0,0,0,0,10
2210,p1804,20171020,5616,5616,0,0,0,5616,5616,0,0,0,0,10
2211,p1804,20171023,5616,5616,0,0,0,5616,5616,0,0,0,0,10
2212,p1804,20171024,5616,5616,0,0,0,5716,5716,100,100,0,0,10
2213,p1804,20171025,5716,5716,0,0,0,5746,5746,30,30,0,0,10
2214,p1804,20171026,5746,5746,0,0,0,5746,5746,0,0,0,0,10
2215,p1804,20171027,5746,5746,0,0,0,5756,5756,10,10,0,0,10
2216,p1804,20171030,5756,5756,5818,5898,5818,5882,5862,126,106,10,586280,12
2217,p1804,20171031,5882,5862,5820,5820,5820,5820,5820,-42,-42,2,116400,10
2218,p1804,20171101,5820,5820,0,0,0,5796,5796,-24,-24,0,0,10
2219,p1804,20171102,5796,5796,0,0,0,5796,5796,0,0,0,0,10
2220,p1804,20171103,5796,5796,0,0,0,5796,5796,0,0,0,0,10
2221,p1804,20171106,5796,5796,0,0,0,5796,5796,0,0,0,0,10
2222,p1804,20171107,5796,5796,0,0,0,5796,5796,0,0,0,0,10
2223,p1804,20171108,5796,5796,0,0,0,5796,5796,0,0,0,0,10
2224,p1804,20171109,5796,5796,0,0,0,5796,5796,0,0,0,0,10
2225,p1804,20171110,5796,5796,0,0,0,5796,5796,0,0,0,0,10
2226,p1804,20171113,5796,5796,0,0,0,5796,5796,0,0,0,0,10
2227,p1804,20171114,5796,5796,0,0,0,5726,5726,-70,-70,0,0,10
2228,p1804,20171115,5726,5726,0,0,0,5726,5726,0,0,0,0,10
2229,p1804,20171116,5726,5726,0,0,0,5726,5726,0,0,0,0,10
2230,p1804,20171117,5726,5726,0,0,0,5726,5726,0,0,0,0,10
2231,p1804,20171120,5726,5726,5636,5636,5636,5636,5636,-90,-90,2,112720,10
2232,p1804,20171121,5636,5636,0,0,0,5636,5636,0,0,0,0,10
2233,p1804,20171122,5636,5636,0,0,0,5636,5636,0,0,0,0,10
2234,p1804,20171123,5636,5636,0,0,0,5636,5636,0,0,0,0,10
2235,p1804,20171124,5636,5636,0,0,0,5626,5626,-10,-10,0,0,10
2236,p1804,20171127,5626,5626,5596,5596,5444,5444,5522,-182,-104,6,331360,10
2237,p1804,20171128,5444,5522,5492,5492,5492,5492,5492,-30,-30,2,109840,10
2238,p1804,20171129,5492,5492,0,0,0,5492,5492,0,0,0,0,10
2239,p1804,20171130,5492,5492,0,0,0,5492,5492,0,0,0,0,10
2240,p1804,20171201,5492,5492,5532,5532,5504,5504,5518,12,26,4,220720,10
2241,p1804,20171204,5504,5518,0,0,0,5518,5518,0,0,0,0,10
2242,p1804,20171205,5518,5518,5462,5462,5462,5462,5462,-56,-56,2,109240,12
2243,p1804,20171206,5462,5462,5476,5476,5476,5476,5476,14,14,2,109520,10
2244,p1804,20171207,5476,5476,5416,5416,5416,5416,5416,-60,-60,2,108320,12
2245,p1804,20171208,5416,5416,0,0,0,5416,5416,0,0,0,0,12
2246,p1804,20171211,5416,5416,0,0,0,5416,5416,0,0,0,0,12
2247,p1804,20171212,5416,5416,0,0,0,5416,5416,0,0,0,0,12
2248,p1804,20171213,5416,5416,0,0,0,5416,5416,0,0,0,0,12
2249,p1804,20171214,5416,5416,5350,5350,5350,5350,5350,-66,-66,2,107000,10
2250,p1804,20171215,5350,5350,0,0,0,5324,5324,-26,-26,0,0,10
2251,p1804,20171218,5324,5324,0,0,0,5324,5324,0,0,0,0,10
2252,p1804,20171219,5324,5324,0,0,0,5324,5324,0,0,0,0,10
2253,p1804,20171220,5324,5324,0,0,0,5324,5324,0,0,0,0,10
2254,p1804,20171221,5324,5324,0,0,0,5246,5246,-78,-78,0,0,10
2255,p1804,20171222,5246,5246,5150,5150,5124,5130,5130,-116,-116,44,2257840,24
2256,p1804,20171225,5130,5130,0,0,0,5130,5130,0,0,0,0,24
2257,p1804,20171226,5130,5130,0,0,0,5130,5130,0,0,0,0,24
2258,p1804,20171227,5130,5130,0,0,0,5154,5154,24,24,0,0,24
2259,p1804,20171228,5154,5154,0,0,0,5154,5154,0,0,0,0,24
2260,p1804,20171229,5154,5154,0,0,0,5212,5212,58,58,0,0,24
2261,p1805,20170516,5408,5408,5316,5350,5310,5340,5330,-68,-78,2372,126471480,1808
2262,p1805,20170517,5340,5330,5342,5380,5326,5378,5338,48,8,682,36412840,2132
2263,p1805,20170518,5378,5338,5374,5400,5350,5370,5374,32,36,824,44295920,2326
2264,p1805,20170519,5370,5374,5322,5358,5300,5328,5330,-46,-44,780,41574560,2598
2265,p1805,20170522,5328,5330,5334,5386,5334,5362,5368,32,38,1196,64214160,2884
2266,p1805,20170523,5362,5368,5362,5374,5306,5310,5336,-58,-32,1002,53477600,3578
2267,p1805,20170524,5310,5336,5302,5318,5250,5266,5282,-70,-54,552,29157000,3740
2268,p1805,20170525,5266,5282,5276,5306,5250,5276,5282,-6,0,1272,67210960,4666
2269,p1805,20170526,5276,5282,5288,5300,5206,5206,5244,-76,-38,1570,82353200,5158
2270,p1805,20170531,5206,5244,5180,5182,5088,5088,5132,-156,-112,626,32129760,5212
2271,p1805,20170601,5088,5132,5106,5116,5048,5062,5090,-70,-42,914,46532560,5728
2272,p1805,20170602,5062,5090,5080,5128,5080,5086,5100,-4,10,3720,189727120,8082
2273,p1805,20170605,5086,5100,5080,5166,5050,5124,5092,24,-8,2012,102460760,9438
2274,p1805,20170606,5124,5092,5112,5130,5074,5104,5104,12,12,1142,58291520,9720
2275,p1805,20170607,5104,5104,5120,5144,5080,5084,5102,-20,-2,2202,112375760,10134
2276,p1805,20170608,5084,5102,5076,5090,5042,5070,5062,-32,-40,2050,103781080,11108
2277,p1805,20170609,5070,5062,5076,5152,5076,5120,5116,58,54,2956,151243480,12948
2278,p1805,20170612,5120,5116,5130,5204,5130,5192,5166,76,50,2008,103772880,12828
2279,p1805,20170613,5192,5166,5196,5198,5144,5154,5162,-12,-4,1026,52974760,13448
2280,p1805,20170614,5154,5162,5132,5164,5130,5160,5148,-2,-14,1912,98460440,13468
2281,p1805,20170615,5160,5148,5172,5204,5162,5176,5178,28,30,972,50333120,13676
2282,p1805,20170616,5176,5178,5186,5250,5170,5242,5236,64,58,2352,123160720,13762
2283,p1805,20170619,5242,5236,5258,5324,5228,5296,5294,60,58,2318,122723920,13448
2284,p1805,20170620,5296,5294,5300,5300,5212,5232,5246,-62,-48,3822,200535400,14904
2285,p1805,20170621,5232,5246,5218,5224,5168,5180,5186,-66,-60,4078,211536120,15948
2286,p1805,20170622,5180,5186,5188,5196,5140,5148,5160,-38,-26,1222,63057280,16026
2287,p1805,20170623,5148,5160,5156,5180,5140,5166,5154,6,-6,1744,89887320,16854
2288,p1805,20170626,5166,5154,5178,5186,5156,5164,5166,10,12,1400,72347200,16864
2289,p1805,20170627,5164,5166,5156,5214,5152,5204,5172,38,6,2792,144439000,17752
2290,p1805,20170628,5204,5172,5218,5252,5186,5200,5222,28,50,5532,288892040,18950
2291,p1805,20170629,5200,5222,5192,5260,5192,5246,5240,24,18,3636,190553120,20094
2292,p1805,20170630,5246,5240,5260,5282,5226,5260,5254,20,14,1152,60543800,20268
2293,p1805,20170703,5260,5254,5248,5350,5230,5310,5290,56,36,5228,276614320,22552
2294,p1805,20170704,5310,5290,5322,5322,5236,5246,5264,-44,-26,2618,137829320,23246
2295,p1805,20170705,5246,5264,5258,5298,5258,5290,5278,26,14,3278,173055800,23026
2296,p1805,20170706,5290,5278,5302,5362,5292,5344,5336,66,58,2716,144926280,23144
2297,p1805,20170707,5344,5336,5344,5360,5308,5342,5336,6,0,2398,127959280,23624
2298,p1805,20170710,5342,5336,5336,5430,5332,5412,5400,76,64,5568,300752600,24776
2299,p1805,20170711,5412,5400,5430,5470,5394,5432,5430,32,30,6334,344038680,26468
2300,p1805,20170712,5432,5430,5430,5462,5408,5428,5436,-2,6,3266,177594440,28080
2301,p1805,20170713,5428,5436,5436,5444,5378,5402,5406,-34,-30,3838,207509760,29652
2302,p1805,20170714,5402,5406,5350,5392,5338,5360,5358,-46,-48,3406,182541120,30350
2303,p1805,20170717,5360,5358,5382,5418,5370,5376,5394,18,36,3672,198103400,31452
2304,p1805,20170718,5376,5394,5376,5418,5328,5330,5380,-64,-14,11082,596256680,28854
2305,p1805,20170719,5330,5380,5340,5362,5302,5346,5336,-34,-44,3722,198645040,28666
2306,p1805,20170720,5346,5336,5350,5420,5206,5400,5370,64,34,9916,532666240,30264
2307,p1805,20170721,5400,5370,5410,5462,5400,5414,5426,44,56,4818,261474680,30268
2308,p1805,20170724,5414,5426,5430,5430,5336,5368,5370,-58,-56,5184,278414000,32144
2309,p1805,20170725,5368,5370,5378,5492,5364,5488,5440,118,70,7410,403233440,33834
2310,p1805,20170726,5488,5440,5498,5512,5460,5470,5484,30,44,13888,761749560,35810
2311,p1805,20170727,5470,5484,5484,5574,5474,5568,5546,84,62,14610,810509160,38272
2312,p1805,20170728,5568,5546,5576,5602,5488,5522,5538,-24,-8,9822,544099600,40198
2313,p1805,20170731,5522,5538,5538,5612,5522,5592,5580,54,42,8646,482555920,40034
2314,p1805,20170801,5592,5580,5582,5646,5548,5552,5584,-28,4,12306,687249440,42182
2315,p1805,20170802,5552,5584,5548,5562,5496,5526,5524,-58,-60,6750,372891040,41918
2316,p1805,20170803,5526,5524,5532,5556,5446,5452,5510,-72,-14,10916,601591000,42768
2317,p1805,20170804,5452,5510,5452,5492,5426,5486,5472,-24,-38,9554,522880240,43686
2318,p1805,20170807,5486,5472,5480,5526,5440,5456,5486,-16,14,3950,216699040,43716
2319,p1805,20170808,5456,5486,5448,5530,5412,5526,5476,40,-10,6248,342215480,43314
2320,p1805,20170809,5526,5476,5532,5558,5518,5558,5540,82,64,8494,470603320,45522
2321,p1805,20170810,5558,5540,5550,5568,5468,5532,5522,-8,-18,11452,632586160,45370
2322,p1805,20170811,5532,5522,5546,5626,5472,5494,5534,-28,12,15594,863002160,46008
2323,p1805,20170814,5494,5534,5530,5590,5490,5562,5548,28,14,12248,679535240,46862
2324,p1805,20170815,5562,5548,5552,5556,5482,5492,5510,-56,-38,7270,400681720,47616
2325,p1805,20170816,5492,5510,5470,5474,5406,5414,5430,-96,-80,10754,584148200,46560
2326,p1805,20170817,5414,5430,5438,5468,5422,5462,5446,32,16,9920,540255000,48118
2327,p1805,20170818,5462,5446,5472,5520,5444,5518,5486,72,40,15140,830614280,49606
2328,p1805,20170821,5518,5486,5518,5568,5512,5560,5548,74,62,14212,788518600,52004
2329,p1805,20170822,5560,5548,5578,5654,5552,5654,5612,106,64,25484,1430318720,52788
2330,p1805,20170823,5654,5612,5646,5672,5600,5626,5628,14,16,39034,2197371080,61740
2331,p1805,20170824,5626,5628,5636,5674,5588,5666,5632,38,4,26306,1481975840,58246
2332,p1805,20170825,5666,5632,5676,5706,5616,5618,5658,-14,26,33082,1872065960,63654
2333,p1805,20170828,5618,5658,5618,5662,5604,5624,5632,-34,-26,22926,1291556400,62666
2334,p1805,20170829,5624,5632,5628,5628,5556,5570,5590,-62,-42,14674,820559680,62126
2335,p1805,20170830,5570,5590,5564,5610,5530,5536,5570,-54,-20,30348,1690937200,63260
2336,p1805,20170831,5536,5570,5544,5586,5530,5564,5560,-6,-10,18792,1045029880,62236
2337,p1805,20170901,5564,5560,5554,5624,5554,5616,5598,56,38,14504,811978920,62804
2338,p1805,20170904,5616,5598,5618,5652,5588,5630,5626,32,28,18770,1056323440,64358
2339,p1805,20170905,5630,5626,5612,5650,5578,5650,5604,24,-22,26046,1460134840,69606
2340,p1805,20170906,5650,5604,5658,5676,5610,5642,5636,38,32,28502,1606757440,73698
2341,p1805,20170907,5642,5636,5628,5646,5580,5620,5612,-16,-24,25290,1419345880,72272
2342,p1805,20170908,5620,5612,5650,5660,5552,5560,5602,-52,-10,38960,2182698760,79420
2343,p1805,20170911,5560,5602,5560,5672,5498,5666,5590,64,-12,51728,2892266000,81536
2344,p1805,20170912,5666,5590,5668,5678,5616,5650,5652,60,62,29086,1644017560,81884
2345,p1805,20170913,5650,5652,5666,5742,5628,5650,5676,-2,24,51118,2902068600,85292
2346,p1805,20170914,5650,5676,5670,5746,5646,5726,5708,50,32,47336,2702398560,84944
2347,p1805,20170915,5726,5708,5716,5736,5670,5712,5702,4,-6,31586,1801588800,87488
2348,p1805,20170918,5712,5702,5704,5706,5644,5682,5676,-20,-26,19444,1103910680,86696
2349,p1805,20170919,5682,5676,5644,5728,5644,5696,5690,20,14,23824,1355904080,87398
2350,p1805,20170920,5696,5690,5672,5710,5638,5670,5676,-20,-14,40166,2280168840,87896
2351,p1805,20170921,5670,5676,5676,5724,5646,5650,5692,-26,16,67668,3851784120,92462
2352,p1805,20170922,5650,5692,5636,5660,5608,5620,5632,-72,-60,47094,2652336280,85348
2353,p1805,20170925,5620,5632,5626,5662,5560,5578,5606,-54,-26,30606,1716331000,83132
2354,p1805,20170926,5578,5606,5582,5602,5568,5578,5588,-28,-18,34032,1902180480,83834
2355,p1805,20170927,5578,5588,5616,5634,5568,5604,5600,16,12,43314,2425666720,81626
2356,p1805,20170928,5604,5600,5604,5610,5446,5486,5506,-114,-94,76374,4205388160,96108
2357,p1805,20170929,5486,5506,5484,5530,5474,5514,5502,8,-4,33590,1848345120,102030
2358,p1805,20171009,5514,5502,5550,5596,5538,5552,5564,50,62,42276,2353038120,103188
2359,p1805,20171010,5552,5564,5558,5558,5504,5520,5522,-44,-42,36796,2032194080,107180
2360,p1805,20171011,5520,5522,5506,5530,5480,5490,5500,-32,-22,43466,2390760240,117168
2361,p1805,20171012,5490,5500,5500,5544,5494,5536,5522,36,22,34338,1896501200,122662
2362,p1805,20171013,5536,5522,5526,5546,5456,5546,5502,24,-20,54036,2973588440,122344
2363,p1805,20171016,5546,5502,5578,5592,5544,5584,5572,82,70,48114,2681469960,126740
2364,p1805,20171017,5584,5572,5580,5630,5562,5606,5588,34,16,51326,2868416280,128064
2365,p1805,20171018,5606,5588,5596,5596,5520,5562,5556,-26,-32,46402,2578727680,136066
2366,p1805,20171019,5562,5556,5558,5596,5502,5506,5558,-50,2,44808,2490530240,143010
2367,p1805,20171020,5506,5558,5518,5618,5508,5598,5562,40,4,48602,2703751000,139168
2368,p1805,20171023,5598,5562,5618,5666,5584,5656,5626,94,64,61298,3448771920,141536
2369,p1805,20171024,5656,5626,5680,5722,5656,5706,5694,80,68,99190,5649591720,167104
2370,p1805,20171025,5706,5694,5690,5778,5676,5744,5722,50,28,109932,6290385160,169022
2371,p1805,20171026,5744,5722,5750,5758,5708,5728,5726,6,4,58692,3361818920,168062
2372,p1805,20171027,5728,5726,5734,5764,5710,5748,5740,22,14,72644,4171030240,172814
2373,p1805,20171030,5748,5740,5730,5824,5702,5798,5776,58,36,92922,5368722320,183828
2374,p1805,20171031,5798,5776,5798,5810,5760,5786,5784,10,8,71204,4119169320,176392
2375,p1805,20171101,5786,5784,5780,5804,5744,5750,5772,-34,-12,75558,4361531880,185850
2376,p1805,20171102,5750,5772,5776,5798,5754,5764,5772,-8,0,87936,5076164040,201882
2377,p1805,20171103,5764,5772,5728,5754,5706,5738,5730,-34,-42,64272,3682956240,204156
2378,p1805,20171106,5738,5730,5732,5762,5678,5730,5712,0,-18,93850,5362342320,209902
2379,p1805,20171107,5730,5712,5712,5780,5712,5750,5746,38,34,92396,5310754800,217566
2380,p1805,20171108,5750,5746,5734,5758,5704,5726,5732,-20,-14,80114,4593070320,219948
2381,p1805,20171109,5726,5732,5760,5812,5746,5794,5780,62,48,115264,6663951160,233614
2382,p1805,20171110,5794,5780,5772,5794,5716,5720,5754,-60,-26,104414,6009001960,230606
2383,p1805,20171113,5720,5754,5762,5762,5724,5744,5740,-10,-14,70390,4040703040,246534
2384,p1805,20171114,5744,5740,5722,5726,5640,5668,5674,-72,-66,126180,7161190840,241568
2385,p1805,20171115,5668,5674,5630,5656,5572,5578,5616,-96,-58,124180,6974398360,251580
2386,p1805,20171116,5578,5616,5578,5636,5532,5610,5594,-6,-22,94544,5290157440,257892
2387,p1805,20171117,5610,5594,5598,5630,5568,5574,5598,-20,4,84936,4755076640,266140
2388,p1805,20171120,5574,5598,5570,5600,5506,5526,5540,-72,-58,125774,6968450200,278000
2389,p1805,20171121,5526,5540,5488,5528,5474,5478,5502,-62,-38,157924,8689489520,302560
2390,p1805,20171122,5478,5502,5500,5532,5484,5494,5508,-8,6,183852,10127970960,318500
2391,p1805,20171123,5494,5508,5522,5530,5464,5496,5506,-12,-2,203140,11188629720,315954
2392,p1805,20171124,5496,5506,5476,5514,5466,5496,5496,-10,-10,190834,10489725000,336102
2393,p1805,20171127,5496,5496,5500,5514,5394,5402,5442,-94,-54,329704,17944664520,372598
2394,p1805,20171128,5402,5442,5418,5440,5404,5428,5422,-14,-20,199056,10795338360,364372
2395,p1805,20171129,5428,5422,5430,5446,5384,5412,5416,-10,-6,240964,13051660720,371096
2396,p1805,20171130,5412,5416,5400,5464,5378,5414,5420,-2,4,311790,16901410600,381600
2397,p1805,20171201,5414,5420,5460,5468,5410,5456,5440,36,20,298244,16228066200,388624
2398,p1805,20171204,5456,5440,5456,5508,5436,5492,5472,52,32,328162,17962292440,399198
2399,p1805,20171205,5492,5472,5472,5486,5362,5386,5426,-86,-46,336392,18257460480,427136
2400,p1805,20171206,5386,5426,5392,5436,5380,5414,5404,-12,-22,281102,15195661400,437198
2401,p1805,20171207,5414,5404,5384,5388,5292,5316,5336,-88,-68,364918,19475924080,456466
2402,p1805,20171208,5316,5336,5294,5352,5294,5336,5328,0,-8,242242,12907861520,459296
2403,p1805,20171211,5336,5328,5322,5358,5308,5324,5328,-4,0,294486,15693458880,473860
2404,p1805,20171212,5324,5328,5310,5368,5302,5328,5338,0,10,353650,18882106040,500218
2405,p1805,20171213,5328,5338,5336,5340,5310,5324,5324,-14,-14,209012,11128484040,487268
2406,p1805,20171214,5324,5324,5318,5324,5208,5218,5262,-106,-62,417452,21969415720,546528
2407,p1805,20171215,5218,5262,5254,5256,5214,5246,5238,-16,-24,258884,13562753240,546740
2408,p1805,20171218,5246,5238,5288,5308,5266,5294,5286,56,48,289336,15295839080,527540
2409,p1805,20171219,5294,5286,5278,5290,5234,5254,5260,-32,-26,223624,11764731280,528020
2410,p1805,20171220,5254,5260,5262,5298,5254,5274,5274,14,14,230584,12163111320,536560
2411,p1805,20171221,5274,5274,5248,5268,5170,5180,5214,-94,-60,382560,19946757480,561068
2412,p1805,20171222,5180,5214,5166,5172,5106,5134,5132,-80,-82,344642,17688275080,578972
2413,p1805,20171225,5134,5132,5144,5186,5134,5176,5162,44,30,279434,14426717880,554060
2414,p1805,20171226,5176,5162,5160,5190,5156,5178,5174,16,12,161702,8368987280,558922
2415,p1805,20171227,5178,5174,5206,5250,5192,5232,5222,58,48,310280,16207884320,544010
2416,p1805,20171228,5232,5222,5248,5262,5218,5248,5242,26,20,260848,13675059560,528058
2417,p1805,20171229,5248,5242,5230,5254,5204,5226,5230,-16,-12,235898,12338656080,511778
2418,p1806,20170615,5148,5148,0,0,0,5148,5148,0,0,0,0,0
2419,p1806,20170616,5148,5148,0,0,0,5148,5148,0,0,0,0,0
2420,p1806,20170619,5148,5148,0,0,0,5148,5148,0,0,0,0,0
2421,p1806,20170620,5148,5148,5352,5352,5306,5306,5328,158,180,8,426320,8
2422,p1806,20170621,5306,5328,0,0,0,5268,5268,-60,-60,0,0,8
2423,p1806,20170622,5268,5268,0,0,0,5268,5268,0,0,0,0,8
2424,p1806,20170623,5268,5268,0,0,0,5268,5268,0,0,0,0,8
2425,p1806,20170626,5268,5268,5258,5258,5250,5250,5254,-18,-14,4,210160,8
2426,p1806,20170627,5250,5254,0,0,0,5260,5260,6,6,0,0,8
2427,p1806,20170628,5260,5260,0,0,0,5260,5260,0,0,0,0,8
2428,p1806,20170629,5260,5260,0,0,0,5278,5278,18,18,0,0,8
2429,p1806,20170630,5278,5278,0,0,0,5278,5278,0,0,0,0,8
2430,p1806,20170703,5278,5278,5360,5370,5360,5370,5364,92,86,4,214600,8
2431,p1806,20170704,5370,5364,0,0,0,5364,5364,0,0,0,0,8
2432,p1806,20170705,5364,5364,0,0,0,5364,5364,0,0,0,0,8
2433,p1806,20170706,5364,5364,0,0,0,5422,5422,58,58,0,0,8
2434,p1806,20170707,5422,5422,0,0,0,5422,5422,0,0,0,0,8
2435,p1806,20170710,5422,5422,5682,5682,5520,5558,5574,136,152,10,557560,16
2436,p1806,20170711,5558,5574,0,0,0,5574,5574,0,0,0,0,16
2437,p1806,20170712,5574,5574,5568,5568,5568,5568,5568,-6,-6,2,111360,14
2438,p1806,20170713,5568,5568,5560,5560,5528,5528,5544,-40,-24,4,221760,16
2439,p1806,20170714,5528,5544,0,0,0,5544,5544,0,0,0,0,16
2440,p1806,20170717,5544,5544,5492,5492,5492,5492,5492,-52,-52,2,109840,14
2441,p1806,20170718,5492,5492,5480,5508,5480,5508,5496,16,4,8,439800,18
2442,p1806,20170719,5508,5496,5500,5500,5422,5422,5452,-74,-44,16,872600,10
2443,p1806,20170720,5422,5452,5414,5414,5414,5414,5414,-38,-38,2,108280,10
2444,p1806,20170721,5414,5414,0,0,0,5436,5436,22,22,0,0,10
2445,p1806,20170724,5436,5436,5560,5560,5560,5560,5560,124,124,2,111200,12
2446,p1806,20170725,5560,5560,0,0,0,5560,5560,0,0,0,0,12
2447,p1806,20170726,5560,5560,0,0,0,5560,5560,0,0,0,0,12
2448,p1806,20170727,5560,5560,0,0,0,5560,5560,0,0,0,0,12
2449,p1806,20170728,5560,5560,0,0,0,5560,5560,0,0,0,0,12
2450,p1806,20170731,5560,5560,5560,5560,5560,5560,5560,0,0,2,111200,12
2451,p1806,20170801,5560,5560,5664,5664,5664,5664,5664,104,104,2,113280,10
2452,p1806,20170802,5664,5664,0,0,0,5664,5664,0,0,0,0,10
2453,p1806,20170803,5664,5664,0,0,0,5578,5578,-86,-86,0,0,10
2454,p1806,20170804,5578,5578,0,0,0,5578,5578,0,0,0,0,10
2455,p1806,20170807,5578,5578,5550,5578,5550,5578,5568,0,-10,6,334120,12
2456,p1806,20170808,5578,5568,5548,5548,5548,5548,5548,-20,-20,2,110960,14
2457,p1806,20170809,5548,5548,5564,5564,5564,5564,5564,16,16,2,111280,12
2458,p1806,20170810,5564,5564,0,0,0,5564,5564,0,0,0,0,12
2459,p1806,20170811,5564,5564,5600,5600,5600,5600,5600,36,36,2,112000,14
2460,p1806,20170814,5600,5600,5592,5592,5592,5592,5592,-8,-8,2,111840,12
2461,p1806,20170815,5592,5592,0,0,0,5592,5592,0,0,0,0,12
2462,p1806,20170816,5592,5592,0,0,0,5512,5512,-80,-80,0,0,12
2463,p1806,20170817,5512,5512,0,0,0,5512,5512,0,0,0,0,12
2464,p1806,20170818,5512,5512,0,0,0,5520,5520,8,8,0,0,12
2465,p1806,20170821,5520,5520,0,0,0,5520,5520,0,0,0,0,12
2466,p1806,20170822,5520,5520,0,0,0,5582,5582,62,62,0,0,12
2467,p1806,20170823,5582,5582,0,0,0,5582,5582,0,0,0,0,12
2468,p1806,20170824,5582,5582,0,0,0,5584,5584,2,2,0,0,12
2469,p1806,20170825,5584,5584,0,0,0,5584,5584,0,0,0,0,12
2470,p1806,20170828,5584,5584,0,0,0,5672,5672,88,88,0,0,12
2471,p1806,20170829,5672,5672,0,0,0,5672,5672,0,0,0,0,12
2472,p1806,20170830,5672,5672,0,0,0,5672,5672,0,0,0,0,12
2473,p1806,20170831,5672,5672,0,0,0,5662,5662,-10,-10,0,0,12
2474,p1806,20170901,5662,5662,0,0,0,5662,5662,0,0,0,0,12
2475,p1806,20170904,5662,5662,0,0,0,5662,5662,0,0,0,0,12
2476,p1806,20170905,5662,5662,0,0,0,5662,5662,0,0,0,0,12
2477,p1806,20170906,5662,5662,0,0,0,5662,5662,0,0,0,0,12
2478,p1806,20170907,5662,5662,5650,5650,5650,5650,5650,-12,-12,2,113000,10
2479,p1806,20170908,5650,5650,0,0,0,5650,5650,0,0,0,0,10
2480,p1806,20170911,5650,5650,5666,5744,5616,5744,5668,94,18,10,566840,12
2481,p1806,20170912,5744,5668,0,0,0,5688,5688,20,20,0,0,12
2482,p1806,20170913,5688,5688,5688,5696,5688,5696,5692,8,4,4,227680,12
2483,p1806,20170914,5696,5692,0,0,0,5760,5760,68,68,0,0,12
2484,p1806,20170915,5760,5760,0,0,0,5760,5760,0,0,0,0,12
2485,p1806,20170918,5760,5760,0,0,0,5760,5760,0,0,0,0,12
2486,p1806,20170919,5760,5760,0,0,0,5760,5760,0,0,0,0,12
2487,p1806,20170920,5760,5760,0,0,0,5760,5760,0,0,0,0,12
2488,p1806,20170921,5760,5760,0,0,0,5760,5760,0,0,0,0,12
2489,p1806,20170922,5760,5760,5720,5720,5720,5720,5720,-40,-40,2,114400,12
2490,p1806,20170925,5720,5720,5598,5598,5598,5598,5598,-122,-122,2,111960,10
2491,p1806,20170926,5598,5598,0,0,0,5598,5598,0,0,0,0,10
2492,p1806,20170927,5598,5598,0,0,0,5598,5598,0,0,0,0,10
2493,p1806,20170928,5598,5598,5528,5528,5528,5528,5528,-70,-70,4,221120,6
2494,p1806,20170929,5528,5528,0,0,0,5528,5528,0,0,0,0,6
2495,p1806,20171009,5528,5528,0,0,0,5562,5562,34,34,0,0,6
2496,p1806,20171010,5562,5562,0,0,0,5562,5562,0,0,0,0,6
2497,p1806,20171011,5562,5562,0,0,0,5562,5562,0,0,0,0,6
2498,p1806,20171012,5562,5562,0,0,0,5562,5562,0,0,0,0,6
2499,p1806,20171013,5562,5562,0,0,0,5562,5562,0,0,0,0,6
2500,p1806,20171016,5562,5562,0,0,0,5562,5562,0,0,0,0,6
2501,p1806,20171017,5562,5562,0,0,0,5572,5572,10,10,0,0,6
2502,p1806,20171018,5572,5572,0,0,0,5572,5572,0,0,0,0,6
2503,p1806,20171019,5572,5572,5576,5576,5576,5576,5576,4,4,4,223040,8
2504,p1806,20171020,5576,5576,0,0,0,5576,5576,0,0,0,0,8
2505,p1806,20171023,5576,5576,0,0,0,5650,5650,74,74,0,0,8
2506,p1806,20171024,5650,5650,0,0,0,5650,5650,0,0,0,0,8
2507,p1806,20171025,5650,5650,0,0,0,5650,5650,0,0,0,0,8
2508,p1806,20171026,5650,5650,0,0,0,5650,5650,0,0,0,0,8
2509,p1806,20171027,5650,5650,0,0,0,5672,5672,22,22,0,0,8
2510,p1806,20171030,5672,5672,0,0,0,5706,5706,34,34,0,0,8
2511,p1806,20171031,5706,5706,0,0,0,5706,5706,0,0,0,0,8
2512,p1806,20171101,5706,5706,0,0,0,5706,5706,0,0,0,0,8
2513,p1806,20171102,5706,5706,5846,5846,5792,5792,5818,86,112,4,232760,10
2514,p1806,20171103,5792,5818,5780,5780,5780,5780,5780,-38,-38,2,115600,8
2515,p1806,20171106,5780,5780,0,0,0,5780,5780,0,0,0,0,8
2516,p1806,20171107,5780,5780,0,0,0,5780,5780,0,0,0,0,8
2517,p1806,20171108,5780,5780,0,0,0,5780,5780,0,0,0,0,8
2518,p1806,20171109,5780,5780,0,0,0,5780,5780,0,0,0,0,8
2519,p1806,20171110,5780,5780,0,0,0,5780,5780,0,0,0,0,8
2520,p1806,20171113,5780,5780,0,0,0,5780,5780,0,0,0,0,8
2521,p1806,20171114,5780,5780,0,0,0,5732,5732,-48,-48,0,0,8
2522,p1806,20171115,5732,5732,0,0,0,5732,5732,0,0,0,0,8
2523,p1806,20171116,5732,5732,5572,5620,5572,5620,5596,-112,-136,4,223840,10
2524,p1806,20171117,5620,5596,0,0,0,5596,5596,0,0,0,0,10
2525,p1806,20171120,5596,5596,0,0,0,5596,5596,0,0,0,0,10
2526,p1806,20171121,5596,5596,0,0,0,5558,5558,-38,-38,0,0,10
2527,p1806,20171122,5558,5558,0,0,0,5558,5558,0,0,0,0,10
2528,p1806,20171123,5558,5558,0,0,0,5558,5558,0,0,0,0,10
2529,p1806,20171124,5558,5558,0,0,0,5558,5558,0,0,0,0,10
2530,p1806,20171127,5558,5558,0,0,0,5558,5558,0,0,0,0,10
2531,p1806,20171128,5558,5558,0,0,0,5558,5558,0,0,0,0,10
2532,p1806,20171129,5558,5558,5446,5446,5446,5446,5446,-112,-112,2,108920,10
2533,p1806,20171130,5446,5446,0,0,0,5446,5446,0,0,0,0,10
2534,p1806,20171201,5446,5446,0,0,0,5446,5446,0,0,0,0,10
2535,p1806,20171204,5446,5446,0,0,0,5500,5500,54,54,0,0,10
2536,p1806,20171205,5500,5500,0,0,0,5500,5500,0,0,0,0,10
2537,p1806,20171206,5500,5500,0,0,0,5478,5478,-22,-22,0,0,10
2538,p1806,20171207,5478,5478,0,0,0,5410,5410,-68,-68,0,0,10
2539,p1806,20171208,5410,5410,0,0,0,5406,5406,-4,-4,0,0,10
2540,p1806,20171211,5406,5406,0,0,0,5406,5406,0,0,0,0,10
2541,p1806,20171212,5406,5406,0,0,0,5416,5416,10,10,0,0,10
2542,p1806,20171213,5416,5416,5388,5388,5348,5348,5368,-68,-48,4,214720,10
2543,p1806,20171214,5348,5368,5320,5320,5242,5242,5280,-126,-88,4,211240,12
2544,p1806,20171215,5242,5280,5300,5330,5294,5330,5318,50,38,12,638280,18
2545,p1806,20171218,5330,5318,5356,5356,5302,5340,5330,22,12,14,746240,10
2546,p1806,20171219,5340,5330,0,0,0,5330,5330,0,0,0,0,10
2547,p1806,20171220,5330,5330,5300,5300,5300,5300,5300,-30,-30,2,106000,12
2548,p1806,20171221,5300,5300,5288,5316,5288,5316,5306,16,6,6,318360,10
2549,p1806,20171222,5316,5306,0,0,0,5306,5306,0,0,0,0,10
2550,p1806,20171225,5306,5306,0,0,0,5306,5306,0,0,0,0,10
2551,p1806,20171226,5306,5306,0,0,0,5306,5306,0,0,0,0,10
2552,p1806,20171227,5306,5306,0,0,0,5306,5306,0,0,0,0,10
2553,p1806,20171228,5306,5306,0,0,0,5306,5306,0,0,0,0,10
2554,p1806,20171229,5306,5306,0,0,0,5306,5306,0,0,0,0,10
2555,p1807,20170717,5544,5544,5430,5524,5430,5524,5476,-20,-68,4,219080,2
2556,p1807,20170718,5524,5476,0,0,0,5476,5476,0,0,0,0,2
2557,p1807,20170719,5476,5476,0,0,0,5476,5476,0,0,0,0,2
2558,p1807,20170720,5476,5476,0,0,0,5438,5438,-38,-38,0,0,2
2559,p1807,20170721,5438,5438,5522,5522,5520,5520,5520,82,82,4,220840,2
2560,p1807,20170724,5520,5520,0,0,0,5520,5520,0,0,0,0,2
2561,p1807,20170725,5520,5520,0,0,0,5520,5520,0,0,0,0,2
2562,p1807,20170726,5520,5520,0,0,0,5520,5520,0,0,0,0,2
2563,p1807,20170727,5520,5520,0,0,0,5570,5570,50,50,0,0,2
2564,p1807,20170728,5570,5570,0,0,0,5570,5570,0,0,0,0,2
2565,p1807,20170731,5570,5570,0,0,0,5570,5570,0,0,0,0,2
2566,p1807,20170801,5570,5570,0,0,0,5570,5570,0,0,0,0,2
2567,p1807,20170802,5570,5570,0,0,0,5570,5570,0,0,0,0,2
2568,p1807,20170803,5570,5570,0,0,0,5570,5570,0,0,0,0,2
2569,p1807,20170804,5570,5570,0,0,0,5570,5570,0,0,0,0,2
2570,p1807,20170807,5570,5570,0,0,0,5570,5570,0,0,0,0,2
2571,p1807,20170808,5570,5570,0,0,0,5570,5570,0,0,0,0,2
2572,p1807,20170809,5570,5570,5630,5634,5630,5634,5632,64,62,4,225280,6
2573,p1807,20170810,5634,5632,5598,5626,5556,5626,5612,-6,-20,14,785680,16
2574,p1807,20170811,5626,5612,5684,5684,5582,5582,5602,-30,-10,12,672360,6
2575,p1807,20170814,5582,5602,0,0,0,5602,5602,0,0,0,0,6
2576,p1807,20170815,5602,5602,0,0,0,5602,5602,0,0,0,0,6
2577,p1807,20170816,5602,5602,0,0,0,5602,5602,0,0,0,0,6
2578,p1807,20170817,5602,5602,5604,5604,5604,5604,5604,2,2,4,224160,10
2579,p1807,20170818,5604,5604,5580,5580,5580,5580,5580,-24,-24,4,223200,8
2580,p1807,20170821,5580,5580,0,0,0,5580,5580,0,0,0,0,8
2581,p1807,20170822,5580,5580,5730,5730,5730,5730,5730,150,150,2,114600,6
2582,p1807,20170823,5730,5730,0,0,0,5730,5730,0,0,0,0,6
2583,p1807,20170824,5730,5730,0,0,0,5730,5730,0,0,0,0,6
2584,p1807,20170825,5730,5730,0,0,0,5730,5730,0,0,0,0,6
2585,p1807,20170828,5730,5730,0,0,0,5730,5730,0,0,0,0,6
2586,p1807,20170829,5730,5730,0,0,0,5730,5730,0,0,0,0,6
2587,p1807,20170830,5730,5730,0,0,0,5710,5710,-20,-20,0,0,6
2588,p1807,20170831,5710,5710,0,0,0,5686,5686,-24,-24,0,0,6
2589,p1807,20170901,5686,5686,0,0,0,5686,5686,0,0,0,0,6
2590,p1807,20170904,5686,5686,0,0,0,5686,5686,0,0,0,0,6
2591,p1807,20170905,5686,5686,0,0,0,5686,5686,0,0,0,0,6
2592,p1807,20170906,5686,5686,0,0,0,5686,5686,0,0,0,0,6
2593,p1807,20170907,5686,5686,0,0,0,5686,5686,0,0,0,0,6
2594,p1807,20170908,5686,5686,0,0,0,5686,5686,0,0,0,0,6
2595,p1807,20170911,5686,5686,0,0,0,5686,5686,0,0,0,0,6
2596,p1807,20170912,5686,5686,0,0,0,5686,5686,0,0,0,0,6
2597,p1807,20170913,5686,5686,0,0,0,5686,5686,0,0,0,0,6
2598,p1807,20170914,5686,5686,0,0,0,5718,5718,32,32,0,0,6
2599,p1807,20170915,5718,5718,0,0,0,5712,5712,-6,-6,0,0,6
2600,p1807,20170918,5712,5712,0,0,0,5712,5712,0,0,0,0,6
2601,p1807,20170919,5712,5712,0,0,0,5726,5726,14,14,0,0,6
2602,p1807,20170920,5726,5726,0,0,0,5726,5726,0,0,0,0,6
2603,p1807,20170921,5726,5726,0,0,0,5726,5726,0,0,0,0,6
2604,p1807,20170922,5726,5726,5606,5740,5606,5740,5672,14,-54,4,226920,6
2605,p1807,20170925,5740,5672,0,0,0,5672,5672,0,0,0,0,6
2606,p1807,20170926,5672,5672,0,0,0,5672,5672,0,0,0,0,6
2607,p1807,20170927,5672,5672,0,0,0,5672,5672,0,0,0,0,6
2608,p1807,20170928,5672,5672,5572,5572,5572,5572,5572,-100,-100,2,111440,4
2609,p1807,20170929,5572,5572,5496,5612,5496,5612,5554,40,-18,4,222160,4
2610,p1807,20171009,5612,5554,0,0,0,5616,5616,62,62,0,0,4
2611,p1807,20171010,5616,5616,5592,5592,5592,5592,5592,-24,-24,2,111840,4
2612,p1807,20171011,5592,5592,5496,5586,5496,5586,5540,-6,-52,4,221640,4
2613,p1807,20171012,5586,5540,0,0,0,5562,5562,22,22,0,0,4
2614,p1807,20171013,5562,5562,0,0,0,5542,5542,-20,-20,0,0,4
2615,p1807,20171016,5542,5542,0,0,0,5612,5612,70,70,0,0,4
2616,p1807,20171017,5612,5612,0,0,0,5612,5612,0,0,0,0,4
2617,p1807,20171018,5612,5612,0,0,0,5612,5612,0,0,0,0,4
2618,p1807,20171019,5612,5612,0,0,0,5612,5612,0,0,0,0,4
2619,p1807,20171020,5612,5612,0,0,0,5612,5612,0,0,0,0,4
2620,p1807,20171023,5612,5612,5622,5692,5602,5602,5638,-10,26,12,676640,2
2621,p1807,20171024,5602,5638,0,0,0,5638,5638,0,0,0,0,2
2622,p1807,20171025,5638,5638,0,0,0,5664,5664,26,26,0,0,2
2623,p1807,20171026,5664,5664,0,0,0,5664,5664,0,0,0,0,2
2624,p1807,20171027,5664,5664,0,0,0,5674,5674,10,10,0,0,2
2625,p1807,20171030,5674,5674,0,0,0,5708,5708,34,34,0,0,2
2626,p1807,20171031,5708,5708,0,0,0,5720,5720,12,12,0,0,2
2627,p1807,20171101,5720,5720,5794,5794,5660,5660,5726,-60,6,4,229080,4
2628,p1807,20171102,5660,5726,0,0,0,5726,5726,0,0,0,0,4
2629,p1807,20171103,5726,5726,0,0,0,5726,5726,0,0,0,0,4
2630,p1807,20171106,5726,5726,0,0,0,5726,5726,0,0,0,0,4
2631,p1807,20171107,5726,5726,0,0,0,5726,5726,0,0,0,0,4
2632,p1807,20171108,5726,5726,5750,5750,5750,5750,5750,24,24,2,115000,4
2633,p1807,20171109,5750,5750,0,0,0,5750,5750,0,0,0,0,4
2634,p1807,20171110,5750,5750,0,0,0,5750,5750,0,0,0,0,4
2635,p1807,20171113,5750,5750,0,0,0,5750,5750,0,0,0,0,4
2636,p1807,20171114,5750,5750,0,0,0,5750,5750,0,0,0,0,4
2637,p1807,20171115,5750,5750,0,0,0,5692,5692,-58,-58,0,0,4
2638,p1807,20171116,5692,5692,0,0,0,5692,5692,0,0,0,0,4
2639,p1807,20171117,5692,5692,0,0,0,5692,5692,0,0,0,0,4
2640,p1807,20171120,5692,5692,0,0,0,5634,5634,-58,-58,0,0,4
2641,p1807,20171121,5634,5634,0,0,0,5596,5596,-38,-38,0,0,4
2642,p1807,20171122,5596,5596,0,0,0,5602,5602,6,6,0,0,4
2643,p1807,20171123,5602,5602,0,0,0,5602,5602,0,0,0,0,4
2644,p1807,20171124,5602,5602,0,0,0,5592,5592,-10,-10,0,0,4
2645,p1807,20171127,5592,5592,0,0,0,5592,5592,0,0,0,0,4
2646,p1807,20171128,5592,5592,5528,5528,5528,5528,5528,-64,-64,2,110560,2
2647,p1807,20171129,5528,5528,0,0,0,5528,5528,0,0,0,0,2
2648,p1807,20171130,5528,5528,0,0,0,5528,5528,0,0,0,0,2
2649,p1807,20171201,5528,5528,0,0,0,5528,5528,0,0,0,0,2
2650,p1807,20171204,5528,5528,0,0,0,5528,5528,0,0,0,0,2
2651,p1807,20171205,5528,5528,0,0,0,5528,5528,0,0,0,0,2
2652,p1807,20171206,5528,5528,0,0,0,5528,5528,0,0,0,0,2
2653,p1807,20171207,5528,5528,0,0,0,5460,5460,-68,-68,0,0,2
2654,p1807,20171208,5460,5460,0,0,0,5460,5460,0,0,0,0,2
2655,p1807,20171211,5460,5460,0,0,0,5460,5460,0,0,0,0,2
2656,p1807,20171212,5460,5460,0,0,0,5460,5460,0,0,0,0,2
2657,p1807,20171213,5460,5460,0,0,0,5460,5460,0,0,0,0,2
2658,p1807,20171214,5460,5460,0,0,0,5372,5372,-88,-88,0,0,2
2659,p1807,20171215,5372,5372,0,0,0,5372,5372,0,0,0,0,2
2660,p1807,20171218,5372,5372,5326,5326,5326,5326,5326,-46,-46,2,106520,2
2661,p1807,20171219,5326,5326,0,0,0,5326,5326,0,0,0,0,2
2662,p1807,20171220,5326,5326,0,0,0,5326,5326,0,0,0,0,2
2663,p1807,20171221,5326,5326,0,0,0,5326,5326,0,0,0,0,2
2664,p1807,20171222,5326,5326,5210,5210,5210,5210,5210,-116,-116,2,104200,0
2665,p1807,20171225,5210,5210,0,0,0,5210,5210,0,0,0,0,0
2666,p1807,20171226,5210,5210,0,0,0,5210,5210,0,0,0,0,0
2667,p1807,20171227,5210,5210,0,0,0,5230,5230,20,20,0,0,0
2668,p1807,20171228,5230,5230,0,0,0,5230,5230,0,0,0,0,0
2669,p1807,20171229,5230,5230,0,0,0,5230,5230,0,0,0,0,0
2670,p1808,20170815,5602,5602,5510,5510,5510,5510,5510,-92,-92,30,1653000,30
2671,p1808,20170816,5510,5510,5564,5598,5564,5598,5576,88,66,30,1673280,0
2672,p1808,20170817,5598,5576,0,0,0,5576,5576,0,0,0,0,0
2673,p1808,20170818,5576,5576,5630,5630,5630,5630,5630,54,54,2,112600,2
2674,p1808,20170821,5630,5630,0,0,0,5630,5630,0,0,0,0,2
2675,p1808,20170822,5630,5630,0,0,0,5780,5780,150,150,0,0,2
2676,p1808,20170823,5780,5780,5714,5714,5714,5714,5714,-66,-66,2,114280,2
2677,p1808,20170824,5714,5714,0,0,0,5718,5718,4,4,0,0,2
2678,p1808,20170825,5718,5718,0,0,0,5718,5718,0,0,0,0,2
2679,p1808,20170828,5718,5718,0,0,0,5718,5718,0,0,0,0,2
2680,p1808,20170829,5718,5718,0,0,0,5676,5676,-42,-42,0,0,2
2681,p1808,20170830,5676,5676,0,0,0,5656,5656,-20,-20,0,0,2
2682,p1808,20170831,5656,5656,0,0,0,5656,5656,0,0,0,0,2
2683,p1808,20170901,5656,5656,0,0,0,5694,5694,38,38,0,0,2
2684,p1808,20170904,5694,5694,0,0,0,5694,5694,0,0,0,0,2
2685,p1808,20170905,5694,5694,0,0,0,5672,5672,-22,-22,0,0,2
2686,p1808,20170906,5672,5672,0,0,0,5704,5704,32,32,0,0,2
2687,p1808,20170907,5704,5704,0,0,0,5704,5704,0,0,0,0,2
2688,p1808,20170908,5704,5704,0,0,0,5704,5704,0,0,0,0,2
2689,p1808,20170911,5704,5704,0,0,0,5722,5722,18,18,0,0,2
2690,p1808,20170912,5722,5722,0,0,0,5784,5784,62,62,0,0,2
2691,p1808,20170913,5784,5784,0,0,0,5784,5784,0,0,0,0,2
2692,p1808,20170914,5784,5784,0,0,0,5816,5816,32,32,0,0,2
2693,p1808,20170915,5816,5816,0,0,0,5810,5810,-6,-6,0,0,2
2694,p1808,20170918,5810,5810,0,0,0,5784,5784,-26,-26,0,0,2
2695,p1808,20170919,5784,5784,0,0,0,5798,5798,14,14,0,0,2
2696,p1808,20170920,5798,5798,0,0,0,5798,5798,0,0,0,0,2
2697,p1808,20170921,5798,5798,0,0,0,5798,5798,0,0,0,0,2
2698,p1808,20170922,5798,5798,0,0,0,5744,5744,-54,-54,0,0,2
2699,p1808,20170925,5744,5744,0,0,0,5712,5712,-32,-32,0,0,2
2700,p1808,20170926,5712,5712,0,0,0,5694,5694,-18,-18,0,0,2
2701,p1808,20170927,5694,5694,0,0,0,5694,5694,0,0,0,0,2
2702,p1808,20170928,5694,5694,0,0,0,5594,5594,-100,-100,0,0,2
2703,p1808,20170929,5594,5594,0,0,0,5594,5594,0,0,0,0,2
2704,p1808,20171009,5594,5594,0,0,0,5656,5656,62,62,0,0,2
2705,p1808,20171010,5656,5656,0,0,0,5632,5632,-24,-24,0,0,2
2706,p1808,20171011,5632,5632,0,0,0,5580,5580,-52,-52,0,0,2
2707,p1808,20171012,5580,5580,0,0,0,5602,5602,22,22,0,0,2
2708,p1808,20171013,5602,5602,0,0,0,5582,5582,-20,-20,0,0,2
2709,p1808,20171016,5582,5582,0,0,0,5652,5652,70,70,0,0,2
2710,p1808,20171017,5652,5652,0,0,0,5668,5668,16,16,0,0,2
2711,p1808,20171018,5668,5668,0,0,0,5636,5636,-32,-32,0,0,2
2712,p1808,20171019,5636,5636,0,0,0,5640,5640,4,4,0,0,2
2713,p1808,20171020,5640,5640,0,0,0,5640,5640,0,0,0,0,2
2714,p1808,20171023,5640,5640,0,0,0,5666,5666,26,26,0,0,2
2715,p1808,20171024,5666,5666,0,0,0,5734,5734,68,68,0,0,2
2716,p1808,20171025,5734,5734,0,0,0,5734,5734,0,0,0,0,2
2717,p1808,20171026,5734,5734,0,0,0,5734,5734,0,0,0,0,2
2718,p1808,20171027,5734,5734,0,0,0,5734,5734,0,0,0,0,2
2719,p1808,20171030,5734,5734,0,0,0,5734,5734,0,0,0,0,2
2720,p1808,20171031,5734,5734,0,0,0,5734,5734,0,0,0,0,2
2721,p1808,20171101,5734,5734,0,0,0,5734,5734,0,0,0,0,2
2722,p1808,20171102,5734,5734,0,0,0,5734,5734,0,0,0,0,2
2723,p1808,20171103,5734,5734,0,0,0,5698,5698,-36,-36,0,0,2
2724,p1808,20171106,5698,5698,0,0,0,5698,5698,0,0,0,0,2
2725,p1808,20171107,5698,5698,0,0,0,5698,5698,0,0,0,0,2
2726,p1808,20171108,5698,5698,0,0,0,5698,5698,0,0,0,0,2
2727,p1808,20171109,5698,5698,0,0,0,5698,5698,0,0,0,0,2
2728,p1808,20171110,5698,5698,0,0,0,5698,5698,0,0,0,0,2
2729,p1808,20171113,5698,5698,0,0,0,5698,5698,0,0,0,0,2
2730,p1808,20171114,5698,5698,0,0,0,5634,5634,-64,-64,0,0,2
2731,p1808,20171115,5634,5634,0,0,0,5634,5634,0,0,0,0,2
2732,p1808,20171116,5634,5634,0,0,0,5502,5502,-132,-132,0,0,2
2733,p1808,20171117,5502,5502,0,0,0,5504,5504,2,2,0,0,2
2734,p1808,20171120,5504,5504,0,0,0,5504,5504,0,0,0,0,2
2735,p1808,20171121,5504,5504,0,0,0,5504,5504,0,0,0,0,2
2736,p1808,20171122,5504,5504,0,0,0,5504,5504,0,0,0,0,2
2737,p1808,20171123,5504,5504,0,0,0,5504,5504,0,0,0,0,2
2738,p1808,20171124,5504,5504,0,0,0,5504,5504,0,0,0,0,2
2739,p1808,20171127,5504,5504,0,0,0,5450,5450,-54,-54,0,0,2
2740,p1808,20171128,5450,5450,0,0,0,5450,5450,0,0,0,0,2
2741,p1808,20171129,5450,5450,0,0,0,5342,5342,-108,-108,0,0,2
2742,p1808,20171130,5342,5342,0,0,0,5344,5344,2,2,0,0,2
2743,p1808,20171201,5344,5344,0,0,0,5362,5362,18,18,0,0,2
2744,p1808,20171204,5362,5362,0,0,0,5392,5392,30,30,0,0,2
2745,p1808,20171205,5392,5392,0,0,0,5392,5392,0,0,0,0,2
2746,p1808,20171206,5392,5392,0,0,0,5392,5392,0,0,0,0,2
2747,p1808,20171207,5392,5392,0,0,0,5326,5326,-66,-66,0,0,2
2748,p1808,20171208,5326,5326,0,0,0,5326,5326,0,0,0,0,2
2749,p1808,20171211,5326,5326,0,0,0,5326,5326,0,0,0,0,2
2750,p1808,20171212,5326,5326,0,0,0,5326,5326,0,0,0,0,2
2751,p1808,20171213,5326,5326,0,0,0,5326,5326,0,0,0,0,2
2752,p1808,20171214,5326,5326,0,0,0,5240,5240,-86,-86,0,0,2
2753,p1808,20171215,5240,5240,0,0,0,5240,5240,0,0,0,0,2
2754,p1808,20171218,5240,5240,0,0,0,5196,5196,-44,-44,0,0,2
2755,p1808,20171219,5196,5196,0,0,0,5172,5172,-24,-24,0,0,2
2756,p1808,20171220,5172,5172,0,0,0,5144,5144,-28,-28,0,0,2
2757,p1808,20171221,5144,5144,0,0,0,5148,5148,4,4,0,0,2
2758,p1808,20171222,5148,5148,0,0,0,5148,5148,0,0,0,0,2
2759,p1808,20171225,5148,5148,0,0,0,5178,5178,30,30,0,0,2
2760,p1808,20171226,5178,5178,0,0,0,5178,5178,0,0,0,0,2
2761,p1808,20171227,5178,5178,0,0,0,5226,5226,48,48,0,0,2
2762,p1808,20171228,5226,5226,0,0,0,5246,5246,20,20,0,0,2
2763,p1808,20171229,5246,5246,0,0,0,5246,5246,0,0,0,0,2
2764,p1809,20170915,5816,5816,5688,5696,5634,5664,5668,-152,-148,782,44327160,724
2765,p1809,20170918,5664,5668,5600,5686,5600,5618,5624,-50,-44,312,17549800,834
2766,p1809,20170919,5618,5624,5600,5670,5600,5666,5650,42,26,346,19551760,840
2767,p1809,20170920,5666,5650,5666,5666,5610,5640,5642,-10,-8,314,17720440,946
2768,p1809,20170921,5640,5642,5652,5678,5602,5602,5648,-40,6,964,54465520,1576
2769,p1809,20170922,5602,5648,5588,5612,5570,5584,5592,-64,-56,400,22375600,1754
2770,p1809,20170925,5584,5592,5594,5616,5524,5530,5554,-62,-38,516,28660000,2080
2771,p1809,20170926,5530,5554,5530,5554,5530,5536,5544,-18,-10,646,35818760,2184
2772,p1809,20170927,5536,5544,5576,5576,5502,5542,5544,-2,0,574,31827920,2316
2773,p1809,20170928,5542,5544,5522,5526,5396,5428,5448,-116,-96,992,54057120,2628
2774,p1809,20170929,5428,5448,5452,5460,5424,5448,5444,0,-4,384,20910960,2742
2775,p1809,20171009,5448,5444,5500,5524,5480,5490,5498,46,54,200,10996480,2740
2776,p1809,20171010,5490,5498,5502,5502,5454,5460,5470,-38,-28,492,26914520,2798
2777,p1809,20171011,5460,5470,5440,5460,5426,5426,5444,-44,-26,668,36367480,3074
2778,p1809,20171012,5426,5444,5430,5482,5430,5466,5460,22,16,682,37246600,3234
2779,p1809,20171013,5466,5460,5478,5480,5408,5472,5446,12,-14,1092,59473600,3720
2780,p1809,20171016,5472,5446,5518,5524,5484,5512,5504,66,58,774,42604200,4036
2781,p1809,20171017,5512,5504,5542,5560,5500,5524,5524,20,20,562,31056000,4222
2782,p1809,20171018,5524,5524,5506,5520,5458,5500,5486,-24,-38,2056,112832960,5692
2783,p1809,20171019,5500,5486,5490,5524,5434,5434,5488,-52,2,866,47536680,5992
2784,p1809,20171020,5434,5488,5438,5530,5438,5520,5498,32,10,2454,134940800,7410
2785,p1809,20171023,5520,5498,5546,5562,5498,5560,5530,62,32,2484,137405880,8608
2786,p1809,20171024,5560,5530,5582,5614,5558,5600,5598,70,68,1870,104687320,8420
2787,p1809,20171025,5600,5598,5594,5660,5580,5610,5606,12,8,3438,192763480,9206
2788,p1809,20171026,5610,5606,5626,5634,5596,5620,5612,14,6,2326,130562840,10120
2789,p1809,20171027,5620,5612,5624,5650,5600,5624,5628,12,16,1892,106517440,10630
2790,p1809,20171030,5624,5628,5620,5694,5590,5670,5658,42,30,1646,93158280,11058
2791,p1809,20171031,5670,5658,5670,5676,5640,5658,5654,0,-4,1124,63561040,11146
2792,p1809,20171101,5658,5654,5652,5678,5626,5632,5652,-22,-2,1596,90228280,11778
2793,p1809,20171102,5632,5652,5652,5672,5638,5642,5656,-10,4,2332,131920720,12420
2794,p1809,20171103,5642,5656,5628,5638,5602,5626,5620,-30,-36,2252,126583040,12892
2795,p1809,20171106,5626,5620,5628,5652,5580,5632,5606,12,-14,4566,256022680,15844
2796,p1809,20171107,5632,5606,5632,5660,5622,5648,5644,42,38,3278,185018840,15930
2797,p1809,20171108,5648,5644,5658,5664,5624,5648,5650,4,6,6552,370302040,19882
2798,p1809,20171109,5648,5650,5670,5724,5670,5714,5698,64,48,4402,250878480,19862
2799,p1809,20171110,5714,5698,5702,5722,5646,5646,5686,-52,-12,6624,376743240,21546
2800,p1809,20171113,5646,5686,5666,5672,5640,5662,5654,-24,-32,2188,123725960,22254
2801,p1809,20171114,5662,5654,5638,5640,5572,5596,5598,-58,-56,3696,206933920,23068
2802,p1809,20171115,5596,5598,5578,5586,5502,5510,5542,-88,-56,6534,362213520,24338
2803,p1809,20171116,5510,5542,5510,5560,5478,5536,5528,-6,-14,3570,197362720,24910
2804,p1809,20171117,5536,5528,5536,5548,5498,5500,5520,-28,-8,3000,165635320,25928
2805,p1809,20171120,5500,5520,5502,5518,5444,5466,5470,-54,-50,5446,297930440,27050
2806,p1809,20171121,5466,5470,5440,5480,5420,5440,5456,-30,-14,11786,643205480,34508
2807,p1809,20171122,5440,5456,5450,5488,5446,5460,5466,4,10,7112,388858000,36104
2808,p1809,20171123,5460,5466,5478,5494,5448,5466,5472,0,6,8564,468724560,38114
2809,p1809,20171124,5466,5472,5452,5504,5450,5482,5484,10,12,8876,486793800,37600
2810,p1809,20171127,5482,5484,5490,5494,5392,5398,5424,-86,-60,11342,615385120,38450
2811,p1809,20171128,5398,5424,5394,5418,5394,5412,5404,-12,-20,5150,278406960,37880
2812,p1809,20171129,5412,5404,5404,5420,5382,5384,5398,-20,-6,7024,379280360,38362
2813,p1809,20171130,5384,5398,5382,5452,5370,5408,5410,10,12,9354,506161920,38298
2814,p1809,20171201,5408,5410,5420,5460,5410,5454,5436,44,26,11194,608508800,37702
2815,p1809,20171204,5454,5436,5442,5496,5438,5482,5470,46,34,7930,433809920,38490
2816,p1809,20171205,5482,5470,5460,5476,5366,5384,5418,-86,-52,7572,410306280,40238
2817,p1809,20171206,5384,5418,5378,5426,5378,5408,5406,-10,-12,10490,567185840,42348
2818,p1809,20171207,5408,5406,5392,5392,5302,5328,5340,-78,-66,14754,788008200,46888
2819,p1809,20171208,5328,5340,5328,5358,5306,5338,5334,-2,-6,5626,300171080,48222
2820,p1809,20171211,5338,5334,5344,5360,5316,5330,5336,-4,2,5698,304115600,48256
2821,p1809,20171212,5330,5336,5328,5370,5310,5342,5348,6,12,9124,488119760,46976
2822,p1809,20171213,5342,5348,5338,5360,5326,5344,5344,-4,-4,13172,704033000,49680
2823,p1809,20171214,5344,5344,5338,5348,5252,5268,5302,-76,-42,16102,853792840,54744
2824,p1809,20171215,5268,5302,5276,5292,5262,5278,5282,-24,-20,14710,776997320,53620
2825,p1809,20171218,5278,5282,5306,5342,5306,5332,5320,50,38,10100,537518040,52184
2826,p1809,20171219,5332,5320,5322,5328,5282,5298,5300,-22,-20,7416,393061040,53196
2827,p1809,20171220,5298,5300,5306,5336,5298,5310,5316,10,16,10790,573643920,54456
2828,p1809,20171221,5310,5316,5300,5310,5226,5236,5258,-80,-58,13016,684432280,54370
2829,p1809,20171222,5236,5258,5222,5228,5186,5214,5208,-44,-50,16862,878424000,53694
2830,p1809,20171225,5214,5208,5226,5256,5212,5242,5236,34,28,8188,428748680,53412
2831,p1809,20171226,5242,5236,5236,5254,5218,5236,5234,0,-2,8232,430875200,54110
2832,p1809,20171227,5236,5234,5260,5302,5252,5286,5280,52,46,12198,644065080,54448
2833,p1809,20171228,5286,5280,5296,5310,5268,5284,5288,4,8,12858,680074880,53610
2834,p1809,20171229,5284,5288,5276,5288,5250,5256,5268,-32,-20,13312,701325400,56934
2835,p1810,20171023,5498,5498,0,0,0,5498,5498,0,0,0,0,0
2836,p1810,20171024,5498,5498,0,0,0,5498,5498,0,0,0,0,0
2837,p1810,20171025,5498,5498,0,0,0,5504,5504,6,6,0,0,0
2838,p1810,20171026,5504,5504,0,0,0,5508,5508,4,4,0,0,0
2839,p1810,20171027,5508,5508,0,0,0,5522,5522,14,14,0,0,0
2840,p1810,20171030,5522,5522,0,0,0,5522,5522,0,0,0,0,0
2841,p1810,20171031,5522,5522,5650,5650,5650,5650,5650,128,128,2,113000,2
2842,p1810,20171101,5650,5650,5620,5620,5620,5620,5620,-30,-30,2,112400,0
2843,p1810,20171102,5620,5620,0,0,0,5620,5620,0,0,0,0,0
2844,p1810,20171103,5620,5620,0,0,0,5620,5620,0,0,0,0,0
2845,p1810,20171106,5620,5620,0,0,0,5620,5620,0,0,0,0,0
2846,p1810,20171107,5620,5620,0,0,0,5620,5620,0,0,0,0,0
2847,p1810,20171108,5620,5620,0,0,0,5620,5620,0,0,0,0,0
2848,p1810,20171109,5620,5620,0,0,0,5666,5666,46,46,0,0,0
2849,p1810,20171110,5666,5666,0,0,0,5666,5666,0,0,0,0,0
2850,p1810,20171113,5666,5666,0,0,0,5666,5666,0,0,0,0,0
2851,p1810,20171114,5666,5666,0,0,0,5610,5610,-56,-56,0,0,0
2852,p1810,20171115,5610,5610,5500,5550,5500,5550,5524,-60,-86,20,1105000,0
2853,p1810,20171116,5550,5524,0,0,0,5524,5524,0,0,0,0,0
2854,p1810,20171117,5524,5524,0,0,0,5524,5524,0,0,0,0,0
2855,p1810,20171120,5524,5524,0,0,0,5474,5474,-50,-50,0,0,0
2856,p1810,20171121,5474,5474,0,0,0,5474,5474,0,0,0,0,0
2857,p1810,20171122,5474,5474,0,0,0,5474,5474,0,0,0,0,0
2858,p1810,20171123,5474,5474,0,0,0,5474,5474,0,0,0,0,0
2859,p1810,20171124,5474,5474,0,0,0,5474,5474,0,0,0,0,0
2860,p1810,20171127,5474,5474,0,0,0,5416,5416,-58,-58,0,0,0
2861,p1810,20171128,5416,5416,0,0,0,5416,5416,0,0,0,0,0
2862,p1810,20171129,5416,5416,0,0,0,5416,5416,0,0,0,0,0
2863,p1810,20171130,5416,5416,0,0,0,5416,5416,0,0,0,0,0
2864,p1810,20171201,5416,5416,0,0,0,5416,5416,0,0,0,0,0
2865,p1810,20171204,5416,5416,0,0,0,5448,5448,32,32,0,0,0
2866,p1810,20171205,5448,5448,0,0,0,5398,5398,-50,-50,0,0,0
2867,p1810,20171206,5398,5398,0,0,0,5398,5398,0,0,0,0,0
2868,p1810,20171207,5398,5398,0,0,0,5334,5334,-64,-64,0,0,0
2869,p1810,20171208,5334,5334,0,0,0,5334,5334,0,0,0,0,0
2870,p1810,20171211,5334,5334,0,0,0,5334,5334,0,0,0,0,0
2871,p1810,20171212,5334,5334,0,0,0,5334,5334,0,0,0,0,0
2872,p1810,20171213,5334,5334,0,0,0,5334,5334,0,0,0,0,0
2873,p1810,20171214,5334,5334,0,0,0,5294,5294,-40,-40,0,0,0
2874,p1810,20171215,5294,5294,0,0,0,5294,5294,0,0,0,0,0
2875,p1810,20171218,5294,5294,0,0,0,5308,5308,14,14,0,0,0
2876,p1810,20171219,5308,5308,0,0,0,5308,5308,0,0,0,0,0
2877,p1810,20171220,5308,5308,0,0,0,5308,5308,0,0,0,0,0
2878,p1810,20171221,5308,5308,0,0,0,5252,5252,-56,-56,0,0,0
2879,p1810,20171222,5252,5252,0,0,0,5204,5204,-48,-48,0,0,0
2880,p1810,20171225,5204,5204,0,0,0,5230,5230,26,26,0,0,0
2881,p1810,20171226,5230,5230,0,0,0,5230,5230,0,0,0,0,0
2882,p1810,20171227,5230,5230,0,0,0,5230,5230,0,0,0,0,0
2883,p1810,20171228,5230,5230,0,0,0,5230,5230,0,0,0,0,0
2884,p1810,20171229,5230,5230,0,0,0,5212,5212,-18,-18,0,0,0
2885,p1811,20171115,5610,5610,0,0,0,5610,5610,0,0,0,0,0
2886,p1811,20171116,5610,5610,0,0,0,5610,5610,0,0,0,0,0
2887,p1811,20171117,5610,5610,0,0,0,5610,5610,0,0,0,0,0
2888,p1811,20171120,5610,5610,0,0,0,5514,5514,-96,-96,0,0,0
2889,p1811,20171121,5514,5514,0,0,0,5514,5514,0,0,0,0,0
2890,p1811,20171122,5514,5514,0,0,0,5484,5484,-30,-30,0,0,0
2891,p1811,20171123,5484,5484,0,0,0,5484,5484,0,0,0,0,0
2892,p1811,20171124,5484,5484,0,0,0,5484,5484,0,0,0,0,0
2893,p1811,20171127,5484,5484,0,0,0,5434,5434,-50,-50,0,0,0
2894,p1811,20171128,5434,5434,0,0,0,5434,5434,0,0,0,0,0
2895,p1811,20171129,5434,5434,0,0,0,5434,5434,0,0,0,0,0
2896,p1811,20171130,5434,5434,0,0,0,5434,5434,0,0,0,0,0
2897,p1811,20171201,5434,5434,0,0,0,5434,5434,0,0,0,0,0
2898,p1811,20171204,5434,5434,0,0,0,5434,5434,0,0,0,0,0
2899,p1811,20171205,5434,5434,0,0,0,5432,5432,-2,-2,0,0,0
2900,p1811,20171206,5432,5432,0,0,0,5432,5432,0,0,0,0,0
2901,p1811,20171207,5432,5432,0,0,0,5378,5378,-54,-54,0,0,0
2902,p1811,20171208,5378,5378,0,0,0,5378,5378,0,0,0,0,0
2903,p1811,20171211,5378,5378,0,0,0,5346,5346,-32,-32,0,0,0
2904,p1811,20171212,5346,5346,0,0,0,5346,5346,0,0,0,0,0
2905,p1811,20171213,5346,5346,5382,5382,5376,5376,5380,30,34,12,645720,10
2906,p1811,20171214,5376,5380,0,0,0,5338,5338,-42,-42,0,0,10
2907,p1811,20171215,5338,5338,0,0,0,5338,5338,0,0,0,0,10
2908,p1811,20171218,5338,5338,0,0,0,5338,5338,0,0,0,0,10
2909,p1811,20171219,5338,5338,0,0,0,5318,5318,-20,-20,0,0,10
2910,p1811,20171220,5318,5318,0,0,0,5318,5318,0,0,0,0,10
2911,p1811,20171221,5318,5318,0,0,0,5260,5260,-58,-58,0,0,10
2912,p1811,20171222,5260,5260,0,0,0,5210,5210,-50,-50,0,0,10
2913,p1811,20171225,5210,5210,0,0,0,5210,5210,0,0,0,0,10
2914,p1811,20171226,5210,5210,0,0,0,5210,5210,0,0,0,0,10
2915,p1811,20171227,5210,5210,0,0,0,5254,5254,44,44,0,0,10
2916,p1811,20171228,5254,5254,0,0,0,5254,5254,0,0,0,0,10
2917,p1811,20171229,5254,5254,0,0,0,5254,5254,0,0,0,0,10
2918,p1812,20171215,5338,5338,0,0,0,5318,5318,-20,-20,0,0,0
2919,p1812,20171218,5318,5318,0,0,0,5356,5356,38,38,0,0,0
2920,p1812,20171219,5356,5356,0,0,0,5336,5336,-20,-20,0,0,0
2921,p1812,20171220,5336,5336,0,0,0,5352,5352,16,16,0,0,0
2922,p1812,20171221,5352,5352,0,0,0,5352,5352,0,0,0,0,0
2923,p1812,20171222,5352,5352,0,0,0,5302,5302,-50,-50,0,0,0
2924,p1812,20171225,5302,5302,0,0,0,5330,5330,28,28,0,0,0
2925,p1812,20171226,5330,5330,0,0,0,5328,5328,-2,-2,0,0,0
2926,p1812,20171227,5328,5328,0,0,0,5374,5374,46,46,0,0,0
2927,p1812,20171228,5374,5374,0,0,0,5382,5382,8,8,0,0,0
2928,p1812,20171229,5382,5382,0,0,0,5382,5382,0,0,0,0,0
