ROWNUM,合约,日期,前收盘价,前结算价,开盘价,最高价,最低价,收盘价,结算价,涨跌1,涨跌2,成交量,成交金额,持仓量
1,jd1701,20170103,3086,3147,3015,3015,2896,2898,2915,-249,-232,286,8339620,46
2,jd1701,20170104,2898,2915,0,0,0,2915,2915,0,0,0,0,46
3,jd1701,20170105,2915,2915,2901,2901,2901,2901,2901,-14,-14,2,58020,44
4,jd1701,20170106,2901,2901,2939,2988,2939,2988,2977,87,76,10,297740,34
5,jd1701,20170109,2988,2977,2909,2909,2909,2909,2909,-68,-68,2,58180,32
6,jd1701,20170110,2909,2909,0,0,0,2909,2909,0,0,0,0,32
7,jd1701,20170111,2909,2909,2909,2909,2901,2901,2905,-8,-4,4,116200,28
8,jd1701,20170112,2901,2905,0,0,0,2905,2905,0,0,0,0,28
9,jd1701,20170113,2905,2905,2800,2975,2800,2895,2852,-10,-53,22,627600,6
10,jd1701,20170116,2895,2852,0,0,0,2913,2913,61,61,0,0,0
11,jd1702,20170103,3051,3059,3050,3050,2990,3006,3004,-53,-55,268,8052060,1108
12,jd1702,20170104,3006,3004,2993,3034,2962,3006,3012,2,8,272,8194120,1054
13,jd1702,20170105,3006,3012,3009,3009,2990,3002,2996,-10,-16,78,2336900,1046
14,jd1702,20170106,3002,2996,3002,3005,2905,2957,2963,-39,-33,162,4801000,1040
15,jd1702,20170109,2957,2963,2936,2978,2923,2939,2945,-24,-18,106,3122320,1036
16,jd1702,20170110,2939,2945,2950,2950,2921,2924,2930,-21,-15,38,1113520,1042
17,jd1702,20170111,2924,2930,2950,2959,2931,2955,2945,25,15,166,4889060,1080
18,jd1702,20170112,2955,2945,2943,2943,2882,2883,2910,-62,-35,160,4657080,1140
19,jd1702,20170113,2883,2910,2859,2910,2851,2903,2878,-7,-32,512,14736460,1092
20,jd1702,20170116,2903,2878,2851,2888,2848,2854,2865,-24,-13,330,9454720,1014
21,jd1702,20170117,2854,2865,2875,2877,2836,2860,2860,-5,-5,260,7437460,952
22,jd1702,20170118,2860,2860,2857,2867,2836,2860,2850,0,-10,56,1596180,928
23,jd1702,20170119,2860,2850,2858,2868,2852,2854,2859,4,9,152,4346580,880
24,jd1702,20170120,2854,2859,2859,2859,2836,2844,2844,-15,-15,110,3129120,850
25,jd1702,20170123,2844,2844,2825,2826,2716,2716,2758,-128,-86,280,7722560,824
26,jd1702,20170124,2716,2758,2716,2716,2621,2631,2645,-127,-113,414,10954140,706
27,jd1702,20170125,2631,2645,2584,2645,2583,2638,2616,-7,-29,324,8477460,516
28,jd1702,20170126,2638,2616,2613,2680,2601,2603,2627,-13,11,630,16551880,62
29,jd1702,20170203,2603,2627,2522,2620,2512,2558,2546,-69,-81,34,865760,46
30,jd1702,20170206,2558,2546,2674,2674,2555,2555,2595,9,49,6,155700,48
31,jd1702,20170207,2555,2595,2654,2655,2654,2655,2654,60,59,4,106180,50
32,jd1702,20170208,2655,2654,2610,2610,2610,2610,2610,-44,-44,4,104400,50
33,jd1702,20170209,2610,2610,2660,2670,2580,2640,2639,30,29,28,739000,36
34,jd1702,20170210,2640,2639,2670,2675,2660,2660,2668,21,29,6,160100,34
35,jd1702,20170213,2660,2668,2695,2695,2630,2630,2676,-38,8,14,374700,30
36,jd1702,20170214,2630,2676,2551,2698,2551,2596,2618,-80,-58,24,628420,6
37,jd1702,20170215,2596,2618,2590,2698,2590,2698,2644,80,26,8,211520,2
38,jd1702,20170216,2698,2644,2660,2660,2660,2660,2614,16,-30,2,53200,0
39,jd1703,20170103,3076,3071,3050,3067,3039,3050,3047,-21,-24,354,10788160,2852
40,jd1703,20170104,3050,3047,3012,3070,3008,3059,3037,12,-10,762,23146360,2980
41,jd1703,20170105,3059,3037,3059,3059,3010,3033,3032,-4,-5,390,11825340,3098
42,jd1703,20170106,3033,3032,3016,3037,3011,3015,3021,-17,-11,448,13534900,3290
43,jd1703,20170109,3015,3021,3003,3028,3003,3026,3015,5,-6,292,8804700,3306
44,jd1703,20170110,3026,3015,3038,3046,3016,3017,3032,2,17,214,6490140,3266
45,jd1703,20170111,3017,3032,3037,3092,3032,3068,3058,36,26,790,24165560,3318
46,jd1703,20170112,3068,3058,3054,3062,3001,3015,3019,-43,-39,966,29172220,3634
47,jd1703,20170113,3015,3019,3011,3015,2946,2954,2981,-65,-38,1104,32919920,4136
48,jd1703,20170116,2954,2981,2933,2973,2933,2959,2954,-22,-27,992,29308840,4394
49,jd1703,20170117,2959,2954,2970,2994,2901,2945,2951,-9,-3,854,25207260,4348
50,jd1703,20170118,2945,2951,2958,2958,2938,2953,2946,2,-5,272,8014860,4378
51,jd1703,20170119,2953,2946,2959,2979,2945,2962,2964,16,18,252,7469540,4334
52,jd1703,20170120,2962,2964,2945,2964,2941,2955,2948,-9,-16,316,9316460,4192
53,jd1703,20170123,2955,2948,2941,2946,2907,2917,2923,-31,-25,474,13857640,4286
54,jd1703,20170124,2917,2923,2910,2915,2830,2838,2870,-85,-53,1472,42247540,4652
55,jd1703,20170125,2838,2870,2818,2830,2781,2820,2808,-50,-62,1074,30164580,4438
56,jd1703,20170126,2820,2808,2812,2919,2812,2895,2888,87,80,2066,59676560,3736
57,jd1703,20170203,2895,2888,2821,2852,2801,2820,2823,-68,-65,1424,40202720,3978
58,jd1703,20170206,2820,2823,2823,2849,2820,2833,2836,10,13,972,27573300,3942
59,jd1703,20170207,2833,2836,2831,2838,2826,2838,2832,2,-4,338,9574300,3882
60,jd1703,20170208,2838,2832,2840,2842,2833,2839,2838,7,6,488,13853160,3684
61,jd1703,20170209,2839,2838,2831,2837,2812,2816,2823,-22,-15,524,14796540,3588
62,jd1703,20170210,2816,2823,2814,2823,2792,2812,2808,-11,-15,614,17244540,3622
63,jd1703,20170213,2812,2808,2808,2813,2785,2797,2802,-11,-6,846,23709400,3618
64,jd1703,20170214,2797,2802,2797,2833,2779,2784,2801,-18,-1,712,19946240,3378
65,jd1703,20170215,2784,2801,2786,2799,2713,2718,2737,-83,-64,1330,36411540,3184
66,jd1703,20170216,2718,2737,2729,2729,2644,2670,2693,-67,-44,1694,45634060,2716
67,jd1703,20170217,2670,2693,2683,2683,2618,2638,2641,-55,-52,834,22029240,2532
68,jd1703,20170220,2638,2641,2624,2644,2588,2637,2619,-4,-22,778,20375880,2500
69,jd1703,20170221,2637,2619,2617,2637,2607,2608,2618,-11,-1,474,12410080,2462
70,jd1703,20170222,2608,2618,2595,2606,2567,2579,2587,-39,-31,644,16665180,2324
71,jd1703,20170223,2579,2587,2575,2575,2502,2509,2522,-78,-65,950,23960460,2160
72,jd1703,20170224,2509,2522,2490,2530,2467,2486,2496,-36,-26,886,22117120,1872
73,jd1703,20170227,2486,2496,2480,2488,2430,2441,2451,-55,-45,1058,25941100,1466
74,jd1703,20170228,2441,2451,2422,2525,2412,2498,2463,47,12,2036,50156840,236
75,jd1703,20170301,2498,2463,2501,2546,2501,2546,2513,83,50,52,1307020,208
76,jd1703,20170302,2546,2513,2509,2509,2503,2503,2505,-10,-8,10,250520,144
77,jd1703,20170303,2503,2505,2495,2500,2470,2500,2491,-5,-14,64,1594780,140
78,jd1703,20170306,2500,2491,2485,2495,2450,2495,2471,4,-20,24,593160,118
79,jd1703,20170307,2495,2471,2549,2549,2534,2534,2541,63,70,4,101660,116
80,jd1703,20170308,2534,2541,2520,2548,2520,2542,2531,1,-10,18,455580,104
81,jd1703,20170309,2542,2531,2542,2547,2520,2520,2536,-11,5,6,152180,100
82,jd1703,20170310,2520,2536,2547,2650,2540,2540,2556,4,20,28,715880,94
83,jd1703,20170313,2540,2556,2684,2684,2602,2602,2643,46,87,4,105720,94
84,jd1703,20170314,2602,2643,0,0,0,2639,2639,-4,-4,0,0,74
85,jd1703,20170315,2639,2639,2645,2645,2559,2559,2573,-80,-66,12,308800,62
86,jd1703,20170316,2559,2573,2680,2680,2680,2680,2680,107,107,2,53600,38
87,jd1703,20170317,2680,2680,2730,2730,2730,2730,2730,50,50,2,54600,38
88,jd1703,20170320,2730,2730,2892,2892,2892,2892,2892,162,162,10,289200,32
89,jd1703,20170321,2892,2892,2850,2900,2839,2900,2878,8,-14,24,690780,24
90,jd1703,20170322,2900,2878,2800,2800,2800,2800,2800,-78,-78,10,280000,32
91,jd1703,20170323,2800,2800,0,0,0,2800,2800,0,0,0,0,12
92,jd1703,20170324,2800,2800,2880,2880,2880,2880,2880,80,80,2,57600,12
93,jd1703,20170327,2880,2880,0,0,0,2880,2880,0,0,0,0,0
94,jd1703,20170328,2880,2880,0,0,0,2797,2797,-83,-83,0,0,0
95,jd1704,20170103,3269,3269,3169,3192,3161,3182,3172,-87,-97,26,824920,50
96,jd1704,20170104,3182,3172,3179,3179,3175,3175,3177,3,5,10,317720,56
97,jd1704,20170105,3175,3177,3181,3201,3180,3180,3192,3,15,10,319280,58
98,jd1704,20170106,3180,3192,3121,3121,3121,3121,3121,-71,-71,2,62420,60
99,jd1704,20170109,3121,3121,0,0,0,3121,3121,0,0,0,0,60
100,jd1704,20170110,3121,3121,3168,3168,3161,3161,3165,40,44,6,189920,56
101,jd1704,20170111,3161,3165,3256,3259,3220,3254,3234,89,69,18,582180,68
102,jd1704,20170112,3254,3234,3211,3211,3211,3211,3211,-23,-23,6,192660,72
103,jd1704,20170113,3211,3211,3134,3170,3101,3150,3131,-61,-80,44,1377800,52
104,jd1704,20170116,3150,3131,3157,3157,3133,3133,3149,2,18,6,188940,56
105,jd1704,20170117,3133,3149,3126,3171,3101,3142,3133,-7,-16,22,689360,56
106,jd1704,20170118,3142,3133,0,0,0,3133,3133,0,0,0,0,56
107,jd1704,20170119,3133,3133,3170,3170,3170,3170,3170,37,37,8,253600,52
108,jd1704,20170120,3170,3170,3183,3183,3182,3182,3182,12,12,4,127300,48
109,jd1704,20170123,3182,3182,3166,3166,3166,3166,3166,-16,-16,2,63320,48
110,jd1704,20170124,3166,3166,3198,3198,3153,3153,3172,-13,6,16,507640,46
111,jd1704,20170125,3153,3172,3139,3139,3104,3135,3133,-37,-39,42,1316020,54
112,jd1704,20170126,3135,3133,3156,3156,3116,3148,3137,15,4,12,376440,54
113,jd1704,20170203,3148,3137,3088,3120,3055,3090,3089,-47,-48,28,865020,66
114,jd1704,20170206,3090,3089,3100,3101,3100,3101,3100,12,11,12,372060,70
115,jd1704,20170207,3101,3100,3075,3148,3075,3091,3104,-9,4,6,186280,70
116,jd1704,20170208,3091,3104,3102,3109,3079,3108,3097,4,-7,36,1114980,64
117,jd1704,20170209,3108,3097,3106,3106,3106,3106,3106,9,9,4,124240,66
118,jd1704,20170210,3106,3106,0,0,0,3106,3106,0,0,0,0,66
119,jd1704,20170213,3106,3106,3063,3120,3063,3120,3095,14,-11,30,928780,68
120,jd1704,20170214,3120,3095,0,0,0,3095,3095,0,0,0,0,68
121,jd1704,20170215,3095,3095,3078,3078,3016,3030,3036,-65,-59,86,2611740,128
122,jd1704,20170216,3030,3036,3012,3029,2889,2908,2947,-128,-89,144,4244820,178
123,jd1704,20170217,2908,2947,2878,2881,2803,2832,2827,-115,-120,282,7972880,202
124,jd1704,20170220,2832,2827,2821,2821,2757,2816,2794,-11,-33,162,4526980,242
125,jd1704,20170221,2816,2794,2818,2830,2777,2805,2809,11,15,198,5562740,334
126,jd1704,20170222,2805,2809,2798,2815,2769,2781,2793,-28,-16,224,6257700,440
127,jd1704,20170223,2781,2793,2777,2778,2666,2666,2713,-127,-80,498,13513340,660
128,jd1704,20170224,2666,2713,2689,2715,2638,2713,2692,0,-21,612,16476960,860
129,jd1704,20170227,2713,2692,2709,2712,2650,2660,2674,-32,-18,880,23532040,1314
130,jd1704,20170228,2660,2674,2653,2701,2644,2686,2676,12,2,890,23819820,1344
131,jd1704,20170301,2686,2676,2688,2739,2688,2727,2721,51,45,732,19919600,1350
132,jd1704,20170302,2727,2721,2747,2784,2732,2782,2763,61,42,854,23600940,1360
133,jd1704,20170303,2782,2763,2770,2775,2733,2745,2758,-18,-5,792,21846100,1536
134,jd1704,20170306,2745,2758,2733,2743,2710,2729,2731,-29,-27,566,15462680,1728
135,jd1704,20170307,2729,2731,2733,2733,2701,2717,2713,-14,-18,570,15469220,1736
136,jd1704,20170308,2717,2713,2709,2739,2702,2737,2725,24,12,850,23167140,1802
137,jd1704,20170309,2737,2725,2747,2747,2721,2729,2733,4,8,410,11207660,1710
138,jd1704,20170310,2729,2733,2721,2742,2716,2724,2729,-9,-4,510,13922640,1496
139,jd1704,20170313,2724,2729,2720,2753,2720,2751,2744,22,15,536,14712840,1406
140,jd1704,20170314,2751,2744,2751,2753,2726,2729,2732,-15,-12,552,15083000,1324
141,jd1704,20170315,2729,2732,2729,2748,2721,2730,2732,-2,0,392,10712880,1208
142,jd1704,20170316,2730,2732,2725,2732,2702,2721,2719,-11,-13,476,12942540,1008
143,jd1704,20170317,2721,2719,2747,2747,2713,2736,2731,17,12,336,9177500,896
144,jd1704,20170320,2736,2731,2777,2867,2751,2867,2827,136,96,1132,32002100,990
145,jd1704,20170321,2867,2827,2890,2926,2867,2880,2901,53,74,790,22918360,886
146,jd1704,20170322,2880,2901,2875,2876,2840,2873,2864,-28,-37,246,7047560,850
147,jd1704,20170323,2873,2864,2879,2891,2865,2868,2874,4,10,102,2931600,834
148,jd1704,20170324,2868,2874,2862,2888,2849,2860,2864,-14,-10,198,5672040,762
149,jd1704,20170327,2860,2864,2856,2873,2841,2847,2856,-17,-8,204,5828160,776
150,jd1704,20170328,2847,2856,2856,2865,2755,2780,2792,-76,-64,472,13182500,658
151,jd1704,20170329,2780,2792,2733,2787,2725,2747,2762,-45,-30,180,4972800,590
152,jd1704,20170330,2747,2762,2750,2758,2720,2754,2747,-8,-15,466,12803540,426
153,jd1704,20170331,2754,2747,2841,2884,2610,2610,2688,-137,-59,634,17047560,176
154,jd1704,20170405,2610,2688,2475,2580,2475,2569,2514,-119,-174,90,2263040,122
155,jd1704,20170406,2569,2514,2550,2664,2550,2600,2609,86,95,62,1617660,36
156,jd1704,20170407,2600,2609,0,0,0,2609,2609,0,0,0,0,26
157,jd1704,20170410,2609,2609,2500,2500,2453,2453,2484,-156,-125,6,149060,20
158,jd1704,20170411,2453,2484,2450,2450,2400,2400,2412,-84,-72,16,386000,4
159,jd1704,20170412,2400,2412,2556,2556,2556,2556,2556,144,144,2,51120,4
160,jd1704,20170413,2556,2556,2500,2500,2500,2500,2500,-56,-56,2,50000,4
161,jd1704,20170414,2500,2500,0,0,0,2500,2500,0,0,0,0,2
162,jd1704,20170417,2500,2500,2500,2500,2500,2500,2500,0,0,2,50000,0
163,jd1704,20170418,2500,2500,0,0,0,2500,2500,0,0,0,0,0
164,jd1704,20170419,2500,2500,0,0,0,2500,2500,0,0,0,0,0
165,jd1704,20170420,2500,2500,0,0,0,2500,2500,0,0,0,0,0
166,jd1704,20170421,2500,2500,0,0,0,2500,2500,0,0,0,0,0
167,jd1704,20170424,2500,2500,0,0,0,2500,2500,0,0,0,0,0
168,jd1704,20170425,2500,2500,0,0,0,2518,2518,18,18,0,0,0
169,jd1705,20170103,3375,3374,3350,3390,3349,3374,3370,0,-4,128730,4338528880,192260
170,jd1705,20170104,3374,3370,3368,3420,3313,3418,3372,48,2,260066,8769993120,190586
171,jd1705,20170105,3418,3372,3425,3452,3401,3417,3425,45,53,143652,4920157420,188534
172,jd1705,20170106,3417,3425,3420,3433,3335,3355,3379,-70,-46,190870,6450683820,192732
173,jd1705,20170109,3355,3379,3351,3375,3340,3365,3358,-14,-21,123232,4138985840,193840
174,jd1705,20170110,3365,3358,3375,3386,3343,3366,3366,8,8,143634,4836053140,199296
175,jd1705,20170111,3366,3366,3374,3502,3374,3484,3455,118,89,354952,12263625880,205566
176,jd1705,20170112,3484,3455,3480,3508,3432,3455,3463,0,8,171926,5955058500,204834
177,jd1705,20170113,3455,3463,3480,3485,3388,3404,3439,-59,-24,190564,6555263060,214246
178,jd1705,20170116,3404,3439,3406,3442,3383,3426,3418,-13,-21,229884,7858028600,230486
179,jd1705,20170117,3426,3418,3429,3479,3345,3380,3404,-38,-14,298270,10155127180,228806
180,jd1705,20170118,3380,3404,3390,3401,3371,3388,3385,-16,-19,130140,4406193640,223772
181,jd1705,20170119,3388,3385,3400,3447,3393,3424,3426,39,41,211010,7229393020,219512
182,jd1705,20170120,3424,3426,3420,3428,3370,3386,3388,-40,-38,132842,4501986280,213180
183,jd1705,20170123,3386,3388,3388,3423,3355,3402,3393,14,5,159572,5414509040,220096
184,jd1705,20170124,3402,3393,3405,3440,3390,3418,3417,25,24,160584,5488143140,221946
185,jd1705,20170125,3418,3417,3410,3417,3373,3391,3395,-26,-22,122008,4142474480,211826
186,jd1705,20170126,3391,3395,3395,3418,3380,3393,3397,-2,2,111356,3783512040,202720
187,jd1705,20170203,3393,3397,3380,3380,3286,3299,3316,-98,-81,218422,7243825280,240958
188,jd1705,20170206,3299,3316,3295,3330,3287,3317,3315,1,-1,145982,4839957380,250774
189,jd1705,20170207,3317,3315,3315,3332,3305,3314,3317,-1,2,103684,3439883840,257446
190,jd1705,20170208,3314,3317,3322,3344,3314,3323,3325,6,8,189274,6295190980,265362
191,jd1705,20170209,3323,3325,3333,3336,3303,3320,3321,-5,-4,168468,5594975920,273020
192,jd1705,20170210,3320,3321,3318,3335,3311,3325,3323,4,2,154250,5126042600,270292
193,jd1705,20170213,3325,3323,3330,3385,3235,3368,3340,45,17,364336,12170597040,273086
194,jd1705,20170214,3368,3340,3366,3389,3341,3363,3366,23,26,176142,5930664100,272066
195,jd1705,20170215,3363,3366,3350,3355,3300,3314,3322,-52,-44,223062,7411886560,271248
196,jd1705,20170216,3314,3322,3321,3341,3308,3317,3324,-5,2,157362,5231254820,270844
197,jd1705,20170217,3317,3324,3313,3328,3248,3277,3283,-47,-41,272622,8951904940,279850
198,jd1705,20170220,3277,3283,3276,3292,3260,3284,3275,1,-8,129086,4228448500,284242
199,jd1705,20170221,3284,3275,3288,3310,3275,3295,3293,20,18,157716,5193659260,283130
200,jd1705,20170222,3295,3293,3279,3320,3267,3315,3301,22,8,203534,6720287700,290068
201,jd1705,20170223,3315,3301,3319,3326,3275,3294,3294,-7,-7,163228,5377560760,289184
202,jd1705,20170224,3294,3294,3272,3356,3268,3352,3324,58,30,296794,9867801840,302252
203,jd1705,20170227,3352,3324,3352,3366,3323,3343,3338,19,14,174882,5839146120,311456
204,jd1705,20170228,3343,3338,3343,3378,3308,3328,3339,-10,1,266116,8886995220,311838
205,jd1705,20170301,3328,3339,3340,3352,3320,3330,3335,-9,-4,143634,4791176720,315258
206,jd1705,20170302,3330,3335,3340,3350,3323,3346,3337,11,2,134616,4493378180,320652
207,jd1705,20170303,3346,3337,3326,3343,3301,3318,3321,-19,-16,170376,5659154960,313336
208,jd1705,20170306,3318,3321,3316,3328,3293,3299,3310,-22,-11,176122,5830943600,331156
209,jd1705,20170307,3299,3310,3301,3304,3255,3258,3275,-52,-35,227776,7459824520,346836
210,jd1705,20170308,3258,3275,3240,3246,3181,3218,3215,-57,-60,260906,8388569180,325794
211,jd1705,20170309,3218,3215,3210,3225,3198,3214,3213,-1,-2,122684,3942356000,312402
212,jd1705,20170310,3214,3213,3215,3233,3200,3205,3214,-8,1,136510,4388684360,301336
213,jd1705,20170313,3205,3214,3205,3232,3190,3221,3219,7,5,129862,4181306300,296416
214,jd1705,20170314,3221,3219,3220,3236,3204,3222,3217,3,-2,127094,4088790260,295390
215,jd1705,20170315,3222,3217,3230,3241,3201,3217,3221,0,4,156150,5029777680,299396
216,jd1705,20170316,3217,3221,3223,3229,3159,3163,3190,-58,-31,221118,7055135340,302644
217,jd1705,20170317,3163,3190,3156,3173,3147,3156,3163,-34,-27,99520,3148060780,299292
218,jd1705,20170320,3156,3163,3182,3272,3181,3269,3234,106,71,253532,8201243460,261070
219,jd1705,20170321,3269,3234,3285,3320,3267,3319,3299,85,65,231630,7641521640,230486
220,jd1705,20170322,3319,3299,3310,3315,3273,3294,3290,-5,-9,121688,4003763740,221402
221,jd1705,20170323,3294,3290,3294,3305,3272,3293,3288,3,-2,102394,3367699960,221662
222,jd1705,20170324,3293,3288,3290,3303,3248,3266,3270,-22,-18,138500,4529854420,216104
223,jd1705,20170327,3266,3270,3258,3287,3250,3277,3268,7,-2,115268,3767009940,214244
224,jd1705,20170328,3277,3268,3285,3306,3193,3220,3238,-48,-30,211892,6862285380,199232
225,jd1705,20170329,3220,3238,3226,3233,3202,3224,3217,-14,-21,79928,2571413060,196554
226,jd1705,20170330,3224,3217,3215,3215,3142,3148,3167,-69,-50,164060,5196622640,187552
227,jd1705,20170331,3148,3167,3155,3161,3100,3126,3120,-41,-47,142540,4447906920,170742
228,jd1705,20170405,3126,3120,3086,3110,3037,3057,3068,-63,-52,128634,3946679500,166372
229,jd1705,20170406,3057,3068,3060,3073,3053,3062,3061,-6,-7,51964,1590831280,162738
230,jd1705,20170407,3062,3061,3047,3050,3006,3011,3028,-50,-33,79328,2402764440,149628
231,jd1705,20170410,3011,3028,3000,3000,2906,2919,2938,-109,-90,121726,3577305460,154236
232,jd1705,20170411,2919,2938,2900,2916,2866,2885,2891,-53,-47,78410,2267255920,147890
233,jd1705,20170412,2885,2891,2875,2910,2875,2878,2894,-13,3,56930,1647559440,133320
234,jd1705,20170413,2878,2894,2879,2889,2862,2878,2875,-16,-19,50406,1449246560,124798
235,jd1705,20170414,2878,2875,2885,2895,2871,2883,2876,8,1,37666,1083578400,111042
236,jd1705,20170417,2883,2876,2900,2904,2850,2900,2882,24,6,63108,1819134480,89098
237,jd1705,20170418,2900,2882,2890,2890,2775,2783,2834,-99,-48,62160,1762131740,68436
238,jd1705,20170419,2783,2834,2755,2756,2693,2693,2706,-141,-128,36370,984474320,59804
239,jd1705,20170420,2693,2706,2652,2652,2550,2560,2591,-146,-115,72292,1873153280,46070
240,jd1705,20170421,2560,2591,2532,2585,2516,2533,2547,-58,-44,39500,1006304460,41922
241,jd1705,20170424,2533,2547,2500,2508,2420,2420,2459,-127,-88,36490,897653980,38486
242,jd1705,20170425,2420,2459,2370,2401,2298,2362,2349,-97,-110,81130,1905840300,25958
243,jd1705,20170426,2362,2349,2356,2418,2351,2414,2389,65,40,27874,665968640,20722
244,jd1705,20170427,2414,2389,2407,2415,2353,2360,2374,-29,-15,21286,505425540,13736
245,jd1705,20170428,2360,2374,2351,2353,2261,2328,2307,-46,-67,26908,620811580,508
246,jd1705,20170502,2328,2307,2340,2346,2169,2210,2223,-97,-84,640,14229960,188
247,jd1705,20170503,2210,2223,2260,2260,2128,2190,2202,-33,-21,78,1718280,104
248,jd1705,20170504,2190,2202,2268,2334,2266,2334,2309,132,107,72,1662720,114
249,jd1705,20170505,2334,2309,2350,2440,2280,2350,2324,41,15,88,2045520,66
250,jd1705,20170508,2350,2324,2260,2265,2185,2260,2256,-64,-68,32,722160,50
251,jd1705,20170509,2260,2256,0,0,0,2256,2256,0,0,0,0,48
252,jd1705,20170510,2256,2256,0,0,0,2256,2256,0,0,0,0,46
253,jd1705,20170511,2256,2256,2300,2300,2300,2300,2300,44,44,4,92000,38
254,jd1705,20170512,2300,2300,2162,2162,2162,2162,2162,-138,-138,2,43240,34
255,jd1705,20170515,2162,2162,2250,2260,2250,2260,2257,98,95,14,316000,32
256,jd1705,20170516,2260,2257,2122,2258,2122,2122,2176,-135,-81,10,217640,28
257,jd1705,20170517,2122,2176,2046,2099,2046,2046,2067,-130,-109,10,206720,22
258,jd1705,20170518,2046,2067,1910,1910,1910,1910,1910,-157,-157,2,38200,22
259,jd1705,20170519,1910,1910,2024,2024,2024,2024,2024,114,114,2,40480,12
260,jd1705,20170522,2024,2024,2100,2100,1910,1910,2005,-114,-19,4,80200,12
261,jd1705,20170523,1910,2005,2125,2125,2125,2125,2125,120,120,4,85000,4
262,jd1705,20170524,2125,2125,0,0,0,2152,2152,27,27,0,0,0
263,jd1706,20170103,3434,3434,0,0,0,3434,3434,0,0,0,0,30
264,jd1706,20170104,3434,3434,0,0,0,3434,3434,0,0,0,0,30
265,jd1706,20170105,3434,3434,0,0,0,3434,3434,0,0,0,0,30
266,jd1706,20170106,3434,3434,0,0,0,3410,3410,-24,-24,0,0,30
267,jd1706,20170109,3410,3410,0,0,0,3410,3410,0,0,0,0,30
268,jd1706,20170110,3410,3410,0,0,0,3410,3410,0,0,0,0,30
269,jd1706,20170111,3410,3410,3490,3561,3380,3535,3499,125,89,20,699880,34
270,jd1706,20170112,3535,3499,3530,3530,3443,3496,3486,-3,-13,38,1324900,34
271,jd1706,20170113,3496,3486,3510,3510,3441,3441,3463,-45,-23,14,484900,34
272,jd1706,20170116,3441,3463,3401,3464,3401,3464,3422,1,-41,6,205320,30
273,jd1706,20170117,3464,3422,3470,3470,3417,3436,3434,14,12,18,618200,34
274,jd1706,20170118,3436,3434,3445,3445,3416,3420,3420,-14,-14,14,478900,40
275,jd1706,20170119,3420,3420,3459,3460,3382,3460,3436,40,16,10,343640,38
276,jd1706,20170120,3460,3436,3430,3430,3430,3430,3430,-6,-6,2,68600,36
277,jd1706,20170123,3430,3430,3410,3424,3410,3424,3417,-6,-13,4,136680,36
278,jd1706,20170124,3424,3417,0,0,0,3417,3417,0,0,0,0,36
279,jd1706,20170125,3417,3417,3454,3454,3385,3385,3419,-32,2,4,136780,36
280,jd1706,20170126,3385,3419,0,0,0,3419,3419,0,0,0,0,36
281,jd1706,20170203,3419,3419,3362,3362,3343,3343,3357,-76,-62,8,268580,40
282,jd1706,20170206,3343,3357,0,0,0,3357,3357,0,0,0,0,40
283,jd1706,20170207,3357,3357,0,0,0,3357,3357,0,0,0,0,40
284,jd1706,20170208,3357,3357,3361,3382,3361,3376,3374,19,17,34,1147240,52
285,jd1706,20170209,3376,3374,3517,3517,3361,3361,3393,-13,19,14,475120,54
286,jd1706,20170210,3361,3393,3375,3375,3360,3360,3367,-33,-26,4,134700,54
287,jd1706,20170213,3360,3367,3323,3437,3323,3370,3387,3,20,112,3794480,104
288,jd1706,20170214,3370,3387,3375,3397,3375,3378,3383,-9,-4,44,1488620,120
289,jd1706,20170215,3378,3383,3335,3363,3335,3342,3348,-41,-35,32,1071620,126
290,jd1706,20170216,3342,3348,3327,3350,3302,3335,3330,-13,-18,168,5595020,196
291,jd1706,20170217,3335,3330,3347,3347,3235,3272,3285,-58,-45,250,8214700,356
292,jd1706,20170220,3272,3285,3263,3296,3256,3273,3273,-12,-12,330,10801880,598
293,jd1706,20170221,3273,3273,3295,3296,3263,3294,3282,21,9,226,7418660,720
294,jd1706,20170222,3294,3282,3280,3308,3278,3288,3290,6,8,172,5659200,724
295,jd1706,20170223,3288,3290,3309,3317,3275,3280,3288,-10,-2,442,14533960,968
296,jd1706,20170224,3280,3288,3284,3342,3270,3338,3315,50,27,532,17639740,1008
297,jd1706,20170227,3338,3315,3342,3399,3340,3399,3377,84,62,624,21075180,1224
298,jd1706,20170228,3399,3377,3433,3439,3398,3416,3419,39,42,594,20309720,1364
299,jd1706,20170301,3416,3419,3433,3439,3383,3400,3401,-19,-18,444,15101720,1582
300,jd1706,20170302,3400,3401,3398,3400,3375,3391,3387,-10,-14,210,7112760,1692
301,jd1706,20170303,3391,3387,3385,3385,3360,3369,3370,-18,-17,332,11189180,1762
302,jd1706,20170306,3369,3370,3362,3376,3360,3365,3366,-5,-4,172,5790120,1808
303,jd1706,20170307,3365,3366,3360,3372,3330,3336,3351,-30,-15,244,8176940,1844
304,jd1706,20170308,3336,3351,3312,3350,3288,3304,3306,-47,-45,322,10647980,1870
305,jd1706,20170309,3304,3306,3315,3319,3300,3317,3312,11,6,174,5763300,1906
306,jd1706,20170310,3317,3312,3333,3342,3283,3300,3311,-12,-1,430,14240220,2136
307,jd1706,20170313,3300,3311,3340,3340,3293,3308,3304,-3,-7,378,12490600,2260
308,jd1706,20170314,3308,3304,3300,3306,3283,3293,3293,-11,-11,358,11789000,2426
309,jd1706,20170315,3293,3293,3303,3326,3290,3298,3300,5,7,242,7987340,2522
310,jd1706,20170316,3298,3300,3272,3308,3252,3265,3276,-35,-24,564,18478460,2778
311,jd1706,20170317,3265,3276,3259,3268,3246,3252,3256,-24,-20,286,9312160,2826
312,jd1706,20170320,3252,3256,3284,3322,3261,3318,3298,62,42,1538,50725620,3252
313,jd1706,20170321,3318,3298,3340,3345,3311,3336,3331,38,33,1406,46833880,3908
314,jd1706,20170322,3336,3331,3337,3338,3310,3320,3319,-11,-12,586,19452740,3800
315,jd1706,20170323,3320,3319,3317,3323,3308,3321,3315,2,-4,456,15117480,3996
316,jd1706,20170324,3321,3315,3304,3323,3274,3287,3293,-28,-22,1106,36423380,4612
317,jd1706,20170327,3287,3293,3294,3305,3272,3280,3281,-13,-12,760,24941220,4944
318,jd1706,20170328,3280,3281,3298,3300,3220,3236,3253,-45,-28,1970,64084820,5684
319,jd1706,20170329,3236,3253,3237,3243,3221,3229,3227,-24,-26,678,21883540,5992
320,jd1706,20170330,3229,3227,3221,3221,3162,3171,3182,-56,-45,1356,43155060,6482
321,jd1706,20170331,3171,3182,3159,3175,3130,3162,3149,-20,-33,2396,75470180,7288
322,jd1706,20170405,3162,3149,3128,3152,3100,3117,3118,-32,-31,2272,70859540,7684
323,jd1706,20170406,3117,3118,3112,3115,3102,3107,3107,-11,-11,1332,41393940,8042
324,jd1706,20170407,3107,3107,3100,3114,3077,3080,3094,-27,-13,1744,53963080,8558
325,jd1706,20170410,3080,3094,3070,3070,3009,3019,3027,-75,-67,3096,93741540,9774
326,jd1706,20170411,3019,3027,3000,3009,2923,2976,2981,-51,-46,3082,91904780,10712
327,jd1706,20170412,2976,2981,2951,2983,2946,2953,2964,-28,-17,3598,106665640,10778
328,jd1706,20170413,2953,2964,2965,2968,2927,2935,2940,-29,-24,3788,111385640,11448
329,jd1706,20170414,2935,2940,2942,2950,2902,2904,2916,-36,-24,4374,127569820,12768
330,jd1706,20170417,2904,2916,2925,2925,2876,2901,2892,-15,-24,4758,137634300,14884
331,jd1706,20170418,2901,2892,2898,2898,2792,2799,2836,-93,-56,7388,209532440,16302
332,jd1706,20170419,2799,2836,2777,2777,2695,2695,2711,-141,-125,7916,214663320,16172
333,jd1706,20170420,2695,2711,2670,2725,2615,2694,2668,-17,-43,10888,290556240,15538
334,jd1706,20170421,2694,2668,2680,2688,2644,2655,2666,-13,-2,7070,188516600,16400
335,jd1706,20170424,2655,2666,2633,2633,2533,2533,2574,-133,-92,11276,290301360,19594
336,jd1706,20170425,2533,2574,2509,2779,2461,2604,2562,30,-12,25338,649181120,17048
337,jd1706,20170426,2604,2562,2608,2635,2595,2620,2615,58,53,9038,236351360,16672
338,jd1706,20170427,2620,2615,2636,2636,2535,2549,2567,-66,-48,12998,333751960,18300
339,jd1706,20170428,2549,2567,2530,2608,2521,2596,2570,29,3,19988,513860040,17352
340,jd1706,20170502,2596,2570,2650,2675,2613,2663,2643,93,73,13578,358997840,15408
341,jd1706,20170503,2663,2643,2672,2672,2603,2619,2627,-24,-16,10076,264764940,15290
342,jd1706,20170504,2619,2627,2618,2665,2600,2643,2641,16,14,11074,292502120,14254
343,jd1706,20170505,2643,2641,2645,2645,2571,2585,2605,-56,-36,9144,238238700,14462
344,jd1706,20170508,2585,2605,2560,2570,2475,2487,2504,-118,-101,18202,455837960,15118
345,jd1706,20170509,2487,2504,2481,2494,2449,2481,2468,-23,-36,10194,251685740,14466
346,jd1706,20170510,2481,2468,2490,2504,2466,2486,2485,18,17,8630,214477980,15000
347,jd1706,20170511,2486,2485,2502,2556,2475,2540,2518,55,33,12090,304530980,14260
348,jd1706,20170512,2540,2518,2555,2555,2490,2495,2519,-23,1,11520,290223660,14292
349,jd1706,20170515,2495,2519,2450,2450,2394,2394,2403,-125,-116,11576,278284840,12912
350,jd1706,20170516,2394,2403,2333,2340,2248,2262,2293,-141,-110,19556,448434220,13142
351,jd1706,20170517,2262,2293,2212,2278,2211,2239,2248,-54,-45,12706,285748540,12508
352,jd1706,20170518,2239,2248,2240,2295,2238,2276,2271,28,23,10950,248758360,10838
353,jd1706,20170519,2276,2271,2295,2308,2269,2286,2284,15,13,5446,124399480,10142
354,jd1706,20170522,2286,2284,2290,2290,2181,2182,2244,-102,-40,13230,296891020,9856
355,jd1706,20170523,2182,2244,2151,2200,2142,2170,2166,-74,-78,9444,204579320,7774
356,jd1706,20170524,2170,2166,2168,2199,2158,2168,2172,2,6,5902,128246200,7022
357,jd1706,20170525,2168,2172,2170,2187,2148,2148,2167,-24,-5,3944,85492040,5596
358,jd1706,20170526,2148,2167,2131,2155,2063,2068,2103,-99,-64,6256,131620000,3792
359,jd1706,20170531,2068,2103,2070,2205,2026,2092,2055,-11,-48,6946,142808220,208
360,jd1706,20170601,2092,2055,2162,2178,2162,2178,2172,123,117,104,2258900,136
361,jd1706,20170602,2178,2172,2367,2367,2150,2151,2277,-21,105,86,1958260,88
362,jd1706,20170605,2151,2277,2141,2298,2141,2150,2169,-127,-108,38,824440,78
363,jd1706,20170606,2150,2169,2250,2250,2180,2180,2206,11,37,26,573800,64
364,jd1706,20170607,2180,2206,2155,2155,2155,2155,2155,-51,-51,2,43100,58
365,jd1706,20170608,2155,2155,2284,2284,2284,2284,2284,129,129,2,45680,52
366,jd1706,20170609,2284,2284,2185,2196,2161,2196,2175,-88,-109,8,174060,48
367,jd1706,20170612,2196,2175,2200,2245,2200,2245,2215,70,40,6,132900,42
368,jd1706,20170613,2245,2215,2325,2325,2325,2325,2325,110,110,2,46500,40
369,jd1706,20170614,2325,2325,2325,2425,2211,2425,2310,100,-15,32,739220,36
370,jd1706,20170615,2425,2310,0,0,0,2310,2310,0,0,0,0,32
371,jd1706,20170616,2310,2310,0,0,0,2448,2448,138,138,0,0,28
372,jd1706,20170619,2448,2448,2668,2668,2668,2668,2668,220,220,2,53360,22
373,jd1706,20170620,2668,2668,2961,2961,2961,2961,2961,293,293,4,118440,16
374,jd1706,20170621,2961,2961,3200,3200,3200,3200,3200,239,239,8,256000,8
375,jd1706,20170622,3200,3200,0,0,0,3200,3200,0,0,0,0,8
376,jd1706,20170623,3200,3200,0,0,0,3200,3200,0,0,0,0,8
377,jd1706,20170626,3200,3200,3150,3150,3135,3135,3142,-65,-58,4,125700,4
378,jd1706,20170627,3135,3142,3130,3130,3130,3130,2625,-12,-517,4,125200,0
379,jd1707,20170103,3510,3510,0,0,0,3510,3510,0,0,0,0,32
380,jd1707,20170104,3510,3510,0,0,0,3510,3510,0,0,0,0,32
381,jd1707,20170105,3510,3510,0,0,0,3510,3510,0,0,0,0,32
382,jd1707,20170106,3510,3510,3580,3585,3524,3575,3547,65,37,38,1348200,58
383,jd1707,20170109,3575,3547,3568,3662,3568,3662,3640,115,93,28,1019280,56
384,jd1707,20170110,3662,3640,3646,3646,3643,3643,3644,3,4,8,291560,50
385,jd1707,20170111,3643,3644,3760,3765,3760,3765,3762,121,118,4,150500,48
386,jd1707,20170112,3765,3762,3702,3706,3700,3700,3701,-62,-61,12,444220,48
387,jd1707,20170113,3700,3701,3633,3633,3633,3633,3633,-68,-68,2,72660,48
388,jd1707,20170116,3633,3633,3682,3682,3682,3682,3682,49,49,2,73640,50
389,jd1707,20170117,3682,3682,0,0,0,3682,3682,0,0,0,0,50
390,jd1707,20170118,3682,3682,0,0,0,3682,3682,0,0,0,0,50
391,jd1707,20170119,3682,3682,0,0,0,3682,3682,0,0,0,0,50
392,jd1707,20170120,3682,3682,0,0,0,3682,3682,0,0,0,0,50
393,jd1707,20170123,3682,3682,0,0,0,3682,3682,0,0,0,0,50
394,jd1707,20170124,3682,3682,3666,3739,3666,3725,3716,43,34,28,1040600,72
395,jd1707,20170125,3725,3716,3675,3675,3675,3675,3675,-41,-41,2,73500,72
396,jd1707,20170126,3675,3675,0,0,0,3680,3680,5,5,0,0,72
397,jd1707,20170203,3680,3680,0,0,0,3680,3680,0,0,0,0,72
398,jd1707,20170206,3680,3680,3655,3685,3655,3656,3674,-24,-6,14,514380,80
399,jd1707,20170207,3656,3674,3655,3689,3637,3689,3660,15,-14,6,219620,82
400,jd1707,20170208,3689,3660,3686,3686,3666,3666,3676,6,16,4,147040,82
401,jd1707,20170209,3666,3676,3649,3668,3636,3668,3648,-8,-28,24,875660,90
402,jd1707,20170210,3668,3648,3608,3674,3608,3642,3643,-6,-5,44,1603320,112
403,jd1707,20170213,3642,3643,3610,3695,3610,3665,3658,22,15,116,4243820,172
404,jd1707,20170214,3665,3658,0,0,0,3658,3658,0,0,0,0,172
405,jd1707,20170215,3658,3658,3630,3638,3628,3638,3634,-20,-24,32,1163140,192
406,jd1707,20170216,3638,3634,3623,3654,3545,3600,3593,-34,-41,216,7762620,280
407,jd1707,20170217,3600,3593,3541,3579,3541,3544,3555,-49,-38,180,6399580,374
408,jd1707,20170220,3544,3555,3534,3549,3476,3544,3522,-11,-33,366,12892340,628
409,jd1707,20170221,3544,3522,3502,3552,3500,3548,3526,26,4,128,4514220,688
410,jd1707,20170222,3548,3526,3546,3570,3536,3557,3554,31,28,58,2061400,700
411,jd1707,20170223,3557,3554,3570,3587,3545,3546,3552,-8,-2,34,1207680,724
412,jd1707,20170224,3546,3552,3558,3570,3555,3570,3563,18,11,42,1496520,754
413,jd1707,20170227,3570,3563,3590,3598,3570,3595,3588,32,25,66,2368580,792
414,jd1707,20170228,3595,3588,3605,3618,3550,3592,3587,4,-1,128,4591860,860
415,jd1707,20170301,3592,3587,3550,3588,3550,3572,3566,-15,-21,128,4565740,916
416,jd1707,20170302,3572,3566,3562,3564,3550,3559,3556,-7,-10,110,3912520,998
417,jd1707,20170303,3559,3556,3566,3566,3514,3552,3547,-4,-9,136,4824880,1046
418,jd1707,20170306,3552,3547,3555,3575,3550,3557,3562,10,15,186,6625740,1140
419,jd1707,20170307,3557,3562,3552,3554,3532,3547,3545,-15,-17,162,5743380,1142
420,jd1707,20170308,3547,3545,3541,3543,3506,3530,3525,-15,-20,234,8250520,1186
421,jd1707,20170309,3530,3525,3529,3538,3525,3537,3531,12,6,80,2824920,1202
422,jd1707,20170310,3537,3531,3544,3560,3532,3532,3547,1,16,80,2838080,1236
423,jd1707,20170313,3532,3547,3580,3580,3531,3536,3540,-11,-7,90,3186580,1206
424,jd1707,20170314,3536,3540,3535,3545,3516,3545,3534,5,-6,90,3181000,1242
425,jd1707,20170315,3545,3534,3560,3560,3537,3553,3546,19,12,32,1135000,1252
426,jd1707,20170316,3553,3546,3533,3533,3490,3497,3510,-49,-36,116,4071920,1240
427,jd1707,20170317,3497,3510,3503,3510,3500,3500,3505,-10,-5,122,4276240,1310
428,jd1707,20170320,3500,3505,3539,3582,3524,3582,3562,77,57,470,16743560,1414
429,jd1707,20170321,3582,3562,3588,3595,3566,3595,3579,33,17,140,5010860,1486
430,jd1707,20170322,3595,3579,3549,3560,3519,3544,3548,-35,-31,122,4329760,1516
431,jd1707,20170323,3544,3548,3545,3560,3545,3554,3551,6,3,66,2344020,1528
432,jd1707,20170324,3554,3551,3513,3552,3513,3527,3537,-24,-14,134,4740060,1586
433,jd1707,20170327,3527,3537,3454,3540,3454,3532,3522,-5,-15,68,2395620,1618
434,jd1707,20170328,3532,3522,3532,3532,3478,3493,3499,-29,-23,210,7348100,1698
435,jd1707,20170329,3493,3499,3470,3495,3470,3495,3487,-4,-12,46,1604100,1720
436,jd1707,20170330,3495,3487,3470,3470,3426,3432,3452,-55,-35,176,6076560,1804
437,jd1707,20170331,3432,3452,3388,3441,3388,3434,3423,-18,-29,172,5888580,1858
438,jd1707,20170405,3434,3423,3425,3434,3391,3395,3407,-28,-16,286,9745980,1914
439,jd1707,20170406,3395,3407,3415,3415,3395,3395,3402,-12,-5,346,11773160,2050
440,jd1707,20170407,3395,3402,3389,3398,3361,3374,3383,-28,-19,134,4533420,2102
441,jd1707,20170410,3374,3383,3378,3378,3250,3258,3279,-125,-104,1176,38571240,2360
442,jd1707,20170411,3258,3279,3238,3238,3160,3168,3203,-111,-76,1446,46317680,3116
443,jd1707,20170412,3168,3203,3151,3188,3127,3166,3168,-37,-35,926,29343960,3058
444,jd1707,20170413,3166,3168,3151,3179,3122,3157,3153,-11,-15,1498,47235180,3584
445,jd1707,20170414,3157,3153,3156,3156,3121,3123,3135,-30,-18,608,19062680,3648
446,jd1707,20170417,3123,3135,3138,3138,3050,3099,3093,-36,-42,854,26420320,3954
447,jd1707,20170418,3099,3093,3077,3081,2950,2977,3002,-116,-91,1806,54229180,4094
448,jd1707,20170419,2977,3002,2958,2958,2852,2852,2877,-150,-125,2888,83106860,4266
449,jd1707,20170420,2852,2877,2860,2922,2860,2892,2885,15,8,3064,88413360,4648
450,jd1707,20170421,2892,2885,2890,2915,2885,2910,2899,25,14,1538,44599540,4570
451,jd1707,20170424,2910,2899,2893,2893,2756,2777,2815,-122,-84,5040,141892720,5714
452,jd1707,20170425,2777,2815,2796,2909,2742,2894,2850,79,35,5922,168791900,5490
453,jd1707,20170426,2894,2850,2890,2944,2868,2920,2906,70,56,2062,59931460,5806
454,jd1707,20170427,2920,2906,2918,2918,2843,2860,2871,-46,-35,3686,105834040,6678
455,jd1707,20170428,2860,2871,2852,2918,2802,2904,2858,33,-13,5538,158289340,7858
456,jd1707,20170502,2904,2858,2910,3000,2910,2977,2961,119,103,6566,194431660,7972
457,jd1707,20170503,2977,2961,2967,3000,2924,2927,2949,-34,-12,4576,134960240,8200
458,jd1707,20170504,2927,2949,2915,2967,2915,2948,2948,-1,-1,3764,110994160,8200
459,jd1707,20170505,2948,2948,2951,2951,2871,2885,2898,-63,-50,4922,142676220,9206
460,jd1707,20170508,2885,2898,2855,2860,2754,2758,2786,-140,-112,9938,276964220,10694
461,jd1707,20170509,2758,2786,2748,2748,2691,2702,2712,-84,-74,8144,220905340,12100
462,jd1707,20170510,2702,2712,2706,2721,2666,2686,2687,-26,-25,9508,255527460,11880
463,jd1707,20170511,2686,2687,2697,2811,2680,2791,2757,104,70,16600,457715080,11864
464,jd1707,20170512,2791,2757,2799,2834,2760,2761,2791,4,34,11128,310629680,13464
465,jd1707,20170515,2761,2791,2731,2731,2652,2652,2666,-139,-125,16486,439567580,16758
466,jd1707,20170516,2652,2666,2617,2635,2545,2558,2578,-108,-88,28922,745835340,21172
467,jd1707,20170517,2558,2578,2525,2540,2483,2487,2515,-91,-63,29762,748779860,26170
468,jd1707,20170518,2487,2515,2500,2549,2478,2523,2521,8,6,26464,667233320,22636
469,jd1707,20170519,2523,2521,2540,2566,2505,2522,2527,1,6,13458,340185660,21314
470,jd1707,20170522,2522,2527,2512,2546,2480,2483,2517,-44,-10,16204,407904260,21882
471,jd1707,20170523,2483,2517,2464,2477,2401,2438,2431,-79,-86,34128,829842020,24132
472,jd1707,20170524,2438,2431,2430,2455,2397,2406,2421,-25,-10,22574,546734340,25966
473,jd1707,20170525,2406,2421,2410,2425,2381,2391,2398,-30,-23,22348,536050800,27182
474,jd1707,20170526,2391,2398,2396,2404,2381,2397,2391,-1,-7,19988,478026160,24896
475,jd1707,20170531,2397,2391,2400,2465,2390,2426,2426,35,35,32922,798746060,26118
476,jd1707,20170601,2426,2426,2465,2547,2456,2547,2519,121,93,12818,322917720,22726
477,jd1707,20170602,2547,2519,2710,2720,2584,2642,2660,123,141,48910,1301244300,16142
478,jd1707,20170605,2642,2660,2622,2622,2527,2527,2552,-133,-108,24738,631448680,19026
479,jd1707,20170606,2527,2552,2502,2594,2501,2533,2543,-19,-9,33236,845380800,20572
480,jd1707,20170607,2533,2543,2547,2599,2530,2596,2557,53,14,18552,474436440,19472
481,jd1707,20170608,2596,2557,2629,2678,2595,2628,2630,71,73,34710,913138620,18846
482,jd1707,20170609,2628,2630,2678,2690,2565,2616,2613,-14,-17,35174,919178560,19110
483,jd1707,20170612,2616,2613,2648,2718,2606,2710,2655,97,42,24510,650812280,16728
484,jd1707,20170613,2710,2655,2715,2730,2670,2692,2698,37,43,32344,872909540,14720
485,jd1707,20170614,2692,2698,2735,2826,2720,2804,2782,106,84,36622,1019093200,12892
486,jd1707,20170615,2804,2782,2880,2921,2843,2921,2880,139,98,25790,742906200,12686
487,jd1707,20170616,2921,2880,2970,3110,2962,3069,3055,189,175,66778,2040639780,10382
488,jd1707,20170619,3069,3055,3198,3207,3118,3207,3184,152,129,45782,1458076320,13566
489,jd1707,20170620,3207,3184,3205,3345,3135,3318,3264,134,80,70614,2305112580,14578
490,jd1707,20170621,3318,3264,3355,3427,3346,3427,3408,163,144,46316,1578682880,14664
491,jd1707,20170622,3427,3408,3502,3671,3500,3599,3594,191,186,102386,3680151980,15216
492,jd1707,20170623,3599,3594,3545,3546,3415,3415,3459,-179,-135,34986,1210292560,13876
493,jd1707,20170626,3415,3459,3200,3272,3183,3183,3204,-276,-255,55652,1783303040,10250
494,jd1707,20170627,3183,3204,3148,3218,3107,3180,3164,-24,-40,47104,1490615100,6052
495,jd1707,20170628,3180,3164,3180,3200,3006,3006,3065,-158,-99,40880,1253080620,6226
496,jd1707,20170629,3006,3065,2988,3039,2941,2948,2971,-117,-94,27908,829331000,4034
497,jd1707,20170630,2948,2971,2944,3069,2907,3063,2971,92,0,18088,537400980,374
498,jd1707,20170703,3063,2971,3100,3142,2940,2983,3014,12,43,276,8319040,218
499,jd1707,20170704,2983,3014,2935,2939,2855,2910,2907,-104,-107,84,2442120,174
500,jd1707,20170705,2910,2907,2805,2867,2755,2850,2813,-57,-94,48,1350660,128
501,jd1707,20170706,2850,2813,2810,2890,2810,2883,2873,70,60,24,689620,136
502,jd1707,20170707,2883,2873,2978,2990,2905,2950,2945,77,72,24,706840,126
503,jd1707,20170710,2950,2945,2960,3099,2850,2850,2950,-95,5,48,1416300,90
504,jd1707,20170711,2850,2950,3042,3045,3042,3045,3043,95,93,14,426120,82
505,jd1707,20170712,3045,3043,2926,2926,2920,2920,2924,-123,-119,16,467880,66
506,jd1707,20170713,2920,2924,2920,2920,2890,2890,2902,-34,-22,8,232200,66
507,jd1707,20170714,2890,2902,0,0,0,2902,2902,0,0,0,0,56
508,jd1707,20170717,2902,2902,2780,2850,2780,2801,2805,-101,-97,16,448880,44
509,jd1707,20170718,2801,2805,2885,2920,2885,2920,2911,115,106,12,349360,44
510,jd1707,20170719,2920,2911,0,0,0,2911,2911,0,0,0,0,40
511,jd1707,20170720,2911,2911,3000,3005,3000,3005,3001,94,90,6,180100,38
512,jd1707,20170721,3005,3001,3100,3108,3010,3020,3067,19,66,10,306760,34
513,jd1707,20170724,3020,3067,3150,3150,3150,3150,3150,83,83,2,63000,32
514,jd1707,20170725,3150,3150,3250,3299,2970,2970,3173,-180,23,6,190380,26
515,jd1707,20170726,2970,3173,3200,3300,3200,3300,3013,127,-160,14,459620,0
516,jd1708,20170103,3771,3770,3824,3824,3822,3822,3823,52,53,4,152920,96
517,jd1708,20170104,3822,3823,3765,3793,3746,3793,3780,-30,-43,12,453660,94
518,jd1708,20170105,3793,3780,3846,3846,3846,3846,3846,66,66,2,76920,92
519,jd1708,20170106,3846,3846,0,0,0,3843,3843,-3,-3,0,0,92
520,jd1708,20170109,3843,3843,3800,3800,3800,3800,3800,-43,-43,2,76000,92
521,jd1708,20170110,3800,3800,0,0,0,3850,3850,50,50,0,0,92
522,jd1708,20170111,3850,3850,3876,3975,3876,3907,3919,57,69,8,313560,90
523,jd1708,20170112,3907,3919,0,0,0,3940,3940,21,21,0,0,90
524,jd1708,20170113,3940,3940,0,0,0,3934,3934,-6,-6,0,0,90
525,jd1708,20170116,3934,3934,0,0,0,3886,3886,-48,-48,0,0,90
526,jd1708,20170117,3886,3886,0,0,0,3886,3886,0,0,0,0,90
527,jd1708,20170118,3886,3886,0,0,0,3886,3886,0,0,0,0,90
528,jd1708,20170119,3886,3886,0,0,0,3900,3900,14,14,0,0,90
529,jd1708,20170120,3900,3900,3880,3880,3880,3880,3880,-20,-20,2,77600,92
530,jd1708,20170123,3880,3880,0,0,0,3880,3880,0,0,0,0,92
531,jd1708,20170124,3880,3880,3901,3901,3901,3901,3901,21,21,2,78020,94
532,jd1708,20170125,3901,3901,3867,3867,3867,3867,3867,-34,-34,2,77340,96
533,jd1708,20170126,3867,3867,0,0,0,3870,3870,3,3,0,0,96
534,jd1708,20170203,3870,3870,0,0,0,3836,3836,-34,-34,0,0,96
535,jd1708,20170206,3836,3836,3876,3899,3876,3899,3884,63,48,6,233080,98
536,jd1708,20170207,3899,3884,0,0,0,3843,3843,-41,-41,0,0,98
537,jd1708,20170208,3843,3843,3859,3859,3859,3859,3859,16,16,2,77180,98
538,jd1708,20170209,3859,3859,3866,3866,3843,3850,3853,-9,-6,14,539520,102
539,jd1708,20170210,3850,3853,3814,3837,3810,3836,3824,-17,-29,114,4359560,126
540,jd1708,20170213,3836,3824,3827,3857,3801,3832,3807,8,-17,118,4492620,228
541,jd1708,20170214,3832,3807,3797,3816,3796,3816,3800,9,-7,26,988100,244
542,jd1708,20170215,3816,3800,3781,3801,3781,3800,3794,0,-6,36,1365880,256
543,jd1708,20170216,3800,3794,3815,3815,3791,3807,3802,13,8,28,1064560,264
544,jd1708,20170217,3807,3802,3795,3798,3795,3796,3796,-6,-6,6,227780,268
545,jd1708,20170220,3796,3796,3782,3815,3760,3802,3785,6,-11,44,1665600,288
546,jd1708,20170221,3802,3785,3792,3827,3792,3798,3806,13,21,50,1903140,288
547,jd1708,20170222,3798,3806,3801,3830,3801,3830,3817,24,11,8,305400,288
548,jd1708,20170223,3830,3817,3811,3811,3811,3811,3811,-6,-6,2,76220,290
549,jd1708,20170224,3811,3811,3860,3860,3860,3860,3860,49,49,2,77200,288
550,jd1708,20170227,3860,3860,3830,3896,3830,3896,3857,36,-3,14,540100,284
551,jd1708,20170228,3896,3857,3920,3949,3890,3944,3910,87,53,20,782080,286
552,jd1708,20170301,3944,3910,4035,4035,3903,3903,3936,-7,26,16,629860,290
553,jd1708,20170302,3903,3936,3922,3922,3861,3861,3876,-75,-60,8,310100,288
554,jd1708,20170303,3861,3876,3862,3862,3862,3862,3862,-14,-14,2,77240,286
555,jd1708,20170306,3862,3862,3867,3886,3866,3868,3880,6,18,28,1086560,300
556,jd1708,20170307,3868,3880,3886,3886,3863,3865,3874,-15,-6,20,774980,292
557,jd1708,20170308,3865,3874,3861,3862,3845,3862,3855,-12,-19,8,308420,296
558,jd1708,20170309,3862,3855,3887,3887,3849,3854,3861,-1,6,38,1467280,290
559,jd1708,20170310,3854,3861,3876,3876,3861,3865,3866,4,5,10,386620,292
560,jd1708,20170313,3865,3866,3860,3863,3851,3863,3858,-3,-8,6,231480,296
561,jd1708,20170314,3863,3858,3856,3856,3856,3856,3856,-2,-2,2,77120,296
562,jd1708,20170315,3856,3856,3851,3851,3851,3851,3851,-5,-5,2,77020,298
563,jd1708,20170316,3851,3851,3860,3862,3816,3836,3844,-15,-7,26,999440,312
564,jd1708,20170317,3836,3844,3826,3826,3814,3815,3817,-29,-27,10,381700,320
565,jd1708,20170320,3815,3817,3832,3865,3818,3865,3844,48,27,28,1076500,330
566,jd1708,20170321,3865,3844,3879,3926,3879,3885,3898,41,54,28,1091520,320
567,jd1708,20170322,3885,3898,3848,3848,3848,3848,3848,-50,-50,2,76960,320
568,jd1708,20170323,3848,3848,0,0,0,3853,3853,5,5,0,0,320
569,jd1708,20170324,3853,3853,3867,3888,3851,3875,3861,22,8,26,1003880,318
570,jd1708,20170327,3875,3861,3866,3881,3857,3881,3864,20,3,16,618300,324
571,jd1708,20170328,3881,3864,3886,3886,3828,3832,3849,-32,-15,60,2309720,334
572,jd1708,20170329,3832,3849,3818,3836,3818,3819,3822,-30,-27,32,1223060,332
573,jd1708,20170330,3819,3822,3803,3805,3757,3757,3777,-65,-45,86,3248300,326
574,jd1708,20170331,3757,3777,3751,3764,3735,3749,3748,-28,-29,118,4423780,358
575,jd1708,20170405,3749,3748,3710,3731,3709,3723,3718,-25,-30,22,818140,368
576,jd1708,20170406,3723,3718,3710,3746,3709,3721,3725,3,7,34,1266720,382
577,jd1708,20170407,3721,3725,3701,3716,3690,3690,3701,-35,-24,184,6810580,402
578,jd1708,20170410,3690,3701,3660,3731,3629,3664,3655,-37,-46,170,6213760,414
579,jd1708,20170411,3664,3655,3653,3662,3614,3615,3632,-40,-23,148,5375720,408
580,jd1708,20170412,3615,3632,3629,3646,3616,3639,3635,7,3,110,3998540,406
581,jd1708,20170413,3639,3635,3638,3638,3565,3565,3587,-70,-48,118,4233480,394
582,jd1708,20170414,3565,3587,3547,3558,3500,3515,3521,-72,-66,188,6621260,394
583,jd1708,20170417,3515,3521,3521,3559,3491,3545,3528,24,7,134,4727680,404
584,jd1708,20170418,3545,3528,3503,3528,3352,3366,3398,-162,-130,598,20320400,580
585,jd1708,20170419,3366,3398,3335,3335,3271,3310,3298,-88,-100,2076,68485300,2002
586,jd1708,20170420,3310,3298,3301,3403,3293,3388,3340,90,42,1552,51851380,2368
587,jd1708,20170421,3388,3340,3370,3426,3355,3418,3404,78,64,586,19949280,2472
588,jd1708,20170424,3418,3404,3409,3505,3352,3386,3385,-18,-19,2222,75228100,3528
589,jd1708,20170425,3386,3385,3384,3477,3380,3460,3422,75,37,2018,69072340,3948
590,jd1708,20170426,3460,3422,3465,3520,3455,3518,3492,96,70,1534,53568580,4412
591,jd1708,20170427,3518,3492,3546,3546,3473,3502,3498,10,6,1852,64797640,4844
592,jd1708,20170428,3502,3498,3500,3610,3475,3610,3546,112,48,6478,229737180,7378
593,jd1708,20170502,3610,3546,3634,3669,3582,3615,3621,69,75,7614,275754860,10186
594,jd1708,20170503,3615,3621,3619,3619,3503,3529,3549,-92,-72,7786,276328060,10128
595,jd1708,20170504,3529,3549,3519,3569,3507,3543,3544,-6,-5,4676,165727900,10952
596,jd1708,20170505,3543,3544,3544,3555,3508,3527,3526,-17,-18,4210,148468160,12030
597,jd1708,20170508,3527,3526,3520,3520,3350,3358,3397,-168,-129,11076,376278780,13474
598,jd1708,20170509,3358,3397,3335,3355,3260,3282,3298,-115,-99,10590,349354580,13902
599,jd1708,20170510,3282,3298,3280,3329,3135,3193,3199,-105,-99,21766,696423200,15242
600,jd1708,20170511,3193,3199,3200,3265,3163,3252,3216,53,17,15618,502389240,14314
601,jd1708,20170512,3252,3216,3250,3269,3210,3210,3234,-6,18,7946,257033280,15016
602,jd1708,20170515,3210,3234,3150,3180,3073,3073,3093,-161,-141,13138,406365340,16870
603,jd1708,20170516,3073,3093,3030,3069,3002,3024,3032,-69,-61,23840,722929180,22148
604,jd1708,20170517,3024,3032,3000,3024,2900,2902,2963,-130,-69,33984,1007022580,29448
605,jd1708,20170518,2902,2963,2912,2965,2879,2927,2931,-36,-32,42646,1250318020,32136
606,jd1708,20170519,2927,2931,2951,2988,2886,2927,2920,-4,-11,35806,1045863560,37882
607,jd1708,20170522,2927,2920,2949,2985,2915,2917,2952,-3,32,35606,1051327580,39384
608,jd1708,20170523,2917,2952,2900,2935,2812,2891,2875,-61,-77,73012,2099225640,45652
609,jd1708,20170524,2891,2875,2881,2920,2873,2896,2897,21,22,30556,885258120,47898
610,jd1708,20170525,2896,2897,2901,2905,2844,2847,2864,-50,-33,36100,1034136340,50642
611,jd1708,20170526,2847,2864,2833,2864,2800,2838,2829,-26,-35,46944,1328366060,54412
612,jd1708,20170531,2838,2829,2835,2908,2825,2885,2882,56,53,49804,1435823000,60198
613,jd1708,20170601,2885,2882,2905,3026,2905,3026,2980,144,98,21222,632598060,56254
614,jd1708,20170602,3026,2980,3200,3218,3081,3181,3159,201,179,112000,3539136780,41634
615,jd1708,20170605,3181,3159,3160,3161,3041,3044,3090,-115,-69,61148,1889791620,40488
616,jd1708,20170606,3044,3090,3029,3157,3027,3093,3103,3,13,64316,1996052120,43636
617,jd1708,20170607,3093,3103,3109,3180,3093,3174,3127,71,24,49934,1561899200,48100
618,jd1708,20170608,3174,3127,3194,3258,3189,3239,3221,112,94,70014,2255794360,48876
619,jd1708,20170609,3239,3221,3275,3293,3202,3239,3238,18,17,44380,1437216700,47634
620,jd1708,20170612,3239,3238,3265,3303,3202,3300,3254,62,16,52034,1693461220,47160
621,jd1708,20170613,3300,3254,3290,3296,3250,3261,3273,7,19,39362,1288442560,44150
622,jd1708,20170614,3261,3273,3298,3349,3292,3326,3323,53,50,55062,1829730240,44240
623,jd1708,20170615,3326,3323,3360,3489,3343,3468,3426,145,103,98386,3371596660,39080
624,jd1708,20170616,3468,3426,3499,3597,3433,3474,3523,48,97,155620,5483784980,35624
625,jd1708,20170619,3474,3523,3623,3677,3542,3634,3614,111,91,134840,4873622080,39696
626,jd1708,20170620,3634,3614,3610,3688,3550,3667,3622,53,8,105780,3831587460,42440
627,jd1708,20170621,3667,3622,3720,3803,3693,3803,3760,181,138,125122,4705663700,47328
628,jd1708,20170622,3803,3760,3830,3922,3754,3784,3833,24,73,203042,7783254200,53968
629,jd1708,20170623,3784,3833,3750,3753,3642,3642,3677,-191,-156,112600,4140495340,56954
630,jd1708,20170626,3642,3677,3542,3584,3413,3528,3504,-149,-173,284748,9979780940,49958
631,jd1708,20170627,3528,3504,3535,3637,3530,3636,3591,132,87,152802,5487854880,45994
632,jd1708,20170628,3636,3591,3646,3659,3516,3593,3582,2,-9,209292,7497248500,48086
633,jd1708,20170629,3593,3582,3565,3596,3534,3537,3561,-45,-21,94410,3362385760,43466
634,jd1708,20170630,3537,3561,3527,3574,3491,3557,3531,-4,-30,101494,3583913340,42904
635,jd1708,20170703,3557,3531,3457,3484,3371,3389,3420,-142,-111,115860,3963187840,43408
636,jd1708,20170704,3389,3420,3312,3330,3249,3249,3294,-171,-126,51794,1706398400,46078
637,jd1708,20170705,3249,3294,3150,3185,3078,3153,3138,-141,-156,136914,4297162760,45862
638,jd1708,20170706,3153,3138,3180,3294,3180,3294,3251,156,113,36078,1173190700,44778
639,jd1708,20170707,3294,3251,3410,3511,3368,3487,3441,236,190,244518,8415120640,41492
640,jd1708,20170710,3487,3441,3500,3540,3334,3354,3444,-87,3,159004,5477665200,42346
641,jd1708,20170711,3354,3444,3380,3480,3376,3463,3434,19,-10,108856,3739196440,35888
642,jd1708,20170712,3463,3434,3434,3450,3335,3399,3395,-35,-39,95456,3241131900,32062
643,jd1708,20170713,3399,3395,3340,3378,3300,3304,3343,-91,-52,70376,2352883620,27994
644,jd1708,20170714,3304,3343,3269,3340,3256,3330,3294,-13,-49,59622,1964478400,27074
645,jd1708,20170717,3330,3294,3266,3408,3223,3370,3305,76,11,67834,2242346880,25128
646,jd1708,20170718,3370,3305,3358,3405,3335,3396,3372,91,67,38954,1313567640,25108
647,jd1708,20170719,3396,3372,3457,3503,3410,3479,3455,107,83,48828,1687197000,23920
648,jd1708,20170720,3479,3455,3504,3510,3358,3385,3440,-70,-15,42834,1473891280,22210
649,jd1708,20170721,3385,3440,3413,3439,3353,3371,3395,-69,-45,36106,1225931980,20910
650,jd1708,20170724,3371,3395,3356,3369,3321,3339,3340,-56,-55,24480,817807180,19494
651,jd1708,20170725,3339,3340,3400,3566,3400,3495,3482,155,142,49582,1726932320,15880
652,jd1708,20170726,3495,3482,3582,3587,3434,3467,3498,-15,16,30070,1051881460,14222
653,jd1708,20170727,3467,3498,3520,3524,3455,3475,3480,-23,-18,15428,536981460,12316
654,jd1708,20170728,3475,3480,3460,3467,3312,3417,3388,-63,-92,30974,1049657340,6634
655,jd1708,20170731,3417,3388,3525,3575,3472,3507,3512,119,124,16720,587206700,288
656,jd1708,20170801,3507,3512,3515,3530,3312,3468,3476,-44,-36,240,8344080,100
657,jd1708,20170802,3468,3476,3464,3465,3413,3413,3445,-63,-31,38,1309280,78
658,jd1708,20170803,3413,3445,3365,3407,3365,3406,3395,-39,-50,16,543340,60
659,jd1708,20170804,3406,3395,0,0,0,3428,3428,33,33,0,0,60
660,jd1708,20170807,3428,3428,3600,3650,3450,3640,3610,212,182,26,938840,54
661,jd1708,20170808,3640,3610,3655,3655,3655,3655,3655,45,45,2,73100,54
662,jd1708,20170809,3655,3655,3875,3910,3750,3850,3810,195,155,32,1219340,34
663,jd1708,20170810,3850,3810,3945,3950,3700,3700,3885,-110,75,8,310820,30
664,jd1708,20170811,3700,3885,3980,3980,3980,3980,3980,95,95,2,79600,32
665,jd1708,20170814,3980,3980,0,0,0,3980,3980,0,0,0,0,24
666,jd1708,20170815,3980,3980,3760,3830,3735,3830,3797,-150,-183,10,379700,20
667,jd1708,20170816,3830,3797,0,0,0,3797,3797,0,0,0,0,20
668,jd1708,20170817,3797,3797,0,0,0,3797,3797,0,0,0,0,16
669,jd1708,20170818,3797,3797,3978,3985,3978,3985,3980,188,183,6,238840,10
670,jd1708,20170821,3985,3980,0,0,0,3980,3980,0,0,0,0,10
671,jd1708,20170822,3980,3980,4200,4200,4200,4200,4200,220,220,4,168000,8
672,jd1708,20170823,4200,4200,3906,4000,3906,4000,3953,-200,-247,4,158120,8
673,jd1708,20170824,4000,3953,0,0,0,3953,3953,0,0,0,0,8
674,jd1708,20170825,3953,3953,0,0,0,3953,3953,0,0,0,0,8
675,jd1708,20170828,3953,3953,4100,4100,4100,4100,3968,147,15,6,246000,0
676,jd1709,20170103,4028,4022,4032,4032,4004,4026,4020,4,-2,4832,194246960,29814
677,jd1709,20170104,4026,4020,4021,4061,3974,4059,4023,39,3,13098,527058780,31496
678,jd1709,20170105,4059,4023,4059,4077,4036,4051,4057,28,34,6544,265500360,31596
679,jd1709,20170106,4051,4057,4050,4062,4020,4036,4038,-21,-19,8970,362285460,32680
680,jd1709,20170109,4036,4038,4028,4070,4023,4065,4052,27,14,9504,385122800,32946
681,jd1709,20170110,4065,4052,4069,4087,4055,4085,4074,33,22,7900,321896460,34420
682,jd1709,20170111,4085,4074,4089,4195,4089,4173,4155,99,81,16226,674302560,36230
683,jd1709,20170112,4173,4155,4166,4185,4132,4144,4155,-11,0,8666,360155900,36408
684,jd1709,20170113,4144,4155,4155,4172,4114,4122,4140,-33,-15,7478,309660700,37516
685,jd1709,20170116,4122,4140,4119,4152,4104,4141,4127,1,-13,10450,431303560,36626
686,jd1709,20170117,4141,4127,4145,4178,4088,4125,4131,-2,4,11440,472590220,38516
687,jd1709,20170118,4125,4131,4132,4145,4112,4143,4129,12,-2,7652,316018480,40022
688,jd1709,20170119,4143,4129,4144,4173,4143,4156,4161,27,32,7202,299730960,41306
689,jd1709,20170120,4156,4161,4148,4163,4122,4140,4140,-21,-21,6250,258753420,42250
690,jd1709,20170123,4140,4140,4144,4171,4130,4171,4156,31,16,7294,303179700,44962
691,jd1709,20170124,4171,4156,4175,4222,4173,4210,4199,54,43,10836,455051780,48130
692,jd1709,20170125,4210,4199,4199,4207,4182,4200,4198,1,-1,6622,277993160,47988
693,jd1709,20170126,4200,4198,4197,4215,4182,4201,4199,3,1,6086,255595840,48322
694,jd1709,20170203,4201,4199,4201,4201,4144,4166,4166,-33,-33,11094,462270180,51650
695,jd1709,20170206,4166,4166,4150,4195,4138,4184,4174,18,8,11800,492646220,56510
696,jd1709,20170207,4184,4174,4180,4193,4168,4173,4180,-1,6,5940,248333480,57042
697,jd1709,20170208,4173,4180,4172,4192,4125,4137,4158,-43,-22,22194,922919500,55940
698,jd1709,20170209,4137,4158,4136,4153,4092,4105,4112,-53,-46,23748,976654300,58396
699,jd1709,20170210,4105,4112,4108,4126,4085,4124,4106,12,-6,19584,804246200,59492
700,jd1709,20170213,4124,4106,4127,4165,4095,4155,4139,49,33,23056,954408540,62464
701,jd1709,20170214,4155,4139,4163,4163,4136,4148,4149,9,10,12380,513727040,62926
702,jd1709,20170215,4148,4149,4138,4150,4110,4131,4132,-18,-17,14274,589908420,62612
703,jd1709,20170216,4131,4132,4138,4157,4133,4142,4144,10,12,12754,528642040,62332
704,jd1709,20170217,4142,4144,4134,4153,4116,4137,4134,-7,-10,20148,833033800,63572
705,jd1709,20170220,4137,4134,4140,4184,4130,4184,4161,50,27,22174,922872220,69816
706,jd1709,20170221,4184,4161,4188,4217,4184,4200,4198,39,37,17868,750222900,71500
707,jd1709,20170222,4200,4198,4198,4266,4184,4265,4237,67,39,37318,1581474120,84202
708,jd1709,20170223,4265,4237,4283,4287,4250,4271,4264,34,27,30502,1300763720,85236
709,jd1709,20170224,4271,4264,4255,4298,4226,4294,4273,30,9,38006,1624003140,88732
710,jd1709,20170227,4294,4273,4300,4339,4285,4338,4317,65,44,37212,1606601340,95392
711,jd1709,20170228,4338,4317,4338,4365,4304,4346,4338,29,21,35464,1538687940,97300
712,jd1709,20170301,4346,4338,4359,4369,4313,4333,4332,-5,-6,23670,1025500640,97424
713,jd1709,20170302,4333,4332,4335,4350,4291,4320,4310,-12,-22,33416,1440544360,97582
714,jd1709,20170303,4320,4310,4298,4335,4270,4334,4310,24,0,33470,1442766520,102476
715,jd1709,20170306,4334,4310,4335,4337,4305,4320,4320,10,10,26428,1141785200,103576
716,jd1709,20170307,4320,4320,4305,4321,4284,4291,4302,-29,-18,30838,1326733980,100972
717,jd1709,20170308,4291,4302,4262,4287,4242,4264,4265,-38,-37,38260,1632135180,97924
718,jd1709,20170309,4264,4265,4260,4306,4254,4294,4286,29,21,39252,1682665300,103748
719,jd1709,20170310,4294,4286,4300,4331,4282,4284,4306,-2,20,39584,1704713420,103710
720,jd1709,20170313,4284,4306,4280,4313,4255,4295,4292,-11,-14,39788,1707895780,109212
721,jd1709,20170314,4295,4292,4298,4326,4284,4322,4307,30,15,38302,1649862080,113462
722,jd1709,20170315,4322,4307,4336,4350,4308,4318,4323,11,16,25926,1121039200,115546
723,jd1709,20170316,4318,4323,4322,4333,4252,4256,4280,-67,-43,63840,2732437220,115252
724,jd1709,20170317,4256,4280,4247,4253,4216,4216,4232,-64,-48,50616,2142392820,115548
725,jd1709,20170320,4216,4232,4229,4270,4225,4266,4250,34,18,49084,2086464480,119984
726,jd1709,20170321,4266,4250,4270,4313,4256,4293,4290,43,40,61214,2626101200,126276
727,jd1709,20170322,4293,4290,4293,4295,4257,4268,4273,-22,-17,47414,2026251840,121706
728,jd1709,20170323,4268,4273,4271,4292,4260,4282,4274,9,1,43278,1849805660,123204
729,jd1709,20170324,4282,4274,4280,4305,4274,4295,4290,21,16,49074,2105650020,124956
730,jd1709,20170327,4295,4290,4295,4330,4276,4329,4302,39,12,67606,2908459480,131458
731,jd1709,20170328,4329,4302,4340,4353,4253,4254,4297,-48,-5,92498,3975114260,124248
732,jd1709,20170329,4254,4297,4261,4269,4227,4262,4247,-35,-50,64368,2734067080,127544
733,jd1709,20170330,4262,4247,4261,4261,4095,4099,4158,-148,-89,149380,6211601900,121254
734,jd1709,20170331,4099,4158,4099,4108,4002,4030,4055,-128,-103,136198,5523550620,119100
735,jd1709,20170405,4030,4055,4025,4054,4008,4019,4032,-36,-23,76104,3068909920,124336
736,jd1709,20170406,4019,4032,4020,4036,3996,4018,4013,-14,-19,85382,3427172140,135334
737,jd1709,20170407,4018,4013,4001,4034,3968,3992,4003,-21,-10,96026,3844303000,137198
738,jd1709,20170410,3992,4003,3992,3994,3910,3930,3933,-73,-70,132136,5197977560,151074
739,jd1709,20170411,3930,3933,3917,3948,3901,3918,3929,-15,-4,83022,3262131700,154962
740,jd1709,20170412,3918,3929,3918,3970,3911,3926,3945,-3,16,121708,4802308960,162776
741,jd1709,20170413,3926,3945,3918,3935,3846,3881,3879,-64,-66,190402,7386028180,174656
742,jd1709,20170414,3881,3879,3891,3899,3858,3867,3870,-12,-9,82744,3202907600,175246
743,jd1709,20170417,3867,3870,3879,3947,3845,3932,3900,62,30,186490,7274189280,174644
744,jd1709,20170418,3932,3900,3920,3935,3858,3879,3894,-21,-6,144130,5613639700,172356
745,jd1709,20170419,3879,3894,3850,3867,3722,3759,3777,-135,-117,259914,9816986540,188306
746,jd1709,20170420,3759,3777,3755,3818,3716,3809,3765,32,-12,212166,7988658980,180742
747,jd1709,20170421,3809,3765,3799,3827,3782,3810,3804,45,39,124502,4736517000,179462
748,jd1709,20170424,3810,3804,3783,3836,3752,3785,3791,-19,-13,201652,7646607120,189304
749,jd1709,20170425,3785,3791,3780,3854,3772,3851,3819,60,28,202014,7716137420,193898
750,jd1709,20170426,3851,3819,3858,3920,3851,3917,3884,98,65,230768,8964044300,184466
751,jd1709,20170427,3917,3884,3918,3925,3851,3885,3881,1,-3,182550,7085076380,184300
752,jd1709,20170428,3885,3881,3880,3942,3866,3931,3908,50,27,160054,6255980160,181782
753,jd1709,20170502,3931,3908,3968,3968,3906,3928,3930,20,22,131062,5151504740,183516
754,jd1709,20170503,3928,3930,3920,3935,3839,3841,3875,-89,-55,204386,7920929460,189650
755,jd1709,20170504,3841,3875,3820,3875,3811,3846,3842,-29,-33,190900,7335464520,185424
756,jd1709,20170505,3846,3842,3819,3849,3811,3832,3829,-10,-13,114490,4384109840,182070
757,jd1709,20170508,3832,3829,3830,3832,3638,3638,3703,-191,-126,408382,15123782520,228446
758,jd1709,20170509,3638,3703,3630,3630,3560,3593,3592,-110,-111,379428,13631471280,241496
759,jd1709,20170510,3593,3592,3600,3626,3571,3597,3593,5,1,240552,8644019640,246278
760,jd1709,20170511,3597,3593,3599,3638,3552,3620,3603,27,10,324894,11707994180,237260
761,jd1709,20170512,3620,3603,3610,3645,3585,3598,3616,-5,13,212612,7688160280,237066
762,jd1709,20170515,3598,3616,3570,3586,3508,3525,3530,-91,-86,350346,12368081220,271928
763,jd1709,20170516,3525,3530,3500,3558,3463,3530,3521,0,-9,244386,8605344400,273452
764,jd1709,20170517,3530,3521,3521,3555,3500,3505,3527,-16,6,279312,9853199140,290554
765,jd1709,20170518,3505,3527,3498,3547,3482,3535,3524,8,-3,278620,9820092000,289726
766,jd1709,20170519,3535,3524,3540,3575,3504,3513,3531,-11,7,272294,9616256100,291602
767,jd1709,20170522,3513,3531,3521,3578,3484,3532,3545,1,14,354922,12583134300,293344
768,jd1709,20170523,3532,3545,3523,3541,3503,3518,3523,-27,-22,335930,11835474320,313584
769,jd1709,20170524,3518,3523,3515,3561,3515,3540,3540,17,17,289440,10248550800,313694
770,jd1709,20170525,3540,3540,3540,3555,3516,3524,3532,-16,-8,239812,8470442340,317386
771,jd1709,20170526,3524,3532,3514,3528,3402,3421,3442,-111,-90,518934,17865262880,349802
772,jd1709,20170531,3421,3442,3420,3456,3367,3376,3417,-66,-25,342862,11716158520,336640
773,jd1709,20170601,3376,3417,3400,3587,3398,3587,3534,170,117,729792,25794560560,310918
774,jd1709,20170602,3587,3534,3604,3648,3564,3622,3602,88,68,593304,21372073340,272440
775,jd1709,20170605,3622,3602,3620,3620,3551,3564,3574,-38,-28,290698,10392387100,270984
776,jd1709,20170606,3564,3574,3557,3642,3553,3588,3604,14,30,479862,17295117880,270958
777,jd1709,20170607,3588,3604,3588,3621,3565,3615,3591,11,-13,286800,10301613720,277528
778,jd1709,20170608,3615,3591,3623,3685,3616,3677,3661,86,70,448290,16413749820,288868
779,jd1709,20170609,3677,3661,3700,3706,3650,3681,3676,20,15,249064,9156076040,278756
780,jd1709,20170612,3681,3676,3700,3734,3653,3728,3695,52,19,374548,13839823140,282680
781,jd1709,20170613,3728,3695,3718,3738,3702,3727,3722,32,27,286686,10670916620,286690
782,jd1709,20170614,3727,3722,3735,3750,3705,3725,3724,3,2,310386,11559364580,287256
783,jd1709,20170615,3725,3724,3740,3810,3726,3784,3767,60,43,435806,16418022740,299288
784,jd1709,20170616,3784,3767,3804,3862,3788,3811,3818,44,51,537942,20538744520,274540
785,jd1709,20170619,3811,3818,3900,3965,3884,3956,3932,138,114,569154,22383082080,293694
786,jd1709,20170620,3956,3932,3958,3980,3917,3970,3941,38,9,351912,13870284400,303726
787,jd1709,20170621,3970,3941,3989,4047,3963,4044,3998,103,57,580420,23205991200,357860
788,jd1709,20170622,4044,3998,4044,4075,4002,4027,4037,29,39,698428,28201155240,331524
789,jd1709,20170623,4027,4037,4017,4017,3898,3931,3943,-106,-94,790810,31186726200,302398
790,jd1709,20170626,3931,3943,3869,3988,3842,3982,3934,39,-9,643202,25306004960,316992
791,jd1709,20170627,3982,3934,3980,4040,3967,4040,4005,106,71,531150,21274462120,316504
792,jd1709,20170628,4040,4005,4050,4059,3984,4030,4020,25,15,540622,21738357660,326866
793,jd1709,20170629,4030,4020,4015,4050,4001,4019,4020,-1,0,372192,14963426540,315274
794,jd1709,20170630,4019,4020,4010,4033,3942,4022,3991,2,-29,569204,22718341120,312148
795,jd1709,20170703,4022,3991,3950,4023,3950,4004,3996,13,5,352536,14090524560,310560
796,jd1709,20170704,4004,3996,3970,3979,3797,3797,3868,-199,-128,648196,25073108320,273646
797,jd1709,20170705,3797,3868,3756,3813,3737,3788,3775,-80,-93,488322,18438226360,243952
798,jd1709,20170706,3788,3775,3800,3963,3800,3963,3920,188,145,601182,23571010040,280046
799,jd1709,20170707,3963,3920,3965,4018,3922,3962,3967,42,47,641980,25469137960,242662
800,jd1709,20170710,3962,3967,3950,4029,3908,3924,3971,-43,4,419638,16667638560,235738
801,jd1709,20170711,3924,3971,3949,3989,3937,3967,3963,-4,-8,281980,11176648360,229664
802,jd1709,20170712,3967,3963,3960,3968,3843,3893,3897,-70,-66,581690,22672201960,229182
803,jd1709,20170713,3893,3897,3879,3895,3858,3874,3877,-23,-20,231132,8962250380,222094
804,jd1709,20170714,3874,3877,3850,3932,3816,3922,3892,45,15,346582,13489322000,226848
805,jd1709,20170717,3922,3892,3895,3978,3862,3941,3915,49,23,354156,13865429800,221768
806,jd1709,20170718,3941,3915,3955,4010,3942,3980,3978,65,63,298276,11866502340,221360
807,jd1709,20170719,3980,3978,4010,4044,3980,4014,4009,36,31,261010,10466394640,219418
808,jd1709,20170720,4014,4009,4020,4027,3960,3972,3996,-37,-13,246308,9842519180,217380
809,jd1709,20170721,3972,3996,3982,3998,3956,3969,3975,-27,-21,185056,7357256840,213438
810,jd1709,20170724,3969,3975,3948,3949,3868,3897,3893,-78,-82,252108,9815030040,209124
811,jd1709,20170725,3897,3893,3941,4025,3930,3990,3985,97,92,347104,13833468780,202720
812,jd1709,20170726,3990,3985,4020,4034,3903,3949,3970,-36,-15,279662,11104332400,184578
813,jd1709,20170727,3949,3970,3970,3990,3928,3957,3962,-13,-8,154600,6126352140,179016
814,jd1709,20170728,3957,3962,3948,3983,3860,3897,3912,-65,-50,299160,11704422180,167040
815,jd1709,20170731,3897,3912,4005,4075,3941,4032,4008,120,96,363510,14569604740,141488
816,jd1709,20170801,4032,4008,4016,4030,3970,3982,3995,-26,-13,162898,6509283980,128182
817,jd1709,20170802,3982,3995,3950,3988,3920,3956,3959,-39,-36,119882,4747230960,118556
818,jd1709,20170803,3956,3959,3954,3983,3926,3941,3955,-18,-4,118650,4693533400,112180
819,jd1709,20170804,3941,3955,3980,4055,3970,4008,4013,53,58,194158,7792615460,105088
820,jd1709,20170807,4008,4013,4088,4169,4024,4038,4069,25,56,116376,4735620720,84612
821,jd1709,20170808,4038,4069,4024,4062,4011,4059,4043,-10,-26,54666,2210324600,74620
822,jd1709,20170809,4059,4043,4060,4165,4055,4157,4117,114,74,94950,3909383180,61132
823,jd1709,20170810,4157,4117,4150,4283,4121,4272,4210,155,93,96530,4064535940,52938
824,jd1709,20170811,4272,4210,4300,4329,4235,4313,4275,103,65,76784,3282968940,43076
825,jd1709,20170814,4313,4275,4250,4289,4201,4259,4248,-16,-27,47382,2012829880,33416
826,jd1709,20170815,4259,4248,4279,4279,4215,4248,4243,0,-5,23030,977301900,31440
827,jd1709,20170816,4248,4243,4285,4297,4254,4273,4271,30,28,13876,592717880,30164
828,jd1709,20170817,4273,4271,4266,4269,4148,4148,4191,-123,-80,25504,1068876740,25522
829,jd1709,20170818,4148,4191,4150,4195,4138,4164,4167,-27,-24,13576,565836160,22948
830,jd1709,20170821,4164,4167,4201,4265,4195,4251,4232,84,65,10812,457611420,20368
831,jd1709,20170822,4251,4232,4239,4260,4199,4205,4234,-27,2,6510,275669760,18370
832,jd1709,20170823,4205,4234,4181,4188,4090,4101,4130,-133,-104,12306,508284680,15200
833,jd1709,20170824,4101,4130,4106,4126,4020,4050,4065,-80,-65,8952,363954800,12516
834,jd1709,20170825,4050,4065,4045,4061,3984,3993,4012,-72,-53,8434,338451860,9656
835,jd1709,20170828,3993,4012,3992,4037,3935,4019,3987,7,-25,5384,214693080,8446
836,jd1709,20170829,4019,3987,4058,4063,3996,4015,4018,28,31,3808,153022980,6908
837,jd1709,20170830,4015,4018,4014,4025,3986,3999,4000,-19,-18,4354,174203440,4710
838,jd1709,20170831,3999,4000,4000,4065,3983,4059,4024,59,24,6394,257327320,522
839,jd1709,20170901,4059,4024,4059,4120,3980,4116,4057,92,33,398,16146900,194
840,jd1709,20170904,4116,4057,3999,4100,3999,4100,4091,43,34,24,981880,174
841,jd1709,20170905,4100,4091,4199,4199,4088,4088,4143,-3,52,8,331480,170
842,jd1709,20170906,4088,4143,4250,4250,4109,4249,4214,106,71,8,337140,170
843,jd1709,20170907,4249,4214,3920,4508,3920,4250,4194,36,-20,16,671160,170
844,jd1709,20170908,4250,4194,4230,4230,4230,4230,4230,36,36,2,84600,170
845,jd1709,20170911,4230,4230,4200,4200,4200,4200,4200,-30,-30,2,84000,170
846,jd1709,20170912,4200,4200,0,0,0,4200,4200,0,0,0,0,170
847,jd1709,20170913,4200,4200,0,0,0,4200,4200,0,0,0,0,170
848,jd1709,20170914,4200,4200,4100,4494,4000,4150,4121,-50,-79,32,1318880,178
849,jd1709,20170915,4150,4121,4290,4290,4280,4280,4287,159,166,14,600200,168
850,jd1709,20170918,4280,4287,4120,4120,4120,4120,4120,-167,-167,10,412000,168
851,jd1709,20170919,4120,4120,0,0,0,4120,4120,0,0,0,0,168
852,jd1709,20170920,4120,4120,4008,4150,4008,4150,4079,30,-41,4,163160,164
853,jd1709,20170921,4150,4079,4200,4200,4050,4199,4162,120,83,16,665960,156
854,jd1709,20170922,4199,4162,0,0,0,4162,4162,0,0,0,0,106
855,jd1709,20170925,4162,4162,3871,4000,3871,3871,3899,-291,-263,126,4913740,10
856,jd1709,20170926,3871,3899,3996,4250,3996,4250,4001,351,102,8,329840,0
857,jd1710,20170103,3618,3618,0,0,0,3618,3618,0,0,0,0,46
858,jd1710,20170104,3618,3618,3578,3671,3578,3671,3624,53,6,8,289980,48
859,jd1710,20170105,3671,3624,0,0,0,3624,3624,0,0,0,0,48
860,jd1710,20170106,3624,3624,0,0,0,3625,3625,1,1,0,0,48
861,jd1710,20170109,3625,3625,0,0,0,3625,3625,0,0,0,0,48
862,jd1710,20170110,3625,3625,3679,3679,3661,3661,3667,36,42,6,220020,46
863,jd1710,20170111,3661,3667,3721,3787,3719,3720,3736,53,69,14,523120,48
864,jd1710,20170112,3720,3736,0,0,0,3736,3736,0,0,0,0,48
865,jd1710,20170113,3736,3736,3754,3754,3700,3700,3718,-36,-18,6,223080,48
866,jd1710,20170116,3700,3718,3716,3750,3706,3734,3737,16,19,22,822140,50
867,jd1710,20170117,3734,3737,3700,3713,3690,3690,3700,-47,-37,14,518120,52
868,jd1710,20170118,3690,3700,3717,3717,3701,3701,3708,1,8,6,222500,54
869,jd1710,20170119,3701,3708,3735,3780,3724,3724,3750,16,42,14,525000,56
870,jd1710,20170120,3724,3750,3715,3715,3713,3713,3713,-37,-37,8,297100,56
871,jd1710,20170123,3713,3713,3724,3724,3724,3724,3724,11,11,2,74480,56
872,jd1710,20170124,3724,3724,3781,3782,3780,3781,3781,57,57,8,302480,56
873,jd1710,20170125,3781,3781,3848,3848,3743,3743,3803,-38,22,10,380320,60
874,jd1710,20170126,3743,3803,3745,3774,3745,3774,3754,-29,-49,6,225280,58
875,jd1710,20170203,3774,3754,0,0,0,3754,3754,0,0,0,0,58
876,jd1710,20170206,3754,3754,3751,3787,3751,3786,3774,32,20,6,226480,60
877,jd1710,20170207,3786,3774,3772,3796,3772,3796,3780,22,6,6,226820,62
878,jd1710,20170208,3796,3780,3786,3786,3730,3732,3754,-48,-26,18,675840,60
879,jd1710,20170209,3732,3754,0,0,0,3749,3749,-5,-5,0,0,60
880,jd1710,20170210,3749,3749,0,0,0,3746,3746,-3,-3,0,0,60
881,jd1710,20170213,3746,3746,3776,3776,3753,3753,3764,7,18,4,150580,60
882,jd1710,20170214,3753,3764,3780,3793,3771,3793,3781,29,17,12,453740,60
883,jd1710,20170215,3793,3781,3775,3778,3755,3778,3773,-3,-8,20,754700,66
884,jd1710,20170216,3778,3773,3775,3775,3775,3775,3775,2,2,2,75500,66
885,jd1710,20170217,3775,3775,3770,3770,3763,3763,3768,-12,-7,8,301460,66
886,jd1710,20170220,3763,3768,3799,3800,3795,3799,3798,31,30,14,531840,70
887,jd1710,20170221,3799,3798,3811,3837,3801,3823,3813,25,15,28,1067700,86
888,jd1710,20170222,3823,3813,3807,3869,3807,3869,3862,56,49,104,4016860,120
889,jd1710,20170223,3869,3862,3872,3872,3851,3862,3863,0,1,32,1236460,122
890,jd1710,20170224,3862,3863,3878,3958,3874,3900,3910,37,47,24,938460,126
891,jd1710,20170227,3900,3910,3949,3955,3867,3867,3930,-43,20,12,471640,124
892,jd1710,20170228,3867,3930,3916,3946,3861,3928,3927,-2,-3,38,1492560,132
893,jd1710,20170301,3928,3927,3913,3922,3913,3922,3915,-5,-12,12,469860,140
894,jd1710,20170302,3922,3915,3871,3915,3871,3915,3899,0,-16,10,389980,142
895,jd1710,20170303,3915,3899,3908,3914,3902,3914,3908,15,9,10,390800,138
896,jd1710,20170306,3914,3908,3900,3924,3900,3902,3907,-6,-1,12,468920,144
897,jd1710,20170307,3902,3907,3900,3904,3885,3886,3894,-21,-13,24,934700,148
898,jd1710,20170308,3886,3894,3879,3879,3823,3825,3846,-69,-48,74,2846560,182
899,jd1710,20170309,3825,3846,3869,3887,3863,3870,3871,24,25,30,1161580,178
900,jd1710,20170310,3870,3871,3892,3892,3857,3865,3872,-6,1,36,1394120,194
901,jd1710,20170313,3865,3872,3827,3866,3827,3846,3852,-26,-20,14,539340,192
902,jd1710,20170314,3846,3852,3947,3947,3850,3871,3873,19,21,56,2169140,220
903,jd1710,20170315,3871,3873,3890,3890,3877,3877,3880,4,7,16,620880,224
904,jd1710,20170316,3877,3880,3864,3864,3810,3811,3829,-69,-51,46,1761440,236
905,jd1710,20170317,3811,3829,3809,3817,3794,3795,3800,-34,-29,40,1520160,236
906,jd1710,20170320,3795,3800,3815,3844,3807,3844,3823,44,23,26,994200,242
907,jd1710,20170321,3844,3823,3857,3900,3838,3900,3875,77,52,64,2480080,258
908,jd1710,20170322,3900,3875,3863,3872,3850,3872,3863,-3,-12,46,1777120,270
909,jd1710,20170323,3872,3863,3870,3872,3870,3871,3871,8,8,20,774200,258
910,jd1710,20170324,3871,3871,3873,3900,3851,3890,3883,19,12,20,776600,260
911,jd1710,20170327,3890,3883,3957,3957,3880,3891,3902,8,19,18,702420,258
912,jd1710,20170328,3891,3902,3920,3920,3872,3872,3895,-30,-7,82,3194420,280
913,jd1710,20170329,3872,3895,3861,3878,3839,3855,3850,-40,-45,60,2310320,280
914,jd1710,20170330,3855,3850,3853,3853,3700,3700,3762,-150,-88,178,6697980,362
915,jd1710,20170331,3700,3762,3700,3700,3659,3669,3678,-93,-84,84,3090260,384
916,jd1710,20170405,3669,3678,3660,3691,3652,3688,3675,10,-3,74,2720020,418
917,jd1710,20170406,3688,3675,3650,3693,3650,3692,3684,17,9,24,884160,424
918,jd1710,20170407,3692,3684,3693,3719,3685,3695,3697,11,13,44,1626820,424
919,jd1710,20170410,3695,3697,3666,3679,3658,3679,3670,-18,-27,194,7120160,460
920,jd1710,20170411,3679,3670,3652,3694,3652,3679,3675,9,5,52,1911500,474
921,jd1710,20170412,3679,3675,3683,3733,3683,3697,3701,22,26,64,2369220,496
922,jd1710,20170413,3697,3701,3680,3690,3670,3683,3677,-18,-24,148,5443320,486
923,jd1710,20170414,3683,3677,3673,3699,3672,3688,3686,11,9,110,4055380,480
924,jd1710,20170417,3688,3686,3680,3708,3679,3698,3692,12,6,44,1624780,472
925,jd1710,20170418,3698,3692,3685,3693,3642,3648,3675,-44,-17,224,8233980,488
926,jd1710,20170419,3648,3675,3658,3658,3554,3570,3604,-105,-71,272,9803040,482
927,jd1710,20170420,3570,3604,3543,3594,3543,3578,3568,-26,-36,430,15345540,662
928,jd1710,20170421,3578,3568,3599,3599,3569,3593,3582,25,14,64,2292720,680
929,jd1710,20170424,3593,3582,3584,3588,3561,3586,3578,4,-4,216,7730260,722
930,jd1710,20170425,3586,3578,3587,3619,3575,3618,3597,40,19,176,6332240,770
931,jd1710,20170426,3618,3597,3633,3650,3609,3650,3636,53,39,224,8145700,838
932,jd1710,20170427,3650,3636,3650,3673,3612,3626,3632,-10,-4,142,5158660,820
933,jd1710,20170428,3626,3632,3635,3661,3635,3661,3654,29,22,102,3727180,856
934,jd1710,20170502,3661,3654,3670,3696,3670,3696,3686,42,32,490,18061780,1074
935,jd1710,20170503,3696,3686,3684,3690,3650,3683,3674,-3,-12,338,12420620,1156
936,jd1710,20170504,3683,3674,3680,3699,3644,3654,3677,-20,3,946,34786360,1784
937,jd1710,20170505,3654,3677,3678,3678,3637,3642,3651,-35,-26,702,25631940,2254
938,jd1710,20170508,3642,3651,3630,3630,3470,3472,3558,-179,-93,2190,77935160,3650
939,jd1710,20170509,3472,3558,3468,3479,3408,3415,3432,-143,-126,2928,100507140,5188
940,jd1710,20170510,3415,3432,3402,3455,3338,3368,3388,-64,-44,2312,78341780,6126
941,jd1710,20170511,3368,3388,3378,3384,3320,3359,3354,-29,-34,2656,89103560,6934
942,jd1710,20170512,3359,3354,3354,3387,3215,3351,3349,-3,-5,1336,44747620,7178
943,jd1710,20170515,3351,3349,3341,3341,3258,3266,3287,-83,-62,2616,86000040,8032
944,jd1710,20170516,3266,3287,3258,3302,3250,3301,3279,14,-8,1924,63093920,8158
945,jd1710,20170517,3301,3279,3308,3349,3280,3346,3327,67,48,1956,65081940,8604
946,jd1710,20170518,3346,3327,3330,3415,3302,3413,3376,86,49,2274,76775060,9202
947,jd1710,20170519,3413,3376,3425,3484,3425,3463,3452,87,76,5518,190492000,10364
948,jd1710,20170522,3463,3452,3452,3489,3430,3463,3457,11,5,4430,153170260,10724
949,jd1710,20170523,3463,3457,3485,3485,3443,3474,3464,17,7,3902,135173000,11592
950,jd1710,20170524,3474,3464,3464,3500,3464,3496,3487,32,23,2500,87179340,12646
951,jd1710,20170525,3496,3487,3497,3518,3436,3444,3467,-43,-20,4534,157195600,12454
952,jd1710,20170526,3444,3467,3440,3451,3352,3369,3383,-98,-84,4438,150144420,12492
953,jd1710,20170531,3369,3383,3370,3432,3277,3352,3378,-31,-5,5166,174549080,13830
954,jd1710,20170601,3352,3378,3368,3546,3368,3546,3509,168,131,9090,319048700,13512
955,jd1710,20170602,3546,3509,3567,3638,3503,3529,3550,20,41,8334,295896380,12974
956,jd1710,20170605,3529,3550,3545,3550,3474,3482,3494,-68,-56,4132,144408140,13522
957,jd1710,20170606,3482,3494,3475,3538,3475,3508,3514,14,20,3860,135671760,13876
958,jd1710,20170607,3508,3514,3504,3538,3504,3535,3520,21,6,2266,79772040,14004
959,jd1710,20170608,3535,3520,3556,3589,3541,3585,3570,65,50,3672,131109100,14320
960,jd1710,20170609,3585,3570,3608,3614,3566,3605,3595,35,25,3310,119007080,14812
961,jd1710,20170612,3605,3595,3580,3636,3574,3636,3607,41,12,4170,150413780,15388
962,jd1710,20170613,3636,3607,3628,3661,3607,3648,3638,41,31,4302,156549740,15352
963,jd1710,20170614,3648,3638,3678,3679,3647,3674,3666,36,28,3194,117107460,15718
964,jd1710,20170615,3674,3666,3695,3734,3678,3725,3706,59,40,5550,205694260,15436
965,jd1710,20170616,3725,3706,3758,3758,3670,3671,3728,-35,22,7286,271644480,15496
966,jd1710,20170619,3671,3728,3802,3802,3710,3759,3752,31,24,6684,250793380,15360
967,jd1710,20170620,3759,3752,3759,3760,3708,3758,3742,6,-10,4272,159859420,15118
968,jd1710,20170621,3758,3742,3770,3928,3766,3918,3837,176,95,15530,596006240,14658
969,jd1710,20170622,3918,3837,3920,3930,3800,3818,3879,-19,42,21226,823372120,15906
970,jd1710,20170623,3818,3879,3818,3818,3702,3734,3748,-145,-131,16862,631996060,15460
971,jd1710,20170626,3734,3748,3688,3838,3630,3830,3770,82,22,17906,675214480,16578
972,jd1710,20170627,3830,3770,3804,3895,3803,3881,3859,111,89,17312,668148500,18898
973,jd1710,20170628,3881,3859,3868,3904,3840,3886,3872,27,13,14818,573859580,21332
974,jd1710,20170629,3886,3872,3878,3897,3854,3862,3873,-10,1,8004,309995360,21038
975,jd1710,20170630,3862,3873,3860,3866,3803,3849,3834,-24,-39,11530,442175280,21504
976,jd1710,20170703,3849,3834,3825,3843,3765,3820,3823,-14,-11,7286,278578620,21078
977,jd1710,20170704,3820,3823,3793,3805,3632,3632,3686,-191,-137,21742,801550180,22156
978,jd1710,20170705,3632,3686,3626,3679,3585,3660,3633,-26,-53,15868,576547460,21614
979,jd1710,20170706,3660,3633,3649,3814,3647,3814,3785,181,152,24240,917495680,23498
980,jd1710,20170707,3814,3785,3848,3896,3791,3817,3825,32,40,21370,817502700,22476
981,jd1710,20170710,3817,3825,3866,3870,3743,3775,3827,-50,2,14402,551306620,22984
982,jd1710,20170711,3775,3827,3794,3835,3781,3821,3814,-6,-13,8324,317530080,23314
983,jd1710,20170712,3821,3814,3803,3815,3726,3769,3769,-45,-45,11442,431298620,22964
984,jd1710,20170713,3769,3769,3765,3775,3736,3738,3750,-31,-19,6122,229590320,22578
985,jd1710,20170714,3738,3750,3725,3799,3710,3790,3757,40,7,7198,270467280,22582
986,jd1710,20170717,3790,3757,3794,3851,3744,3837,3803,80,46,10592,402862180,23358
987,jd1710,20170718,3837,3803,3828,3882,3828,3859,3855,56,52,7930,305729900,24232
988,jd1710,20170719,3859,3855,3900,3910,3855,3885,3882,30,27,9090,352936240,24278
989,jd1710,20170720,3885,3882,3894,3896,3832,3840,3863,-42,-19,7624,294559640,24982
990,jd1710,20170721,3840,3863,3858,3868,3824,3835,3843,-28,-20,6004,230737600,24844
991,jd1710,20170724,3835,3843,3820,3825,3776,3807,3802,-36,-41,8350,317514600,24022
992,jd1710,20170725,3807,3802,3841,3893,3840,3870,3868,68,66,10924,422639720,24286
993,jd1710,20170726,3870,3868,3905,3924,3852,3872,3890,4,22,14168,551190460,26010
994,jd1710,20170727,3872,3890,3889,3894,3873,3891,3886,1,-4,6954,270276740,28166
995,jd1710,20170728,3891,3886,3886,3905,3840,3860,3865,-26,-21,9446,365100880,28692
996,jd1710,20170731,3860,3865,3948,3976,3900,3923,3920,58,55,19500,764477000,34012
997,jd1710,20170801,3923,3920,3945,3945,3867,3867,3894,-53,-26,15822,616132240,37906
998,jd1710,20170802,3867,3894,3837,3878,3782,3862,3856,-32,-38,10662,411154740,37652
999,jd1710,20170803,3862,3856,3865,3869,3843,3848,3856,-8,0,9480,365613000,39000
1000,jd1710,20170804,3848,3856,3862,3957,3858,3939,3915,83,59,25782,1009469000,35844
1001,jd1710,20170807,3939,3915,4000,4039,3975,3986,4010,71,95,22810,914735740,33528
1002,jd1710,20170808,3986,4010,3988,4059,3970,4044,4012,34,2,16712,670547040,33072
1003,jd1710,20170809,4044,4012,4055,4268,4046,4248,4178,236,166,36642,1531077160,31140
1004,jd1710,20170810,4248,4178,4248,4300,4189,4299,4250,121,72,24562,1043934060,32996
1005,jd1710,20170811,4299,4250,4310,4449,4265,4440,4345,190,95,45192,1963753500,36798
1006,jd1710,20170814,4440,4345,4399,4428,4324,4376,4374,31,29,38140,1668254100,36410
1007,jd1710,20170815,4376,4374,4381,4383,4289,4321,4327,-53,-47,26492,1146515360,36464
1008,jd1710,20170816,4321,4327,4358,4368,4326,4346,4346,19,19,18874,820287440,35546
1009,jd1710,20170817,4346,4346,4350,4350,4189,4194,4241,-152,-105,35262,1495576200,36528
1010,jd1710,20170818,4194,4241,4200,4269,4163,4179,4213,-62,-28,30156,1270624960,36076
1011,jd1710,20170821,4179,4213,4214,4281,4207,4255,4250,42,37,20640,877234880,34646
1012,jd1710,20170822,4255,4250,4255,4275,4201,4218,4237,-32,-13,14148,599547020,34170
1013,jd1710,20170823,4218,4237,4180,4180,4015,4021,4060,-216,-177,29276,1188760100,34194
1014,jd1710,20170824,4021,4060,4021,4054,3961,3991,3999,-69,-61,20244,809728220,33354
1015,jd1710,20170825,3991,3999,3991,4050,3931,3967,3978,-32,-21,36104,1436563940,33432
1016,jd1710,20170828,3967,3978,3882,3979,3877,3955,3941,-23,-37,18210,717832140,32730
1017,jd1710,20170829,3955,3941,3970,4011,3966,3988,3985,47,44,18544,739109000,30744
1018,jd1710,20170830,3988,3985,4008,4028,3893,3903,3948,-82,-37,22720,897099280,29568
1019,jd1710,20170831,3903,3948,3876,3890,3806,3817,3844,-131,-104,28086,1079692580,27270
1020,jd1710,20170901,3817,3844,3850,3893,3802,3807,3844,-37,0,19600,753467020,27284
1021,jd1710,20170904,3807,3844,3870,3905,3840,3870,3875,26,31,15870,615092500,25140
1022,jd1710,20170905,3870,3875,3910,3928,3870,3893,3891,18,16,14160,550969180,24442
1023,jd1710,20170906,3893,3891,3935,3948,3908,3938,3928,47,37,11700,459649000,22534
1024,jd1710,20170907,3938,3928,3900,3914,3839,3847,3872,-81,-56,15166,587228920,20086
1025,jd1710,20170908,3847,3872,3845,3855,3768,3781,3804,-91,-68,12036,457885660,18916
1026,jd1710,20170911,3781,3804,3772,3817,3766,3797,3791,-7,-13,8528,323296480,17476
1027,jd1710,20170912,3797,3791,3807,3818,3786,3817,3800,26,9,5772,219376600,15706
1028,jd1710,20170913,3817,3800,3792,3815,3778,3792,3795,-8,-5,5966,226416840,13872
1029,jd1710,20170914,3792,3795,3795,3950,3782,3820,3807,25,12,5650,215109540,11722
1030,jd1710,20170915,3820,3807,3807,3832,3807,3826,3822,19,15,2502,95628620,11004
1031,jd1710,20170918,3826,3822,3770,3780,3685,3688,3731,-134,-91,6584,245686400,10458
1032,jd1710,20170919,3688,3731,3621,3643,3546,3547,3600,-184,-131,7712,277698680,9940
1033,jd1710,20170920,3547,3600,3545,3607,3545,3601,3586,1,-14,4378,157038300,9124
1034,jd1710,20170921,3601,3586,3598,3688,3579,3638,3619,52,33,5354,193781080,7904
1035,jd1710,20170922,3638,3619,3634,3653,3584,3587,3621,-32,2,2610,94523420,7384
1036,jd1710,20170925,3587,3621,3508,3544,3450,3450,3483,-171,-138,5138,178990420,6000
1037,jd1710,20170926,3450,3483,3470,3527,3466,3505,3494,22,11,2510,87719640,5188
1038,jd1710,20170927,3505,3494,3505,3524,3468,3510,3496,16,2,1928,67407780,4288
1039,jd1710,20170928,3510,3496,3505,3539,3496,3528,3520,32,24,2406,84693300,2642
1040,jd1710,20170929,3528,3520,3529,3677,3529,3640,3561,120,41,3538,125991060,100
1041,jd1710,20171009,3640,3561,3676,3760,3577,3652,3632,91,71,86,3124180,44
1042,jd1710,20171010,3652,3632,3749,3749,3508,3508,3609,-124,-23,28,1010560,38
1043,jd1710,20171011,3508,3609,0,0,0,3600,3600,-9,-9,0,0,38
1044,jd1710,20171012,3600,3600,0,0,0,3600,3600,0,0,0,0,38
1045,jd1710,20171013,3600,3600,0,0,0,3600,3600,0,0,0,0,38
1046,jd1710,20171016,3600,3600,3560,3560,3560,3560,3560,-40,-40,16,569600,42
1047,jd1710,20171017,3560,3560,0,0,0,3560,3560,0,0,0,0,42
1048,jd1710,20171018,3560,3560,0,0,0,3560,3560,0,0,0,0,42
1049,jd1710,20171019,3560,3560,0,0,0,3560,3560,0,0,0,0,40
1050,jd1710,20171020,3560,3560,3809,3809,3808,3809,3808,249,248,16,609420,22
1051,jd1710,20171023,3809,3808,0,0,0,3808,3808,0,0,0,0,20
1052,jd1710,20171024,3808,3808,4020,4020,4020,4020,4020,212,212,2,80400,12
1053,jd1710,20171025,4020,4020,0,0,0,4020,4020,0,0,0,0,10
1054,jd1710,20171026,4020,4020,3995,4100,3995,4100,3753,80,-267,6,241800,0
1055,jd1711,20170103,3614,3615,3599,3599,3599,3599,3599,-16,-16,2,71980,22
1056,jd1711,20170104,3599,3599,3536,3536,3536,3536,3536,-63,-63,2,70720,24
1057,jd1711,20170105,3536,3536,3684,3684,3684,3684,3684,148,148,2,73680,24
1058,jd1711,20170106,3684,3684,0,0,0,3655,3655,-29,-29,0,0,24
1059,jd1711,20170109,3655,3655,0,0,0,3655,3655,0,0,0,0,24
1060,jd1711,20170110,3655,3655,3601,3716,3601,3697,3651,42,-4,14,511140,24
1061,jd1711,20170111,3697,3651,0,0,0,3719,3719,68,68,0,0,24
1062,jd1711,20170112,3719,3719,3697,3697,3696,3696,3696,-23,-23,6,221780,24
1063,jd1711,20170113,3696,3696,0,0,0,3696,3696,0,0,0,0,24
1064,jd1711,20170116,3696,3696,0,0,0,3686,3686,-10,-10,0,0,24
1065,jd1711,20170117,3686,3686,0,0,0,3686,3686,0,0,0,0,24
1066,jd1711,20170118,3686,3686,0,0,0,3686,3686,0,0,0,0,24
1067,jd1711,20170119,3686,3686,3629,3629,3629,3629,3629,-57,-57,4,145160,24
1068,jd1711,20170120,3629,3629,3688,3688,3688,3688,3688,59,59,2,73760,24
1069,jd1711,20170123,3688,3688,0,0,0,3688,3688,0,0,0,0,24
1070,jd1711,20170124,3688,3688,0,0,0,3688,3688,0,0,0,0,24
1071,jd1711,20170125,3688,3688,3716,3716,3716,3716,3716,28,28,4,148640,20
1072,jd1711,20170126,3716,3716,0,0,0,3669,3669,-47,-47,0,0,20
1073,jd1711,20170203,3669,3669,0,0,0,3669,3669,0,0,0,0,20
1074,jd1711,20170206,3669,3669,0,0,0,3670,3670,1,1,0,0,20
1075,jd1711,20170207,3670,3670,3752,3755,3671,3748,3736,78,66,10,373620,20
1076,jd1711,20170208,3748,3736,3725,3725,3725,3725,3725,-11,-11,2,74500,20
1077,jd1711,20170209,3725,3725,3725,3726,3670,3725,3711,0,-14,8,296920,26
1078,jd1711,20170210,3725,3711,0,0,0,3711,3711,0,0,0,0,26
1079,jd1711,20170213,3711,3711,3717,3719,3717,3719,3718,8,7,6,223080,26
1080,jd1711,20170214,3719,3718,0,0,0,3718,3718,0,0,0,0,26
1081,jd1711,20170215,3718,3718,3810,3810,3750,3760,3781,42,63,8,302540,28
1082,jd1711,20170216,3760,3781,3730,3730,3720,3720,3726,-61,-55,6,223600,24
1083,jd1711,20170217,3720,3726,3701,3720,3700,3720,3703,-6,-23,16,592500,36
1084,jd1711,20170220,3720,3703,0,0,0,3703,3703,0,0,0,0,36
1085,jd1711,20170221,3703,3703,3783,3784,3783,3784,3783,81,80,4,151340,38
1086,jd1711,20170222,3784,3783,3819,3820,3797,3820,3815,37,32,12,457820,46
1087,jd1711,20170223,3820,3815,3799,3799,3799,3799,3799,-16,-16,2,75980,48
1088,jd1711,20170224,3799,3799,0,0,0,3799,3799,0,0,0,0,48
1089,jd1711,20170227,3799,3799,3849,3899,3849,3867,3870,68,71,16,619340,54
1090,jd1711,20170228,3867,3870,3954,3954,3898,3898,3909,28,39,12,469180,56
1091,jd1711,20170301,3898,3909,3828,3884,3828,3868,3860,-41,-49,6,231600,60
1092,jd1711,20170302,3868,3860,3898,3898,3826,3826,3851,-34,-9,12,462220,58
1093,jd1711,20170303,3826,3851,3873,3873,3873,3873,3873,22,22,2,77460,60
1094,jd1711,20170306,3873,3873,3890,3890,3890,3890,3890,17,17,2,77800,62
1095,jd1711,20170307,3890,3890,3860,3887,3860,3885,3877,-5,-13,6,232640,64
1096,jd1711,20170308,3885,3877,3836,3856,3826,3826,3839,-51,-38,8,307160,60
1097,jd1711,20170309,3826,3839,3859,3859,3840,3840,3846,1,7,6,230800,66
1098,jd1711,20170310,3840,3846,0,0,0,3846,3846,0,0,0,0,66
1099,jd1711,20170313,3846,3846,3840,3855,3828,3855,3838,9,-8,10,383820,68
1100,jd1711,20170314,3855,3838,3858,3858,3858,3858,3858,20,20,4,154320,72
1101,jd1711,20170315,3858,3858,3853,3853,3853,3853,3853,-5,-5,2,77060,72
1102,jd1711,20170316,3853,3853,3826,3829,3755,3755,3791,-98,-62,30,1137480,72
1103,jd1711,20170317,3755,3791,3749,3769,3736,3769,3757,-22,-34,22,826540,76
1104,jd1711,20170320,3769,3757,3762,3762,3762,3762,3762,5,5,2,75240,76
1105,jd1711,20170321,3762,3762,3752,3802,3752,3802,3783,40,21,8,302640,78
1106,jd1711,20170322,3802,3783,0,0,0,3783,3783,0,0,0,0,78
1107,jd1711,20170323,3783,3783,0,0,0,3783,3783,0,0,0,0,78
1108,jd1711,20170324,3783,3783,0,0,0,3800,3800,17,17,0,0,78
1109,jd1711,20170327,3800,3800,3880,3880,3807,3829,3826,29,26,12,459220,80
1110,jd1711,20170328,3829,3826,3785,3813,3785,3813,3799,-13,-27,4,151960,82
1111,jd1711,20170329,3813,3799,3800,3800,3780,3780,3790,-19,-9,6,227400,84
1112,jd1711,20170330,3780,3790,3749,3749,3713,3713,3724,-77,-66,16,595900,74
1113,jd1711,20170331,3713,3724,3613,3613,3586,3586,3599,-138,-125,8,287940,68
1114,jd1711,20170405,3586,3599,3730,3730,3600,3669,3628,70,29,94,3410320,124
1115,jd1711,20170406,3669,3628,3645,3668,3639,3668,3653,40,25,10,365300,124
1116,jd1711,20170407,3668,3653,3667,3671,3665,3665,3667,12,14,24,880240,140
1117,jd1711,20170410,3665,3667,3646,3646,3614,3636,3625,-31,-42,66,2392880,142
1118,jd1711,20170411,3636,3625,3638,3638,3610,3610,3621,-15,-4,32,1158940,146
1119,jd1711,20170412,3610,3621,3624,3635,3621,3633,3628,12,7,12,435380,152
1120,jd1711,20170413,3633,3628,3599,3639,3599,3618,3622,-10,-6,54,1956120,158
1121,jd1711,20170414,3618,3622,3609,3609,3601,3601,3604,-21,-18,12,432560,158
1122,jd1711,20170417,3601,3604,3629,3631,3629,3631,3630,27,26,8,290400,152
1123,jd1711,20170418,3631,3630,3631,3632,3540,3586,3606,-44,-24,56,2019820,162
1124,jd1711,20170419,3586,3606,3534,3538,3478,3521,3519,-85,-87,72,2533800,158
1125,jd1711,20170420,3521,3519,3522,3525,3506,3525,3520,6,1,24,844940,148
1126,jd1711,20170421,3525,3520,3549,3552,3545,3552,3550,32,30,14,497080,152
1127,jd1711,20170424,3552,3550,3682,3682,3452,3551,3551,1,1,58,2059580,172
1128,jd1711,20170425,3551,3551,3560,3631,3560,3631,3591,80,40,50,1795520,166
1129,jd1711,20170426,3631,3591,3508,3631,3508,3631,3615,40,24,28,1012340,154
1130,jd1711,20170427,3631,3615,3629,3629,3583,3615,3608,0,-7,12,433060,154
1131,jd1711,20170428,3615,3608,3629,3646,3618,3629,3633,21,25,18,653940,156
1132,jd1711,20170502,3629,3633,3715,3715,3671,3696,3691,63,58,90,3322120,198
1133,jd1711,20170503,3696,3691,3683,3683,3660,3680,3676,-11,-15,62,2279520,206
1134,jd1711,20170504,3680,3676,3660,3690,3656,3663,3673,-13,-3,236,8668560,346
1135,jd1711,20170505,3663,3673,3660,3677,3649,3650,3656,-23,-17,42,1535560,358
1136,jd1711,20170508,3650,3656,3535,3596,3515,3515,3560,-141,-96,208,7406240,424
1137,jd1711,20170509,3515,3560,3483,3545,3457,3464,3484,-96,-76,222,7735820,436
1138,jd1711,20170510,3464,3484,3440,3475,3347,3371,3372,-113,-112,1176,39657040,1192
1139,jd1711,20170511,3371,3372,3353,3371,3254,3347,3332,-25,-40,540,17993940,1402
1140,jd1711,20170512,3347,3332,3430,3430,3166,3355,3323,23,-9,742,24660280,1772
1141,jd1711,20170515,3355,3323,3325,3329,3266,3288,3297,-35,-26,626,20642800,1936
1142,jd1711,20170516,3288,3297,3314,3314,3276,3294,3288,-3,-9,390,12823640,2012
1143,jd1711,20170517,3294,3288,3299,3338,3290,3336,3325,48,37,530,17625360,2022
1144,jd1711,20170518,3336,3325,3292,3409,3290,3407,3371,82,46,670,22587620,2270
1145,jd1711,20170519,3407,3371,3434,3477,3422,3477,3454,106,83,1110,38342920,2670
1146,jd1711,20170522,3477,3454,3484,3499,3447,3464,3475,10,21,1476,51295940,2450
1147,jd1711,20170523,3464,3475,3465,3477,3441,3471,3460,-4,-15,1262,43666020,2870
1148,jd1711,20170524,3471,3460,3487,3499,3472,3492,3485,32,25,500,17429140,3184
1149,jd1711,20170525,3492,3485,3482,3505,3444,3447,3475,-38,-10,1014,35240360,3292
1150,jd1711,20170526,3447,3475,3438,3439,3376,3377,3394,-98,-81,1136,38566920,3712
1151,jd1711,20170531,3377,3394,3400,3427,3371,3390,3395,-4,1,1400,47536360,4320
1152,jd1711,20170601,3390,3395,3430,3564,3402,3564,3524,169,129,3322,117080160,4252
1153,jd1711,20170602,3564,3524,3597,3647,3504,3523,3548,-1,24,2434,86358740,4452
1154,jd1711,20170605,3523,3548,3523,3523,3493,3496,3507,-52,-41,1098,38517740,5018
1155,jd1711,20170606,3496,3507,3495,3535,3493,3509,3517,2,10,1206,42426100,5394
1156,jd1711,20170607,3509,3517,3520,3528,3500,3520,3511,3,-6,986,34622260,5762
1157,jd1711,20170608,3520,3511,3520,3590,3520,3580,3561,69,50,1522,54212440,6114
1158,jd1711,20170609,3580,3561,3600,3633,3570,3615,3601,54,40,1774,63897660,6530
1159,jd1711,20170612,3615,3601,3620,3640,3582,3640,3611,39,10,1410,50920300,6668
1160,jd1711,20170613,3640,3611,3627,3660,3605,3647,3633,36,22,1436,52179160,6894
1161,jd1711,20170614,3647,3633,3680,3684,3650,3680,3672,47,39,1332,48913160,7112
1162,jd1711,20170615,3680,3672,3696,3736,3672,3727,3706,55,34,1560,57820240,7116
1163,jd1711,20170616,3727,3706,3749,3768,3653,3658,3720,-48,14,2428,90342640,6894
1164,jd1711,20170619,3658,3720,3678,3743,3678,3698,3705,-22,-15,2328,86258040,6998
1165,jd1711,20170620,3698,3705,3701,3706,3648,3696,3674,-9,-31,1642,60342900,7044
1166,jd1711,20170621,3696,3674,3705,3813,3687,3805,3740,131,66,3294,123209160,7330
1167,jd1711,20170622,3805,3740,3813,3830,3761,3773,3801,33,61,3592,136544140,7628
1168,jd1711,20170623,3773,3801,3736,3788,3689,3717,3743,-84,-58,2304,86255680,7298
1169,jd1711,20170626,3717,3743,3660,3820,3576,3811,3766,68,23,3436,129426580,6620
1170,jd1711,20170627,3811,3766,3796,3883,3786,3866,3848,100,82,2830,108900080,6838
1171,jd1711,20170628,3866,3848,3888,3888,3819,3870,3847,22,-1,2504,96353840,7126
1172,jd1711,20170629,3870,3847,3860,3868,3819,3819,3850,-28,3,1738,66918240,7218
1173,jd1711,20170630,3819,3850,3826,3856,3779,3802,3802,-48,-48,1714,65180180,7560
1174,jd1711,20170703,3802,3802,3820,3820,3735,3763,3767,-39,-35,2066,77842160,7394
1175,jd1711,20170704,3763,3767,3712,3753,3579,3580,3636,-187,-131,5882,213924920,7946
1176,jd1711,20170705,3580,3636,3590,3678,3572,3643,3617,7,-19,4138,149703940,7796
1177,jd1711,20170706,3643,3617,3643,3797,3643,3792,3765,175,148,4604,173354960,7778
1178,jd1711,20170707,3792,3765,3793,3826,3753,3777,3779,12,14,3260,123227040,7732
1179,jd1711,20170710,3777,3779,3796,3796,3706,3714,3764,-65,-15,2204,82977560,7836
1180,jd1711,20170711,3714,3764,3770,3770,3723,3740,3743,-24,-21,1422,53231720,8134
1181,jd1711,20170712,3740,3743,3743,3743,3670,3712,3704,-31,-39,1970,72985380,8108
1182,jd1711,20170713,3712,3704,3700,3709,3681,3686,3692,-18,-12,1444,53318160,8564
1183,jd1711,20170714,3686,3692,3673,3736,3658,3725,3698,33,6,1090,40316380,8628
1184,jd1711,20170717,3725,3698,3701,3782,3699,3763,3747,65,49,1972,73897800,9168
1185,jd1711,20170718,3763,3747,3781,3804,3757,3789,3789,42,42,1802,68282740,9268
1186,jd1711,20170719,3789,3789,3848,3848,3788,3812,3815,23,26,1632,62265600,9512
1187,jd1711,20170720,3812,3815,3812,3823,3778,3778,3796,-37,-19,1284,48752040,9926
1188,jd1711,20170721,3778,3796,3785,3790,3770,3777,3779,-19,-17,1558,58887540,10152
1189,jd1711,20170724,3777,3779,3765,3785,3740,3780,3762,1,-17,2362,88861800,10960
1190,jd1711,20170725,3780,3762,3815,3840,3796,3834,3826,72,64,3488,133457260,11056
1191,jd1711,20170726,3834,3826,3857,3880,3811,3824,3843,-2,17,2936,112844940,11656
1192,jd1711,20170727,3824,3843,3840,3848,3830,3840,3837,-3,-6,1636,62778940,12150
1193,jd1711,20170728,3840,3837,3834,3850,3810,3821,3827,-16,-10,1720,65830120,12100
1194,jd1711,20170731,3821,3827,3879,3886,3832,3858,3851,31,24,4854,186937420,13410
1195,jd1711,20170801,3858,3851,3858,3860,3789,3792,3819,-59,-32,3580,136729860,14818
1196,jd1711,20170802,3792,3819,3760,3805,3750,3795,3787,-24,-32,3442,130363560,15672
1197,jd1711,20170803,3795,3787,3780,3800,3768,3774,3780,-13,-7,2206,83396360,16228
1198,jd1711,20170804,3774,3780,3789,3870,3789,3850,3830,70,50,6954,266397680,16084
1199,jd1711,20170807,3850,3830,3925,3992,3900,3930,3950,100,120,8360,330289140,16796
1200,jd1711,20170808,3930,3950,3902,4007,3902,3995,3953,45,3,4912,194173480,16166
1201,jd1711,20170809,3995,3953,4068,4150,4001,4150,4103,197,150,15364,630439680,14778
1202,jd1711,20170810,4150,4103,4172,4250,4128,4241,4189,138,86,16520,692121580,15476
1203,jd1711,20170811,4241,4189,4250,4356,4210,4353,4281,164,92,22062,944593200,19302
1204,jd1711,20170814,4353,4281,4233,4350,4211,4311,4285,30,4,22716,973538720,21440
1205,jd1711,20170815,4311,4285,4290,4309,4226,4250,4262,-35,-23,14868,633767920,22614
1206,jd1711,20170816,4250,4262,4285,4294,4250,4280,4274,18,12,10332,441598660,23176
1207,jd1711,20170817,4280,4274,4290,4292,4101,4116,4166,-158,-108,28434,1184629500,29658
1208,jd1711,20170818,4116,4166,4120,4200,4090,4106,4143,-60,-23,32346,1340266340,32004
1209,jd1711,20170821,4106,4143,4140,4218,4140,4194,4180,51,37,24290,1015544300,33500
1210,jd1711,20170822,4194,4180,4199,4207,4142,4145,4174,-35,-6,18716,781326920,34574
1211,jd1711,20170823,4145,4174,4105,4133,3971,3980,4018,-194,-156,30340,1219089140,36616
1212,jd1711,20170824,3980,4018,3995,4022,3946,3972,3985,-46,-33,17848,711364660,36888
1213,jd1711,20170825,3972,3985,3970,4011,3925,3946,3962,-39,-23,24856,984851180,37210
1214,jd1711,20170828,3946,3962,3900,3980,3888,3958,3943,-4,-19,13690,539799200,37396
1215,jd1711,20170829,3958,3943,3978,4060,3966,3979,3991,36,48,15858,632898040,36288
1216,jd1711,20170830,3979,3991,3998,4010,3856,3865,3913,-126,-78,26394,1032963040,40266
1217,jd1711,20170831,3865,3913,3852,3868,3789,3813,3827,-100,-86,32354,1238312700,42246
1218,jd1711,20170901,3813,3827,3850,3890,3796,3813,3844,-14,17,26580,1021872140,43416
1219,jd1711,20170904,3813,3844,3872,3886,3828,3840,3861,-4,17,22972,887016620,42966
1220,jd1711,20170905,3840,3861,3864,3903,3816,3845,3850,-16,-11,19026,732533180,42162
1221,jd1711,20170906,3845,3850,3870,3884,3851,3872,3868,22,18,18100,700139940,40092
1222,jd1711,20170907,3872,3868,3848,3850,3775,3778,3812,-90,-56,27562,1050895340,42106
1223,jd1711,20170908,3778,3812,3777,3785,3707,3724,3750,-88,-62,23692,888489560,41418
1224,jd1711,20170911,3724,3750,3702,3780,3701,3747,3742,-3,-8,17612,659132360,41860
1225,jd1711,20170912,3747,3742,3765,3767,3734,3762,3749,20,7,12998,487423600,40906
1226,jd1711,20170913,3762,3749,3745,3764,3705,3714,3735,-35,-14,19488,727897200,41142
1227,jd1711,20170914,3714,3735,3730,3759,3724,3756,3741,21,6,12698,475110040,38564
1228,jd1711,20170915,3756,3741,3749,3768,3741,3762,3753,21,12,12698,476592820,37654
1229,jd1711,20170918,3762,3753,3700,3720,3665,3667,3692,-86,-61,18398,679302000,37064
1230,jd1711,20170919,3667,3692,3644,3649,3605,3605,3624,-87,-68,16248,588956180,36176
1231,jd1711,20170920,3605,3624,3615,3641,3610,3634,3629,10,5,11082,402245800,34940
1232,jd1711,20170921,3634,3629,3635,3738,3613,3689,3669,60,40,22094,810787040,35810
1233,jd1711,20170922,3689,3669,3699,3701,3653,3658,3678,-11,9,15546,571856860,36434
1234,jd1711,20170925,3658,3678,3590,3608,3551,3557,3575,-121,-103,20184,721715560,34410
1235,jd1711,20170926,3557,3575,3572,3596,3570,3581,3583,6,8,12016,430609920,32980
1236,jd1711,20170927,3581,3583,3580,3646,3537,3590,3571,7,-12,17106,610989980,32074
1237,jd1711,20170928,3590,3571,3572,3689,3569,3659,3632,88,61,17878,649442480,27222
1238,jd1711,20170929,3659,3632,3645,3706,3644,3697,3679,65,47,15190,558894360,22460
1239,jd1711,20171009,3697,3679,3736,3780,3700,3738,3724,59,45,11190,416807760,20378
1240,jd1711,20171010,3738,3724,3719,3741,3702,3709,3715,-15,-9,8588,319090880,19958
1241,jd1711,20171011,3709,3715,3715,3795,3705,3789,3757,74,42,9114,342501320,18198
1242,jd1711,20171012,3789,3757,3750,3758,3735,3740,3744,-17,-13,4602,172330080,17926
1243,jd1711,20171013,3740,3744,3730,3756,3720,3754,3741,10,-3,6228,233009520,16434
1244,jd1711,20171016,3754,3741,3770,3825,3762,3782,3789,41,48,7612,288474200,13166
1245,jd1711,20171017,3782,3789,3770,3799,3745,3798,3775,9,-14,3918,147920880,12268
1246,jd1711,20171018,3798,3775,3790,3825,3789,3817,3808,42,33,4538,172813960,10044
1247,jd1711,20171019,3817,3808,3835,3866,3827,3860,3849,52,41,6098,234725260,7574
1248,jd1711,20171020,3860,3849,3875,3966,3870,3922,3919,73,70,5706,223651540,6382
1249,jd1711,20171023,3922,3919,3910,3911,3863,3874,3888,-45,-31,2582,100396540,5950
1250,jd1711,20171024,3874,3888,3850,3897,3842,3881,3869,-7,-19,2400,92860640,6172
1251,jd1711,20171025,3881,3869,3868,3918,3865,3895,3889,26,20,1624,63165160,5602
1252,jd1711,20171026,3895,3889,3900,3929,3897,3911,3909,22,20,1468,57391400,5028
1253,jd1711,20171027,3911,3909,3921,3921,3881,3901,3896,-8,-13,1516,59075960,4090
1254,jd1711,20171030,3901,3896,3929,3929,3900,3916,3913,20,17,1352,52904540,2996
1255,jd1711,20171031,3916,3913,3910,4000,3875,3888,3961,-25,48,3558,140948940,350
1256,jd1711,20171101,3888,3961,3858,3940,3828,3900,3907,-61,-54,118,4611240,256
1257,jd1711,20171102,3900,3907,3908,3977,3900,3908,3915,1,8,50,1957720,242
1258,jd1711,20171103,3908,3915,4024,4050,3920,4050,4015,135,100,24,963800,222
1259,jd1711,20171106,4050,4015,0,0,0,4015,4015,0,0,0,0,220
1260,jd1711,20171107,4015,4015,4061,4062,4061,4062,4061,47,46,4,162460,210
1261,jd1711,20171108,4062,4061,4134,4135,4080,4135,4118,74,57,14,576580,194
1262,jd1711,20171109,4135,4118,0,0,0,4129,4129,11,11,0,0,192
1263,jd1711,20171110,4129,4129,4193,4193,4193,4193,4193,64,64,2,83860,190
1264,jd1711,20171113,4193,4193,4193,4245,4193,4240,4233,47,40,170,7197480,48
1265,jd1711,20171114,4240,4233,4270,4280,4270,4280,4272,47,39,8,341800,42
1266,jd1711,20171115,4280,4272,0,0,0,4272,4272,0,0,0,0,40
1267,jd1711,20171116,4272,4272,4272,4272,4272,4272,4272,0,0,8,341760,40
1268,jd1711,20171117,4272,4272,0,0,0,4272,4272,0,0,0,0,38
1269,jd1711,20171120,4272,4272,0,0,0,4272,4272,0,0,0,0,38
1270,jd1711,20171121,4272,4272,0,0,0,4272,4272,0,0,0,0,38
1271,jd1711,20171122,4272,4272,4400,4528,4400,4528,4512,256,240,34,1534400,10
1272,jd1711,20171123,4528,4512,4910,4910,4650,4650,4715,138,203,8,377200,0
1273,jd1711,20171124,4650,4715,0,0,0,4715,4715,0,0,0,0,0
1274,jd1711,20171127,4715,4715,0,0,0,4474,4474,-241,-241,0,0,0
1275,jd1712,20170103,3645,3645,0,0,0,3629,3629,-16,-16,0,0,2
1276,jd1712,20170104,3629,3629,0,0,0,3600,3600,-29,-29,0,0,2
1277,jd1712,20170105,3600,3600,0,0,0,3600,3600,0,0,0,0,2
1278,jd1712,20170106,3600,3600,3618,3678,3618,3678,3648,78,48,4,145920,4
1279,jd1712,20170109,3678,3648,0,0,0,3660,3660,12,12,0,0,4
1280,jd1712,20170110,3660,3660,0,0,0,3656,3656,-4,-4,0,0,4
1281,jd1712,20170111,3656,3656,0,0,0,3724,3724,68,68,0,0,4
1282,jd1712,20170112,3724,3724,0,0,0,3701,3701,-23,-23,0,0,4
1283,jd1712,20170113,3701,3701,0,0,0,3701,3701,0,0,0,0,4
1284,jd1712,20170116,3701,3701,0,0,0,3701,3701,0,0,0,0,4
1285,jd1712,20170117,3701,3701,3612,3612,3612,3612,3612,-89,-89,2,72240,2
1286,jd1712,20170118,3612,3612,0,0,0,3631,3631,19,19,0,0,2
1287,jd1712,20170119,3631,3631,0,0,0,3646,3646,15,15,0,0,2
1288,jd1712,20170120,3646,3646,0,0,0,3646,3646,0,0,0,0,2
1289,jd1712,20170123,3646,3646,0,0,0,3646,3646,0,0,0,0,2
1290,jd1712,20170124,3646,3646,0,0,0,3670,3670,24,24,0,0,2
1291,jd1712,20170125,3670,3670,0,0,0,3687,3687,17,17,0,0,2
1292,jd1712,20170126,3687,3687,0,0,0,3640,3640,-47,-47,0,0,2
1293,jd1712,20170203,3640,3640,0,0,0,3640,3640,0,0,0,0,2
1294,jd1712,20170206,3640,3640,3784,3784,3784,3784,3784,144,144,2,75680,4
1295,jd1712,20170207,3784,3784,0,0,0,3852,3852,68,68,0,0,4
1296,jd1712,20170208,3852,3852,0,0,0,3841,3841,-11,-11,0,0,4
1297,jd1712,20170209,3841,3841,3799,3799,3799,3799,3799,-42,-42,2,75980,4
1298,jd1712,20170210,3799,3799,0,0,0,3799,3799,0,0,0,0,4
1299,jd1712,20170213,3799,3799,0,0,0,3799,3799,0,0,0,0,4
1300,jd1712,20170214,3799,3799,0,0,0,3816,3816,17,17,0,0,4
1301,jd1712,20170215,3816,3816,0,0,0,3816,3816,0,0,0,0,4
1302,jd1712,20170216,3816,3816,0,0,0,3816,3816,0,0,0,0,4
1303,jd1712,20170217,3816,3816,0,0,0,3816,3816,0,0,0,0,4
1304,jd1712,20170220,3816,3816,0,0,0,3846,3846,30,30,0,0,4
1305,jd1712,20170221,3846,3846,0,0,0,3929,3929,83,83,0,0,4
1306,jd1712,20170222,3929,3929,0,0,0,3962,3962,33,33,0,0,4
1307,jd1712,20170223,3962,3962,0,0,0,3946,3946,-16,-16,0,0,4
1308,jd1712,20170224,3946,3946,0,0,0,3994,3994,48,48,0,0,4
1309,jd1712,20170227,3994,3994,0,0,0,4068,4068,74,74,0,0,4
1310,jd1712,20170228,4068,4068,0,0,0,4108,4108,40,40,0,0,4
1311,jd1712,20170301,4108,4108,0,0,0,4057,4057,-51,-51,0,0,4
1312,jd1712,20170302,4057,4057,0,0,0,4048,4048,-9,-9,0,0,4
1313,jd1712,20170303,4048,4048,4029,4029,4029,4029,4029,-19,-19,2,80580,6
1314,jd1712,20170306,4029,4029,3998,3998,3998,3998,3998,-31,-31,2,79960,4
1315,jd1712,20170307,3998,3998,0,0,0,3998,3998,0,0,0,0,4
1316,jd1712,20170308,3998,3998,0,0,0,3998,3998,0,0,0,0,4
1317,jd1712,20170309,3998,3998,4049,4049,3902,3902,3975,-96,-23,4,159020,4
1318,jd1712,20170310,3902,3975,0,0,0,3975,3975,0,0,0,0,4
1319,jd1712,20170313,3975,3975,0,0,0,3975,3975,0,0,0,0,4
1320,jd1712,20170314,3975,3975,0,0,0,3975,3975,0,0,0,0,4
1321,jd1712,20170315,3975,3975,3930,3930,3930,3930,3930,-45,-45,2,78600,6
1322,jd1712,20170316,3930,3930,3931,3932,3833,3833,3898,-97,-32,6,233920,10
1323,jd1712,20170317,3833,3898,0,0,0,3898,3898,0,0,0,0,10
1324,jd1712,20170320,3898,3898,0,0,0,3898,3898,0,0,0,0,10
1325,jd1712,20170321,3898,3898,0,0,0,3898,3898,0,0,0,0,10
1326,jd1712,20170322,3898,3898,0,0,0,3898,3898,0,0,0,0,10
1327,jd1712,20170323,3898,3898,3995,3995,3995,3995,3995,97,97,2,79900,8
1328,jd1712,20170324,3995,3995,0,0,0,3995,3995,0,0,0,0,8
1329,jd1712,20170327,3995,3995,0,0,0,3995,3995,0,0,0,0,8
1330,jd1712,20170328,3995,3995,0,0,0,3967,3967,-28,-28,0,0,8
1331,jd1712,20170329,3967,3967,0,0,0,3967,3967,0,0,0,0,8
1332,jd1712,20170330,3967,3967,3820,3829,3820,3829,3826,-138,-141,6,229560,2
1333,jd1712,20170331,3829,3826,0,0,0,3698,3698,-128,-128,0,0,2
1334,jd1712,20170405,3698,3698,0,0,0,3698,3698,0,0,0,0,2
1335,jd1712,20170406,3698,3698,0,0,0,3698,3698,0,0,0,0,2
1336,jd1712,20170407,3698,3698,3701,3701,3701,3701,3701,3,3,2,74020,2
1337,jd1712,20170410,3701,3701,3653,3677,3601,3646,3641,-55,-60,16,582660,6
1338,jd1712,20170411,3646,3641,0,0,0,3641,3641,0,0,0,0,6
1339,jd1712,20170412,3641,3641,0,0,0,3641,3641,0,0,0,0,6
1340,jd1712,20170413,3641,3641,3617,3617,3617,3617,3617,-24,-24,2,72340,6
1341,jd1712,20170414,3617,3617,0,0,0,3617,3617,0,0,0,0,6
1342,jd1712,20170417,3617,3617,0,0,0,3617,3617,0,0,0,0,6
1343,jd1712,20170418,3617,3617,3600,3600,3580,3580,3587,-37,-30,6,215260,10
1344,jd1712,20170419,3580,3587,3540,3540,3492,3492,3510,-95,-77,6,210640,12
1345,jd1712,20170420,3492,3510,3520,3606,3520,3574,3557,64,47,28,996180,18
1346,jd1712,20170421,3574,3557,3595,3595,3595,3595,3595,38,38,2,71900,16
1347,jd1712,20170424,3595,3595,3601,3601,3601,3601,3601,6,6,6,216060,22
1348,jd1712,20170425,3601,3601,0,0,0,3663,3663,62,62,0,0,22
1349,jd1712,20170426,3663,3663,3674,3674,3658,3674,3667,11,4,16,586780,14
1350,jd1712,20170427,3674,3667,3674,3674,3668,3668,3671,1,4,4,146840,16
1351,jd1712,20170428,3668,3671,3701,3728,3682,3728,3705,57,34,10,370580,18
1352,jd1712,20170502,3728,3705,3745,3786,3743,3786,3759,81,54,24,902380,30
1353,jd1712,20170503,3786,3759,0,0,0,3759,3759,0,0,0,0,30
1354,jd1712,20170504,3759,3759,3678,3758,3678,3750,3736,-9,-23,124,4633340,110
1355,jd1712,20170505,3750,3736,0,0,0,3740,3740,4,4,0,0,110
1356,jd1712,20170508,3740,3740,3755,3755,3633,3645,3692,-95,-48,190,7015380,120
1357,jd1712,20170509,3645,3692,3685,3685,3605,3640,3628,-52,-64,216,7837020,196
1358,jd1712,20170510,3640,3628,3643,3643,3465,3518,3504,-110,-124,1114,39037900,908
1359,jd1712,20170511,3518,3504,3476,3500,3398,3483,3463,-21,-41,270,9350820,968
1360,jd1712,20170512,3483,3463,3461,3514,3423,3428,3448,-35,-15,234,8069820,1056
1361,jd1712,20170515,3428,3448,3402,3437,3376,3402,3409,-46,-39,304,10364300,1124
1362,jd1712,20170516,3402,3409,3418,3418,3380,3417,3405,8,-4,440,14986060,1348
1363,jd1712,20170517,3417,3405,3423,3470,3407,3469,3448,64,43,310,10690400,1374
1364,jd1712,20170518,3469,3448,3449,3515,3447,3515,3497,67,49,302,10562660,1520
1365,jd1712,20170519,3515,3497,3521,3560,3515,3560,3542,63,45,204,7227580,1564
1366,jd1712,20170522,3560,3542,3560,3619,3536,3591,3589,49,47,638,22901880,1388
1367,jd1712,20170523,3591,3589,3607,3617,3582,3603,3604,14,15,960,34607020,834
1368,jd1712,20170524,3603,3604,3614,3622,3608,3612,3616,8,12,94,3399940,858
1369,jd1712,20170525,3612,3616,3603,3617,3583,3583,3596,-33,-20,286,10286220,866
1370,jd1712,20170526,3583,3596,3573,3590,3528,3544,3551,-52,-45,424,15059380,992
1371,jd1712,20170531,3544,3551,3527,3574,3474,3495,3522,-56,-29,990,34870140,1410
1372,jd1712,20170601,3495,3522,3495,3698,3495,3698,3639,176,117,2158,78536040,1508
1373,jd1712,20170602,3698,3639,3711,3738,3605,3624,3649,-15,10,1154,42115600,1748
1374,jd1712,20170605,3624,3649,3624,3627,3603,3604,3613,-45,-36,384,13874060,1810
1375,jd1712,20170606,3604,3613,3596,3635,3596,3615,3622,2,9,376,13621200,1948
1376,jd1712,20170607,3615,3622,3605,3617,3580,3616,3595,-6,-27,388,13951760,2044
1377,jd1712,20170608,3616,3595,3620,3660,3620,3644,3637,49,42,332,12077460,2014
1378,jd1712,20170609,3644,3637,3654,3698,3648,3669,3663,32,26,350,12823580,2030
1379,jd1712,20170612,3669,3663,3665,3698,3655,3693,3671,30,8,596,21883160,2064
1380,jd1712,20170613,3693,3671,3681,3749,3680,3740,3723,69,52,424,15788400,2182
1381,jd1712,20170614,3740,3723,3780,3800,3700,3788,3775,65,52,520,19633660,2376
1382,jd1712,20170615,3788,3775,3836,3861,3785,3848,3820,73,45,1084,41415100,2528
1383,jd1712,20170616,3848,3820,3858,3870,3749,3749,3809,-71,-11,1596,60803480,2284
1384,jd1712,20170619,3749,3809,3774,3826,3762,3817,3802,8,-7,1002,38100360,2226
1385,jd1712,20170620,3817,3802,3815,3816,3785,3814,3803,12,1,440,16736380,2218
1386,jd1712,20170621,3814,3803,3820,3848,3743,3846,3792,43,-11,1956,74184620,2738
1387,jd1712,20170622,3846,3792,3850,3903,3821,3849,3855,57,63,1476,56910460,2894
1388,jd1712,20170623,3849,3855,3813,3859,3782,3820,3821,-35,-34,908,34696780,2912
1389,jd1712,20170626,3820,3821,3788,3878,3780,3871,3852,50,31,1050,40453500,2878
1390,jd1712,20170627,3871,3852,3879,3927,3868,3922,3908,70,56,820,32047440,3044
1391,jd1712,20170628,3922,3908,3932,3938,3900,3925,3918,17,10,484,18966380,3040
1392,jd1712,20170629,3925,3918,3920,3923,3885,3894,3908,-24,-10,322,12585300,3066
1393,jd1712,20170630,3894,3908,3861,3891,3854,3861,3868,-47,-40,730,28241240,3026
1394,jd1712,20170703,3861,3868,3840,3869,3828,3851,3850,-17,-18,352,13553160,3036
1395,jd1712,20170704,3851,3850,3821,3847,3672,3673,3751,-177,-99,2586,97002520,3236
1396,jd1712,20170705,3673,3751,3668,3751,3642,3743,3717,-8,-34,996,37027020,3258
1397,jd1712,20170706,3743,3717,3763,3902,3756,3870,3855,153,138,2482,95687540,3558
1398,jd1712,20170707,3870,3855,3870,3884,3840,3859,3856,4,1,1188,45820940,3374
1399,jd1712,20170710,3859,3856,3876,3876,3801,3815,3847,-41,-9,842,32398920,3440
1400,jd1712,20170711,3815,3847,3780,3844,3780,3818,3822,-29,-25,558,21330060,3416
1401,jd1712,20170712,3818,3822,3816,3822,3780,3797,3796,-25,-26,506,19209180,3502
1402,jd1712,20170713,3797,3796,3772,3809,3771,3791,3796,-5,0,468,17767920,3774
1403,jd1712,20170714,3791,3796,3794,3820,3777,3809,3796,13,0,386,14654720,3758
1404,jd1712,20170717,3809,3796,3796,3881,3790,3867,3841,71,45,598,22973020,3880
1405,jd1712,20170718,3867,3841,3885,3915,3871,3890,3892,49,51,732,28496700,4188
1406,jd1712,20170719,3890,3892,3905,3930,3896,3900,3908,8,16,414,16180280,4226
1407,jd1712,20170720,3900,3908,3902,3919,3884,3884,3897,-24,-11,440,17147220,4126
1408,jd1712,20170721,3884,3897,3889,3910,3885,3895,3891,-2,-6,550,21402380,3900
1409,jd1712,20170724,3895,3891,3872,3889,3862,3886,3875,-5,-16,1070,41467240,4450
1410,jd1712,20170725,3886,3875,3898,3963,3893,3958,3935,83,60,1946,76594020,4894
1411,jd1712,20170726,3958,3935,3981,3999,3950,3965,3978,30,43,1160,46151760,5090
1412,jd1712,20170727,3965,3978,3975,3985,3969,3976,3977,-2,-1,480,19089940,5048
1413,jd1712,20170728,3976,3977,3975,3985,3940,3957,3959,-20,-18,1242,49182300,4816
1414,jd1712,20170731,3957,3959,3996,4000,3958,3979,3974,20,15,1012,40221100,4560
1415,jd1712,20170801,3979,3974,3974,3975,3905,3915,3938,-59,-36,828,32613940,4310
1416,jd1712,20170802,3915,3938,3901,3949,3877,3928,3927,-10,-11,1048,41161440,4686
1417,jd1712,20170803,3928,3927,3900,3949,3900,3900,3907,-27,-20,874,34149260,4872
1418,jd1712,20170804,3900,3907,3920,4030,3913,4010,3972,103,65,2080,82620460,4534
1419,jd1712,20170807,4010,3972,4070,4134,4057,4088,4095,116,123,1856,76012620,4736
1420,jd1712,20170808,4088,4095,4075,4132,4075,4128,4105,33,10,840,34487060,4724
1421,jd1712,20170809,4128,4105,4131,4310,4131,4310,4276,205,171,2460,105197360,4792
1422,jd1712,20170810,4310,4276,4308,4375,4274,4362,4329,86,53,1858,80441880,4618
1423,jd1712,20170811,4362,4329,4358,4438,4301,4413,4362,84,33,2442,106537300,5046
1424,jd1712,20170814,4413,4362,4343,4460,4342,4416,4400,54,38,4386,193019100,6048
1425,jd1712,20170815,4416,4400,4390,4414,4332,4360,4367,-40,-33,1926,84108740,5978
1426,jd1712,20170816,4360,4367,4400,4415,4363,4385,4386,18,19,1766,77462560,6446
1427,jd1712,20170817,4385,4386,4410,4419,4286,4291,4327,-95,-59,3586,155181520,6096
1428,jd1712,20170818,4291,4327,4300,4355,4270,4281,4312,-46,-15,2846,122734500,5648
1429,jd1712,20170821,4281,4312,4324,4438,4313,4403,4391,91,79,2428,106632520,6054
1430,jd1712,20170822,4403,4391,4409,4410,4350,4352,4385,-39,-6,1278,56051320,6232
1431,jd1712,20170823,4352,4385,4315,4320,4182,4194,4219,-191,-166,2566,108265860,6068
1432,jd1712,20170824,4194,4219,4201,4224,4160,4171,4185,-48,-34,1020,42691120,5970
1433,jd1712,20170825,4171,4185,4205,4205,4108,4149,4156,-36,-29,1546,64253500,5970
1434,jd1712,20170828,4149,4156,4141,4178,4081,4160,4152,4,-4,1990,82636280,6592
1435,jd1712,20170829,4160,4152,4189,4212,4157,4166,4178,14,26,1250,52231000,6560
1436,jd1712,20170830,4166,4178,4180,4190,4052,4057,4104,-121,-74,2018,82825060,6498
1437,jd1712,20170831,4057,4104,4058,4097,3994,4025,4031,-79,-73,3064,123533680,6542
1438,jd1712,20170901,4025,4031,4080,4107,4014,4034,4064,3,33,2514,102180980,7314
1439,jd1712,20170904,4034,4064,4120,4120,4044,4051,4080,-13,16,1934,78918340,7636
1440,jd1712,20170905,4051,4080,4080,4098,4022,4042,4055,-38,-25,2102,85249840,7668
1441,jd1712,20170906,4042,4055,4040,4085,4025,4076,4067,21,12,1690,68737700,7378
1442,jd1712,20170907,4076,4067,4068,4069,3980,3989,4013,-78,-54,3000,120394980,7316
1443,jd1712,20170908,3989,4013,3978,3989,3921,3936,3953,-77,-60,3100,122565760,6948
1444,jd1712,20170911,3936,3953,3936,3982,3926,3965,3959,12,6,1826,72294240,7160
1445,jd1712,20170912,3965,3959,3950,3992,3945,3974,3972,15,13,1100,43700600,7080
1446,jd1712,20170913,3974,3972,3946,3977,3902,3936,3938,-36,-34,1692,66639780,7136
1447,jd1712,20170914,3936,3938,3955,3980,3941,3976,3959,38,21,992,39275500,7196
1448,jd1712,20170915,3976,3959,3952,3986,3952,3975,3969,16,10,1412,56045620,7320
1449,jd1712,20170918,3975,3969,3950,3950,3871,3879,3895,-90,-74,2892,112644100,7210
1450,jd1712,20170919,3879,3895,3830,3865,3820,3821,3838,-74,-57,2866,110016980,7460
1451,jd1712,20170920,3821,3838,3820,3866,3820,3853,3843,15,5,1314,50505720,7374
1452,jd1712,20170921,3853,3843,3875,3987,3825,3926,3889,83,46,4146,161241500,7712
1453,jd1712,20170922,3926,3889,3934,3948,3907,3927,3924,38,35,2064,81002800,7362
1454,jd1712,20170925,3927,3924,3900,3900,3816,3831,3854,-93,-70,2920,112540920,7790
1455,jd1712,20170926,3831,3854,3843,3876,3838,3861,3859,7,5,1256,48475260,8128
1456,jd1712,20170927,3861,3859,3850,3882,3817,3862,3844,3,-15,2150,82664840,8330
1457,jd1712,20170928,3862,3844,3840,3965,3820,3911,3896,67,52,2742,106852780,8076
1458,jd1712,20170929,3911,3896,3903,3954,3903,3950,3933,54,37,1498,58926620,7892
1459,jd1712,20171009,3950,3933,3960,4035,3930,3974,3965,41,32,1652,65502060,8094
1460,jd1712,20171010,3974,3965,3961,3998,3951,3968,3976,3,11,1648,65535780,8602
1461,jd1712,20171011,3968,3976,3957,4039,3957,4039,4017,63,41,1986,79778080,9258
1462,jd1712,20171012,4039,4017,4025,4025,3986,4013,4012,-4,-5,1302,52237520,9332
1463,jd1712,20171013,4013,4012,4005,4018,3958,3976,3984,-36,-28,3794,151178760,8384
1464,jd1712,20171016,3976,3984,3980,4025,3972,3993,3998,9,14,3224,128921700,8608
1465,jd1712,20171017,3993,3998,3986,4004,3979,4000,3995,2,-3,1132,45230400,8574
1466,jd1712,20171018,4000,3995,3998,4019,3991,4008,4003,13,8,1054,42200640,8646
1467,jd1712,20171019,4008,4003,4022,4070,4015,4063,4049,60,46,1996,80832600,8622
1468,jd1712,20171020,4063,4049,4075,4199,4075,4175,4155,126,106,5418,225121240,9400
1469,jd1712,20171023,4175,4155,4190,4190,4110,4130,4137,-25,-18,3050,126202440,9066
1470,jd1712,20171024,4130,4137,4124,4159,4111,4135,4132,-2,-5,2030,83888520,9302
1471,jd1712,20171025,4135,4132,4128,4169,4111,4144,4141,12,9,2360,97737560,8976
1472,jd1712,20171026,4144,4141,4150,4174,4140,4145,4154,4,13,1858,77184000,8594
1473,jd1712,20171027,4145,4154,4160,4160,4089,4120,4117,-34,-37,3244,133579460,8436
1474,jd1712,20171030,4120,4117,4128,4150,4078,4090,4117,-27,0,2300,94696400,8150
1475,jd1712,20171031,4090,4117,4100,4132,4084,4110,4114,-7,-3,2978,122518960,8336
1476,jd1712,20171101,4110,4114,4118,4159,4118,4135,4139,21,25,1676,69380260,7758
1477,jd1712,20171102,4135,4139,4138,4146,4120,4146,4130,7,-9,972,40147740,7622
1478,jd1712,20171103,4146,4130,4145,4150,4131,4134,4137,4,7,600,24827960,7620
1479,jd1712,20171106,4134,4137,4145,4177,4144,4177,4166,40,29,1734,72244980,7058
1480,jd1712,20171107,4177,4166,4213,4270,4195,4267,4234,101,68,2816,119240180,6792
1481,jd1712,20171108,4267,4234,4287,4332,4283,4326,4313,92,79,3552,153213560,6084
1482,jd1712,20171109,4326,4313,4336,4336,4285,4311,4306,-2,-7,1966,84665260,5476
1483,jd1712,20171110,4311,4306,4300,4316,4285,4295,4301,-11,-5,1656,71240540,5376
1484,jd1712,20171113,4295,4301,4295,4351,4271,4339,4310,38,9,3258,140421580,5038
1485,jd1712,20171114,4339,4310,4330,4330,4266,4285,4284,-25,-26,3270,140115520,5390
1486,jd1712,20171115,4285,4284,4272,4327,4270,4300,4296,16,12,1020,43820660,5156
1487,jd1712,20171116,4300,4296,4290,4335,4290,4314,4314,18,18,1072,46250540,4784
1488,jd1712,20171117,4314,4314,4302,4326,4290,4314,4304,0,-10,678,29186440,4494
1489,jd1712,20171120,4314,4304,4321,4321,4270,4279,4285,-25,-19,1062,45511920,4132
1490,jd1712,20171121,4279,4285,4300,4334,4300,4324,4316,39,31,690,29781020,3916
1491,jd1712,20171122,4324,4316,4350,4422,4350,4422,4373,106,57,1518,66390220,3472
1492,jd1712,20171123,4422,4373,4444,4482,4426,4440,4455,67,82,1020,45449720,3068
1493,jd1712,20171124,4440,4455,4470,4470,4440,4467,4455,12,0,360,16041180,2860
1494,jd1712,20171127,4467,4455,4450,4470,4443,4451,4457,-4,2,716,31914660,2346
1495,jd1712,20171128,4451,4457,4458,4458,4445,4454,4453,-3,-4,810,36070460,1770
1496,jd1712,20171129,4454,4453,4459,4488,4459,4480,4476,27,23,824,36888080,1176
1497,jd1712,20171130,4480,4476,4478,4540,4405,4540,4474,64,-2,1496,66936540,186
1498,jd1712,20171201,4540,4474,4700,4700,4500,4650,4588,176,114,94,4313260,108
1499,jd1712,20171204,4650,4588,4650,4650,4561,4566,4611,-22,23,26,1198920,96
1500,jd1712,20171205,4566,4611,4581,4600,4581,4600,4596,-11,-15,12,551620,96
1501,jd1712,20171206,4600,4596,0,0,0,4596,4596,0,0,0,0,96
1502,jd1712,20171207,4596,4596,4551,4551,4551,4551,4551,-45,-45,10,455100,92
1503,jd1712,20171208,4551,4551,0,0,0,4551,4551,0,0,0,0,92
1504,jd1712,20171211,4551,4551,4599,4599,4550,4597,4585,46,34,8,366860,90
1505,jd1712,20171212,4597,4585,0,0,0,4585,4585,0,0,0,0,90
1506,jd1712,20171213,4585,4585,4699,4699,4699,4699,4699,114,114,2,93980,90
1507,jd1712,20171214,4699,4699,0,0,0,4699,4699,0,0,0,0,90
1508,jd1712,20171215,4699,4699,4699,4699,4699,4699,4699,0,0,6,281940,90
1509,jd1712,20171218,4699,4699,0,0,0,4699,4699,0,0,0,0,90
1510,jd1712,20171219,4699,4699,0,0,0,4699,4699,0,0,0,0,90
1511,jd1712,20171220,4699,4699,4700,4700,4700,4700,4700,1,1,20,940000,70
1512,jd1712,20171221,4700,4700,4750,4982,4750,4982,4831,282,131,70,3382280,0
1513,jd1712,20171222,4982,4831,0,0,0,4831,4831,0,0,0,0,0
1514,jd1712,20171225,4831,4831,0,0,0,4831,4831,0,0,0,0,0
1515,jd1712,20171226,4831,4831,0,0,0,4794,4794,-37,-37,0,0,0
1516,jd1801,20170117,3701,3701,3720,3800,3720,3785,3773,84,72,878,33133540,632
1517,jd1801,20170118,3785,3773,3792,3823,3775,3823,3794,50,21,752,28535380,1100
1518,jd1801,20170119,3823,3794,3838,3868,3826,3844,3845,50,51,906,34837300,1292
1519,jd1801,20170120,3844,3845,3844,3886,3797,3839,3830,-6,-15,442,16929420,1382
1520,jd1801,20170123,3839,3830,3850,3860,3838,3857,3851,27,21,344,13248780,1584
1521,jd1801,20170124,3857,3851,3862,3921,3862,3912,3904,61,53,920,35919980,2088
1522,jd1801,20170125,3912,3904,3932,3932,3891,3909,3901,5,-3,212,8270740,2112
1523,jd1801,20170126,3909,3901,3915,3919,3900,3911,3907,10,6,134,5236360,2148
1524,jd1801,20170203,3911,3907,3920,3920,3882,3918,3905,11,-2,1372,53583820,3114
1525,jd1801,20170206,3918,3905,3898,3939,3895,3929,3919,24,14,1228,48131980,3784
1526,jd1801,20170207,3929,3919,3929,3943,3922,3936,3937,17,18,1312,51663260,4672
1527,jd1801,20170208,3936,3937,3945,3961,3934,3947,3949,10,12,2208,87211200,5694
1528,jd1801,20170209,3947,3949,3937,3961,3929,3942,3945,-7,-4,1632,64383140,6340
1529,jd1801,20170210,3942,3945,3943,3943,3900,3918,3913,-27,-32,2942,115121000,6920
1530,jd1801,20170213,3918,3913,3924,3959,3880,3958,3930,45,17,2054,80727560,7476
1531,jd1801,20170214,3958,3930,3968,3975,3948,3959,3955,29,25,644,25471940,7738
1532,jd1801,20170215,3959,3955,3955,3956,3923,3937,3941,-18,-14,1008,39727920,7860
1533,jd1801,20170216,3937,3941,3938,3955,3938,3947,3947,6,6,886,34976220,8142
1534,jd1801,20170217,3947,3947,3950,3960,3940,3955,3950,8,3,2400,94800780,8460
1535,jd1801,20170220,3955,3950,3967,3999,3947,3999,3975,49,25,2806,111550560,9610
1536,jd1801,20170221,3999,3975,4007,4019,3995,4008,4006,33,31,1686,67557260,10272
1537,jd1801,20170222,4008,4006,4011,4066,3999,4065,4038,59,32,2258,91194660,11110
1538,jd1801,20170223,4065,4038,4075,4087,4060,4085,4074,47,36,2434,99177320,11324
1539,jd1801,20170224,4085,4074,4080,4116,4059,4094,4091,20,17,2740,112100140,11618
1540,jd1801,20170227,4094,4091,4099,4140,4095,4134,4118,43,27,1770,72902220,11626
1541,jd1801,20170228,4134,4118,4142,4158,4108,4141,4139,23,21,1380,57129980,11796
1542,jd1801,20170301,4141,4139,4150,4160,4121,4139,4139,0,0,1096,45366160,12082
1543,jd1801,20170302,4139,4139,4147,4149,4102,4111,4112,-28,-27,1658,68191500,12094
1544,jd1801,20170303,4111,4112,4097,4133,4080,4129,4110,17,-2,1512,62152940,12374
1545,jd1801,20170306,4129,4110,4127,4127,4100,4122,4119,12,9,1176,48441700,12696
1546,jd1801,20170307,4122,4119,4129,4129,4098,4098,4109,-21,-10,1306,53671240,12912
1547,jd1801,20170308,4098,4109,4066,4093,4058,4078,4077,-31,-32,2150,87673940,13310
1548,jd1801,20170309,4078,4077,4068,4110,4067,4092,4092,15,15,3330,136289500,14250
1549,jd1801,20170310,4092,4092,4090,4120,4072,4077,4098,-15,6,3026,124032020,14574
1550,jd1801,20170313,4077,4098,4084,4100,4061,4083,4088,-15,-10,1758,71868580,14932
1551,jd1801,20170314,4083,4088,4097,4108,4081,4096,4096,8,8,2084,85363460,15588
1552,jd1801,20170315,4096,4096,4103,4115,4066,4072,4078,-24,-18,3006,122584800,16534
1553,jd1801,20170316,4072,4078,4078,4082,3958,3977,3998,-101,-80,10042,401500260,18834
1554,jd1801,20170317,3977,3998,3970,3989,3945,3978,3972,-20,-26,6816,270791160,20026
1555,jd1801,20170320,3978,3972,3980,4009,3978,4008,3999,36,27,6896,275818140,20208
1556,jd1801,20170321,4008,3999,4011,4022,3993,4006,4008,7,9,6282,251809160,20664
1557,jd1801,20170322,4006,4008,4005,4005,3984,3992,3996,-16,-12,2622,104787880,20304
1558,jd1801,20170323,3992,3996,3994,3996,3974,3987,3987,-9,-9,2140,85326820,19870
1559,jd1801,20170324,3987,3987,3986,3994,3975,3985,3985,-2,-2,2270,90481620,19898
1560,jd1801,20170327,3985,3985,3987,4003,3974,3994,3989,9,4,3938,157113520,19932
1561,jd1801,20170328,3994,3989,4000,4002,3960,3965,3980,-24,-9,4850,193050400,20208
1562,jd1801,20170329,3965,3980,3970,3975,3948,3960,3960,-20,-20,2482,98310440,20294
1563,jd1801,20170330,3960,3960,3968,3969,3853,3862,3899,-98,-61,11160,435149500,21144
1564,jd1801,20170331,3862,3899,3860,3876,3812,3837,3842,-62,-57,8138,312723440,21310
1565,jd1801,20170405,3837,3842,3839,3857,3814,3832,3842,-10,0,5696,218877400,22304
1566,jd1801,20170406,3832,3842,3842,3856,3823,3852,3839,10,-3,4114,157963740,23134
1567,jd1801,20170407,3852,3839,3830,3871,3824,3864,3853,25,14,5726,220672040,23540
1568,jd1801,20170410,3864,3853,3860,3862,3806,3814,3823,-39,-30,8922,341173520,25892
1569,jd1801,20170411,3814,3823,3811,3828,3798,3803,3813,-20,-10,6154,234698420,27468
1570,jd1801,20170412,3803,3813,3795,3827,3791,3804,3810,-9,-3,4948,188552000,27792
1571,jd1801,20170413,3804,3810,3805,3806,3718,3733,3747,-77,-63,10780,403969520,28566
1572,jd1801,20170414,3733,3747,3736,3741,3693,3696,3712,-51,-35,7194,267096980,28888
1573,jd1801,20170417,3696,3712,3699,3749,3695,3743,3727,31,15,9238,344344040,28178
1574,jd1801,20170418,3743,3727,3740,3741,3666,3690,3702,-37,-25,10076,373070440,27344
1575,jd1801,20170419,3690,3702,3675,3675,3572,3602,3614,-100,-88,17054,616353660,31570
1576,jd1801,20170420,3602,3614,3598,3668,3585,3660,3625,46,11,14614,529823500,33858
1577,jd1801,20170421,3660,3625,3661,3692,3646,3684,3673,59,48,7782,285901260,34688
1578,jd1801,20170424,3684,3673,3672,3746,3645,3735,3706,62,33,19252,713479940,38298
1579,jd1801,20170425,3735,3706,3737,3839,3724,3827,3789,121,83,27108,1027359240,39400
1580,jd1801,20170426,3827,3789,3827,3890,3826,3880,3865,91,76,25768,996100340,41848
1581,jd1801,20170427,3880,3865,3885,3886,3800,3835,3840,-30,-25,21320,818693220,40098
1582,jd1801,20170428,3835,3840,3828,3896,3822,3894,3866,54,26,20012,773858560,43954
1583,jd1801,20170502,3894,3866,3908,3930,3881,3917,3904,51,38,15982,624091380,45600
1584,jd1801,20170503,3917,3904,3931,3932,3870,3873,3910,-31,6,33468,1308656420,42692
1585,jd1801,20170504,3873,3910,3867,3936,3850,3904,3897,-6,-13,29588,1153291280,44702
1586,jd1801,20170505,3904,3897,3904,3918,3890,3917,3906,20,9,17494,683413500,44982
1587,jd1801,20170508,3917,3906,3919,3919,3790,3823,3843,-83,-63,76524,2940875240,51930
1588,jd1801,20170509,3823,3843,3808,3858,3796,3850,3830,7,-13,52926,2027570800,58706
1589,jd1801,20170510,3850,3830,3858,3877,3804,3810,3830,-20,0,39016,1494701300,56710
1590,jd1801,20170511,3810,3830,3808,3810,3673,3721,3724,-109,-106,87852,3272444080,54472
1591,jd1801,20170512,3721,3724,3715,3738,3688,3709,3715,-15,-9,25060,931019580,54498
1592,jd1801,20170515,3709,3715,3700,3706,3655,3677,3683,-38,-32,33482,1233317060,58406
1593,jd1801,20170516,3677,3683,3677,3732,3651,3723,3702,40,19,35996,1332740300,62774
1594,jd1801,20170517,3723,3702,3723,3782,3717,3770,3760,68,58,42954,1615185200,66858
1595,jd1801,20170518,3770,3760,3769,3854,3763,3850,3821,90,61,48450,1851405440,72760
1596,jd1801,20170519,3850,3821,3852,3878,3820,3850,3844,29,23,34894,1341465180,71004
1597,jd1801,20170522,3850,3844,3861,3868,3806,3822,3835,-22,-9,42460,1628390000,68338
1598,jd1801,20170523,3822,3835,3814,3824,3734,3794,3782,-41,-53,54164,2048681660,68808
1599,jd1801,20170524,3794,3782,3790,3837,3782,3795,3804,13,22,35132,1336626920,67678
1600,jd1801,20170525,3795,3804,3800,3801,3741,3743,3768,-61,-36,35724,1346340660,66246
1601,jd1801,20170526,3743,3768,3739,3760,3696,3713,3725,-55,-43,45048,1678315860,64028
1602,jd1801,20170531,3713,3725,3702,3791,3697,3739,3756,14,31,54106,2032307500,64068
1603,jd1801,20170601,3739,3756,3750,3903,3743,3886,3852,130,96,130970,5045249900,72894
1604,jd1801,20170602,3886,3852,3880,3896,3819,3854,3849,2,-3,56132,2160578060,64702
1605,jd1801,20170605,3854,3849,3850,3850,3808,3843,3834,-6,-15,17678,677941900,65046
1606,jd1801,20170606,3843,3834,3840,3877,3828,3846,3857,12,23,24168,932167060,65086
1607,jd1801,20170607,3846,3857,3848,3874,3831,3868,3851,11,-6,19308,743600260,65432
1608,jd1801,20170608,3868,3851,3875,3917,3871,3895,3894,44,43,23712,923392920,65896
1609,jd1801,20170609,3895,3894,3909,3933,3882,3892,3909,-2,15,38292,1497115440,66198
1610,jd1801,20170612,3892,3909,3900,3906,3859,3896,3884,-13,-25,28068,1090273480,67858
1611,jd1801,20170613,3896,3884,3895,3953,3875,3946,3923,62,39,47528,1864987420,73640
1612,jd1801,20170614,3946,3923,3955,3975,3923,3943,3945,20,22,28618,1129247400,72114
1613,jd1801,20170615,3943,3945,3945,3964,3905,3932,3936,-13,-9,43472,1711146200,70552
1614,jd1801,20170616,3932,3936,3948,3950,3869,3871,3903,-65,-33,63714,2486831380,68370
1615,jd1801,20170619,3871,3903,3882,3947,3882,3931,3920,28,17,61590,2414673340,70556
1616,jd1801,20170620,3931,3920,3921,3929,3872,3897,3894,-23,-26,36912,1437457920,69372
1617,jd1801,20170621,3897,3894,3900,3942,3874,3941,3910,47,16,57420,2245338460,71394
1618,jd1801,20170622,3941,3910,3937,4040,3912,3976,3977,66,67,99536,3959208760,71412
1619,jd1801,20170623,3976,3977,3970,3970,3913,3943,3936,-34,-41,48922,1925911420,67842
1620,jd1801,20170626,3943,3936,3908,3977,3900,3966,3950,30,14,34242,1352846240,68156
1621,jd1801,20170627,3966,3950,3976,4023,3960,4020,3999,70,49,40468,1618373280,71528
1622,jd1801,20170628,4020,3999,4025,4045,4003,4033,4022,34,23,34192,1375278640,76848
1623,jd1801,20170629,4033,4022,4031,4036,3982,3989,4006,-33,-16,30990,1241661420,74062
1624,jd1801,20170630,3989,4006,3989,3989,3943,3955,3963,-51,-43,32842,1301775300,72668
1625,jd1801,20170703,3955,3963,3915,3980,3912,3964,3959,1,-4,22290,882632760,72876
1626,jd1801,20170704,3964,3959,3958,3958,3781,3800,3852,-159,-107,103070,3971282720,76112
1627,jd1801,20170705,3800,3852,3800,3844,3792,3840,3820,-12,-32,48498,1852707220,72668
1628,jd1801,20170706,3840,3820,3844,3984,3844,3954,3939,134,119,109328,4307122080,76810
1629,jd1801,20170707,3954,3939,3952,3974,3926,3942,3947,3,8,53820,2124526780,71622
1630,jd1801,20170710,3942,3947,3979,3979,3907,3914,3943,-33,-4,30718,1211457320,70996
1631,jd1801,20170711,3914,3943,3921,3948,3903,3928,3925,-15,-18,22044,865422800,70574
1632,jd1801,20170712,3928,3925,3932,3938,3872,3891,3896,-34,-29,31094,1211516340,72390
1633,jd1801,20170713,3891,3896,3894,3894,3870,3883,3882,-13,-14,14172,550233580,72262
1634,jd1801,20170714,3883,3882,3872,3914,3852,3899,3889,17,7,23804,925773760,73378
1635,jd1801,20170717,3899,3889,3889,3980,3874,3971,3936,82,47,44560,1753944100,81958
1636,jd1801,20170718,3971,3936,3978,4001,3948,3979,3976,43,40,32818,1305091640,81998
1637,jd1801,20170719,3979,3976,3995,4025,3977,4004,3999,28,23,24998,999727060,80226
1638,jd1801,20170720,4004,3999,4004,4005,3975,3982,3988,-17,-11,24176,964316120,80734
1639,jd1801,20170721,3982,3988,3990,3997,3970,3987,3983,-1,-5,22172,883306440,83152
1640,jd1801,20170724,3987,3983,3981,3981,3935,3960,3957,-23,-26,31462,1245193320,83456
1641,jd1801,20170725,3960,3957,3982,4071,3982,4060,4033,103,76,75208,3033541540,96750
1642,jd1801,20170726,4060,4033,4070,4109,4052,4067,4079,34,46,68810,2806819340,104492
1643,jd1801,20170727,4067,4079,4080,4100,4072,4097,4090,18,11,44636,1825855880,113592
1644,jd1801,20170728,4097,4090,4093,4120,4070,4087,4093,-3,3,66316,2714888580,117374
1645,jd1801,20170731,4087,4093,4135,4160,4084,4132,4121,39,28,78570,3238357080,126624
1646,jd1801,20170801,4132,4121,4117,4130,4078,4081,4104,-40,-17,57266,2350599620,129244
1647,jd1801,20170802,4081,4104,4060,4122,4052,4107,4096,3,-8,69136,2832385020,136966
1648,jd1801,20170803,4107,4096,4096,4111,4080,4088,4094,-8,-2,55790,2284288100,130926
1649,jd1801,20170804,4088,4094,4120,4290,4117,4260,4218,166,124,248006,10461671380,168666
1650,jd1801,20170807,4260,4218,4298,4410,4272,4295,4325,77,107,249786,10804955800,178780
1651,jd1801,20170808,4295,4325,4295,4358,4281,4345,4328,20,3,175570,7599643780,194020
1652,jd1801,20170809,4345,4328,4351,4520,4350,4461,4452,133,124,331816,14773537080,209520
1653,jd1801,20170810,4461,4452,4450,4487,4421,4469,4454,17,2,179900,8013689900,204576
1654,jd1801,20170811,4469,4454,4450,4535,4392,4503,4459,49,5,320832,14306217680,216650
1655,jd1801,20170814,4503,4459,4477,4543,4451,4515,4499,56,40,312240,14049551320,231332
1656,jd1801,20170815,4515,4499,4526,4526,4435,4457,4470,-42,-29,315274,14094208720,219138
1657,jd1801,20170816,4457,4470,4480,4508,4451,4478,4480,8,10,237258,10630126880,225230
1658,jd1801,20170817,4478,4480,4500,4510,4416,4447,4450,-33,-30,302734,13472241340,226312
1659,jd1801,20170818,4447,4450,4446,4508,4444,4465,4475,15,25,265168,11868694340,224506
1660,jd1801,20170821,4465,4475,4496,4626,4486,4593,4583,118,108,320062,14670198400,243050
1661,jd1801,20170822,4593,4583,4589,4605,4555,4575,4585,-8,2,178618,8189652400,229500
1662,jd1801,20170823,4575,4585,4550,4551,4363,4412,4428,-173,-157,403880,17886386720,208494
1663,jd1801,20170824,4412,4428,4424,4444,4359,4378,4390,-50,-38,210356,9236447520,210142
1664,jd1801,20170825,4378,4390,4390,4396,4303,4323,4344,-67,-46,306556,13319094800,204958
1665,jd1801,20170828,4323,4344,4300,4365,4263,4332,4327,-12,-17,251408,10879524280,215438
1666,jd1801,20170829,4332,4327,4352,4386,4322,4337,4349,10,22,211360,9193075980,215746
1667,jd1801,20170830,4337,4349,4359,4365,4218,4244,4270,-105,-79,319888,13661167240,221990
1668,jd1801,20170831,4244,4270,4228,4269,4212,4227,4241,-43,-29,223914,9497251720,219920
1669,jd1801,20170901,4227,4241,4255,4283,4213,4227,4247,-14,6,212028,9005111620,223490
1670,jd1801,20170904,4227,4247,4260,4325,4240,4263,4281,16,34,281940,12072567420,220426
1671,jd1801,20170905,4263,4281,4285,4298,4201,4244,4250,-37,-31,268332,11406116920,218726
1672,jd1801,20170906,4244,4250,4260,4300,4251,4273,4274,23,24,226140,9666777100,214366
1673,jd1801,20170907,4273,4274,4257,4284,4160,4179,4206,-95,-68,356856,15010057460,226860
1674,jd1801,20170908,4179,4206,4189,4198,4122,4153,4163,-53,-43,202356,8424828760,210888
1675,jd1801,20170911,4153,4163,4126,4218,4126,4194,4189,31,26,223926,9381153640,208566
1676,jd1801,20170912,4194,4189,4195,4236,4166,4193,4199,4,10,193320,8118278500,207508
1677,jd1801,20170913,4193,4199,4186,4212,4088,4152,4146,-47,-53,244986,10158390740,209510
1678,jd1801,20170914,4152,4146,4160,4202,4143,4193,4173,47,27,208996,8721406000,202458
1679,jd1801,20170915,4193,4173,4190,4220,4151,4179,4184,6,11,234328,9804955080,206598
1680,jd1801,20170918,4179,4184,4130,4148,4053,4079,4081,-105,-103,271126,11067267320,213954
1681,jd1801,20170919,4079,4081,4050,4080,4038,4049,4058,-32,-23,137510,5581411820,207406
1682,jd1801,20170920,4049,4058,4055,4089,4055,4081,4075,23,17,118220,4817610980,204302
1683,jd1801,20170921,4081,4075,4092,4265,4020,4171,4117,96,42,401114,16514293040,201880
1684,jd1801,20170922,4171,4117,4169,4229,4150,4177,4188,60,71,252812,10589154640,197262
1685,jd1801,20170925,4177,4188,4130,4158,4055,4089,4098,-99,-90,246026,10083266540,193588
1686,jd1801,20170926,4089,4098,4096,4150,4085,4120,4119,22,21,170516,7023745600,189688
1687,jd1801,20170927,4120,4119,4120,4141,4072,4117,4106,-2,-13,196066,8050679880,193030
1688,jd1801,20170928,4117,4106,4103,4216,4080,4169,4149,63,43,280342,11632846460,185954
1689,jd1801,20170929,4169,4149,4167,4208,4157,4185,4181,36,32,169974,7107337280,174342
1690,jd1801,20171009,4185,4181,4209,4265,4128,4198,4182,17,1,190336,7961670320,178744
1691,jd1801,20171010,4198,4182,4185,4249,4176,4210,4216,28,34,208934,8809829200,195262
1692,jd1801,20171011,4210,4216,4205,4288,4192,4271,4259,55,43,253210,10785460300,219544
1693,jd1801,20171012,4271,4259,4265,4279,4241,4251,4259,-8,0,136434,5810838280,205738
1694,jd1801,20171013,4251,4259,4246,4265,4205,4240,4232,-19,-27,212280,8984877100,204186
1695,jd1801,20171016,4240,4232,4242,4313,4235,4267,4276,35,44,219558,9388633220,209022
1696,jd1801,20171017,4267,4276,4250,4296,4223,4269,4264,-7,-12,147702,6298266000,208348
1697,jd1801,20171018,4269,4264,4275,4296,4243,4272,4271,8,7,128464,5487718860,208724
1698,jd1801,20171019,4272,4271,4281,4343,4270,4322,4319,51,48,231196,9985806120,221936
1699,jd1801,20171020,4322,4319,4340,4394,4337,4354,4369,35,50,205666,8985736220,218682
1700,jd1801,20171023,4354,4369,4355,4359,4294,4330,4328,-39,-41,126516,5475902720,209614
1701,jd1801,20171024,4330,4328,4320,4375,4308,4345,4344,17,16,132580,5759301240,216834
1702,jd1801,20171025,4345,4344,4348,4364,4322,4340,4342,-4,-2,112994,4906578580,214534
1703,jd1801,20171026,4340,4342,4347,4384,4328,4341,4352,-1,10,143258,6235102220,214786
1704,jd1801,20171027,4341,4352,4350,4355,4255,4290,4289,-62,-63,210654,9035572420,202846
1705,jd1801,20171030,4290,4289,4294,4316,4228,4237,4271,-52,-18,142450,6084972720,197288
1706,jd1801,20171031,4237,4271,4238,4259,4220,4249,4244,-22,-27,90370,3835413900,189522
1707,jd1801,20171101,4249,4244,4265,4334,4253,4289,4293,45,49,165598,7110725220,183162
1708,jd1801,20171102,4289,4293,4297,4318,4270,4316,4294,23,1,101966,4379042600,180876
1709,jd1801,20171103,4316,4294,4312,4322,4288,4295,4301,1,7,80556,3464762640,177580
1710,jd1801,20171106,4295,4301,4297,4375,4297,4346,4348,45,47,125992,5478743800,185272
1711,jd1801,20171107,4346,4348,4362,4408,4351,4400,4379,52,31,135402,5930349560,198060
1712,jd1801,20171108,4400,4379,4420,4445,4394,4411,4422,32,43,179628,7944028080,202610
1713,jd1801,20171109,4411,4422,4422,4444,4390,4427,4415,5,-7,123948,5472503020,204556
1714,jd1801,20171110,4427,4415,4420,4468,4405,4414,4428,-1,13,147382,6526595580,207132
1715,jd1801,20171113,4414,4428,4417,4428,4372,4422,4404,-6,-24,135138,5951794340,204150
1716,jd1801,20171114,4422,4404,4412,4438,4400,4416,4413,12,9,75808,3346032240,196782
1717,jd1801,20171115,4416,4413,4390,4455,4375,4415,4423,2,10,180222,7971617480,203842
1718,jd1801,20171116,4415,4423,4418,4430,4367,4407,4402,-16,-21,118358,5210591820,189974
1719,jd1801,20171117,4407,4402,4391,4444,4360,4407,4392,5,-10,137504,6040261700,186948
1720,jd1801,20171120,4407,4392,4409,4410,4322,4339,4360,-53,-32,147410,6428458600,173000
1721,jd1801,20171121,4339,4360,4360,4390,4348,4381,4366,21,6,107238,4682794200,168450
1722,jd1801,20171122,4381,4366,4410,4495,4398,4490,4451,124,85,227500,10126111140,187254
1723,jd1801,20171123,4490,4451,4508,4525,4480,4482,4499,31,48,94404,4247672160,173694
1724,jd1801,20171124,4482,4499,4490,4516,4472,4491,4493,-8,-6,68958,3098744760,164476
1725,jd1801,20171127,4491,4493,4486,4538,4466,4498,4495,5,2,108998,4900265860,158684
1726,jd1801,20171128,4498,4495,4515,4515,4476,4509,4496,14,1,69120,3108069020,152930
1727,jd1801,20171129,4509,4496,4520,4578,4496,4569,4538,73,42,128138,5815245320,151156
1728,jd1801,20171130,4569,4538,4575,4588,4473,4493,4530,-45,-8,115038,5212310800,115704
1729,jd1801,20171201,4493,4530,4501,4518,4475,4497,4500,-33,-30,64150,2887159920,103816
1730,jd1801,20171204,4497,4500,4497,4515,4460,4500,4494,0,-6,39780,1788064820,93054
1731,jd1801,20171205,4500,4494,4500,4548,4488,4520,4517,26,23,45572,2058929540,86990
1732,jd1801,20171206,4520,4517,4516,4530,4505,4524,4515,7,-2,24254,1095090580,83664
1733,jd1801,20171207,4524,4515,4542,4548,4519,4527,4533,12,18,31186,1413810360,81346
1734,jd1801,20171208,4527,4533,4545,4558,4476,4494,4506,-39,-27,38272,1724675680,69596
1735,jd1801,20171211,4494,4506,4466,4483,4418,4425,4442,-81,-64,33272,1478236460,58024
1736,jd1801,20171212,4425,4442,4402,4441,4402,4409,4419,-33,-23,17878,790153820,51306
1737,jd1801,20171213,4409,4419,4400,4408,4337,4392,4376,-27,-43,34770,1521624820,39210
1738,jd1801,20171214,4392,4376,4380,4458,4378,4451,4418,75,42,15360,678754780,34502
1739,jd1801,20171215,4451,4418,4450,4487,4442,4485,4465,67,47,13342,595829140,33634
1740,jd1801,20171218,4485,4465,4520,4537,4490,4498,4503,33,38,9044,407337740,31958
1741,jd1801,20171219,4498,4503,4490,4490,4436,4449,4454,-54,-49,8798,391902300,30114
1742,jd1801,20171220,4449,4454,4420,4448,4400,4426,4429,-28,-25,5304,234951460,28914
1743,jd1801,20171221,4426,4429,4450,4486,4438,4472,4462,43,33,6538,291768360,26876
1744,jd1801,20171222,4472,4462,4472,4492,4468,4486,4479,24,17,4158,186278160,25450
1745,jd1801,20171225,4486,4479,4503,4505,4463,4485,4481,6,2,4586,205516160,23618
1746,jd1801,20171226,4485,4481,4450,4453,4409,4440,4432,-41,-49,6474,286989020,19616
1747,jd1801,20171227,4440,4432,4433,4467,4428,4466,4451,34,19,4404,196029640,17744
1748,jd1801,20171228,4466,4451,4455,4480,4445,4479,4467,28,16,5536,247321160,13722
1749,jd1801,20171229,4479,4467,4476,4682,4472,4653,4567,186,100,17816,813802960,822
1750,jd1802,20170217,3947,3947,3720,3899,3720,3793,3804,-154,-143,182,6924920,106
1751,jd1802,20170220,3793,3804,3879,3879,3790,3801,3818,-3,14,86,3284140,136
1752,jd1802,20170221,3801,3818,3793,3900,3793,3882,3873,64,55,166,6430000,248
1753,jd1802,20170222,3882,3873,3925,3938,3882,3926,3919,53,46,98,3841560,306
1754,jd1802,20170223,3926,3919,3992,3992,3896,3915,3935,-4,16,376,14798240,404
1755,jd1802,20170224,3915,3935,3844,3950,3844,3896,3884,-39,-51,344,13363820,468
1756,jd1802,20170227,3896,3884,3932,3988,3931,3988,3957,104,73,180,7122700,438
1757,jd1802,20170228,3988,3957,4062,4062,3986,3996,4012,39,55,30,1203720,442
1758,jd1802,20170301,3996,4012,4064,4064,4003,4003,4012,-9,0,110,4413360,420
1759,jd1802,20170302,4003,4012,4019,4019,3989,3999,3999,-13,-13,64,2559600,438
1760,jd1802,20170303,3999,3999,3978,4000,3976,4000,3995,1,-4,26,1038720,440
1761,jd1802,20170306,4000,3995,4016,4016,4006,4015,4013,20,18,40,1605200,452
1762,jd1802,20170307,4015,4013,3993,4012,3992,3992,3995,-21,-18,12,479480,456
1763,jd1802,20170308,3992,3995,3986,3986,3926,3931,3951,-64,-44,68,2686960,464
1764,jd1802,20170309,3931,3951,3973,3973,3934,3953,3953,2,2,26,1027840,474
1765,jd1802,20170310,3953,3953,3967,3967,3954,3955,3957,2,4,16,633160,472
1766,jd1802,20170313,3955,3957,3960,3960,3959,3959,3959,2,2,6,237560,476
1767,jd1802,20170314,3959,3959,3970,3985,3927,3970,3971,11,12,42,1667880,482
1768,jd1802,20170315,3970,3971,3981,3982,3957,3957,3969,-14,-2,18,714520,492
1769,jd1802,20170316,3957,3969,3951,3951,3878,3883,3905,-86,-64,140,5467160,560
1770,jd1802,20170317,3883,3905,3875,3879,3866,3879,3871,-26,-34,54,2090420,570
1771,jd1802,20170320,3879,3871,3894,3896,3888,3896,3893,25,22,12,467160,576
1772,jd1802,20170321,3896,3893,3905,3947,3889,3903,3906,10,13,54,2109520,612
1773,jd1802,20170322,3903,3906,3888,3899,3887,3888,3892,-18,-14,30,1167640,606
1774,jd1802,20170323,3888,3892,3892,3899,3888,3889,3893,-3,1,52,2024480,624
1775,jd1802,20170324,3889,3893,3898,3899,3878,3878,3887,-15,-6,28,1088520,626
1776,jd1802,20170327,3878,3887,3874,3895,3874,3895,3885,8,-2,16,621620,624
1777,jd1802,20170328,3895,3885,3861,3903,3861,3866,3876,-19,-9,60,2325720,642
1778,jd1802,20170329,3866,3876,3860,3873,3851,3852,3859,-24,-17,32,1234900,644
1779,jd1802,20170330,3852,3859,3838,3838,3752,3765,3800,-94,-59,186,7069060,622
1780,jd1802,20170331,3765,3800,3727,3764,3715,3727,3730,-73,-70,120,4477040,614
1781,jd1802,20170405,3727,3730,3745,3745,3730,3730,3739,0,9,84,3140960,664
1782,jd1802,20170406,3730,3739,3651,3737,3651,3736,3718,-3,-21,66,2454320,676
1783,jd1802,20170407,3736,3718,3711,3740,3711,3723,3728,5,10,38,1416700,680
1784,jd1802,20170410,3723,3728,3700,3734,3699,3707,3703,-21,-25,92,3407360,688
1785,jd1802,20170411,3707,3703,3700,3712,3689,3697,3700,-6,-3,82,3034540,704
1786,jd1802,20170412,3697,3700,3716,3716,3708,3708,3713,8,13,8,297080,706
1787,jd1802,20170413,3708,3713,3678,3721,3639,3653,3659,-60,-54,156,5709000,752
1788,jd1802,20170414,3653,3659,3640,3651,3634,3639,3641,-20,-18,46,1675100,764
1789,jd1802,20170417,3639,3641,3627,3646,3627,3645,3643,4,2,76,2769040,764
1790,jd1802,20170418,3645,3643,3666,3668,3610,3611,3624,-32,-19,132,4784680,774
1791,jd1802,20170419,3611,3624,3517,3570,3501,3529,3535,-95,-89,116,4101160,776
1792,jd1802,20170420,3529,3535,3476,3586,3476,3582,3558,47,23,120,4269960,812
1793,jd1802,20170421,3582,3558,3598,3619,3592,3601,3601,43,43,118,4249380,866
1794,jd1802,20170424,3601,3601,3528,3639,3528,3628,3604,27,3,162,5838520,904
1795,jd1802,20170425,3628,3604,3619,3699,3619,3687,3666,83,62,158,5793660,900
1796,jd1802,20170426,3687,3666,3746,3757,3707,3730,3734,64,68,160,5975520,918
1797,jd1802,20170427,3730,3734,3657,3723,3602,3683,3675,-51,-59,170,6247640,958
1798,jd1802,20170428,3683,3675,3749,3749,3669,3730,3718,55,43,124,4610980,940
1799,jd1802,20170502,3730,3718,3745,3753,3719,3740,3733,22,15,112,4180960,928
1800,jd1802,20170503,3740,3733,3652,3770,3652,3732,3741,-1,8,104,3891120,922
1801,jd1802,20170504,3732,3741,3720,3766,3720,3758,3747,17,6,166,6220360,964
1802,jd1802,20170505,3758,3747,3775,3775,3706,3759,3749,12,2,36,1349640,970
1803,jd1802,20170508,3759,3749,3750,3750,3700,3715,3719,-34,-30,334,12422520,984
1804,jd1802,20170509,3715,3719,3689,3755,3689,3743,3732,24,13,156,5823120,968
1805,jd1802,20170510,3743,3732,3741,3750,3713,3719,3732,-13,0,258,9628880,960
1806,jd1802,20170511,3719,3732,3700,3708,3611,3636,3652,-96,-80,658,24032140,1080
1807,jd1802,20170512,3636,3652,3610,3659,3610,3618,3630,-34,-22,232,8422340,1122
1808,jd1802,20170515,3618,3630,3610,3615,3588,3600,3598,-30,-32,328,11804160,1142
1809,jd1802,20170516,3600,3598,3599,3677,3599,3632,3623,34,25,524,18986180,1180
1810,jd1802,20170517,3632,3623,3649,3666,3632,3652,3651,29,28,344,12560560,1186
1811,jd1802,20170518,3652,3651,3587,3719,3586,3708,3683,57,32,216,7956100,1268
1812,jd1802,20170519,3708,3683,3719,3719,3688,3719,3707,36,24,190,7044780,1322
1813,jd1802,20170522,3719,3707,3719,3759,3700,3710,3725,3,18,358,13335760,1378
1814,jd1802,20170523,3710,3725,3700,3719,3679,3709,3699,-16,-26,214,7916260,1404
1815,jd1802,20170524,3709,3699,3723,3737,3700,3710,3717,11,18,96,3568640,1418
1816,jd1802,20170525,3710,3717,3700,3731,3700,3702,3713,-15,-4,234,8690720,1402
1817,jd1802,20170526,3702,3713,3702,3702,3682,3689,3692,-24,-21,236,8714420,1362
1818,jd1802,20170531,3689,3692,3702,3829,3701,3777,3786,85,94,1042,39459640,1550
1819,jd1802,20170601,3777,3786,3815,3869,3777,3844,3819,58,33,1568,59894320,1448
1820,jd1802,20170602,3844,3819,3844,3855,3802,3830,3824,11,5,556,21264620,1488
1821,jd1802,20170605,3830,3824,3833,3833,3810,3815,3819,-9,-5,118,4506960,1466
1822,jd1802,20170606,3815,3819,3811,3831,3808,3819,3820,0,1,126,4814160,1438
1823,jd1802,20170607,3819,3820,3816,3819,3789,3810,3800,-10,-20,254,9653160,1496
1824,jd1802,20170608,3810,3800,3797,3822,3797,3810,3810,10,10,178,6783320,1492
1825,jd1802,20170609,3810,3810,3810,3813,3761,3778,3785,-32,-25,448,16960560,1518
1826,jd1802,20170612,3778,3785,3744,3768,3691,3737,3735,-48,-50,574,21442960,1646
1827,jd1802,20170613,3737,3735,3744,3780,3734,3770,3757,35,22,284,10670020,1772
1828,jd1802,20170614,3770,3757,3780,3800,3774,3781,3785,24,28,196,7419000,1788
1829,jd1802,20170615,3781,3785,3780,3791,3772,3785,3782,0,-3,450,17020480,1868
1830,jd1802,20170616,3785,3782,3792,3793,3716,3727,3756,-55,-26,1044,39215300,1914
1831,jd1802,20170619,3727,3756,3737,3787,3737,3767,3760,11,4,326,12258520,1904
1832,jd1802,20170620,3767,3760,3757,3762,3727,3732,3736,-28,-24,328,12254480,1994
1833,jd1802,20170621,3732,3736,3736,3748,3722,3742,3735,6,-1,404,15089660,2066
1834,jd1802,20170622,3742,3735,3728,3805,3721,3751,3762,16,27,710,26715860,2244
1835,jd1802,20170623,3751,3762,3739,3758,3726,3733,3738,-29,-24,532,19891140,2132
1836,jd1802,20170626,3733,3738,3706,3762,3706,3754,3741,16,3,138,5163340,2122
1837,jd1802,20170627,3754,3741,3756,3795,3756,3788,3781,47,40,504,19057900,2234
1838,jd1802,20170628,3788,3781,3765,3808,3765,3791,3793,10,12,384,14566980,2312
1839,jd1802,20170629,3791,3793,3798,3798,3756,3757,3774,-36,-19,238,8983460,2256
1840,jd1802,20170630,3757,3774,3756,3756,3726,3726,3740,-48,-34,314,11745460,2140
1841,jd1802,20170703,3726,3740,3733,3765,3733,3761,3752,21,12,262,9831020,2140
1842,jd1802,20170704,3761,3752,3729,3754,3670,3678,3702,-74,-50,2346,86859720,3236
1843,jd1802,20170705,3678,3702,3678,3733,3678,3711,3708,9,6,1346,49910920,4026
1844,jd1802,20170706,3711,3708,3731,3796,3724,3787,3764,79,56,1064,40056080,4316
1845,jd1802,20170707,3787,3764,3784,3788,3757,3757,3774,-7,10,202,7623720,4334
1846,jd1802,20170710,3757,3774,3770,3777,3732,3739,3757,-35,-17,534,20067640,4498
1847,jd1802,20170711,3739,3757,3740,3743,3723,3736,3735,-21,-22,94,3511120,4514
1848,jd1802,20170712,3736,3735,3725,3738,3703,3721,3716,-14,-19,776,28837060,4598
1849,jd1802,20170713,3721,3716,3688,3709,3680,3699,3693,-17,-23,576,21276720,4910
1850,jd1802,20170714,3699,3693,3700,3756,3694,3730,3727,37,34,372,13866400,4890
1851,jd1802,20170717,3730,3727,3739,3790,3719,3780,3766,53,39,504,18981120,5084
1852,jd1802,20170718,3780,3766,3780,3815,3776,3805,3800,39,34,524,19913620,5132
1853,jd1802,20170719,3805,3800,3815,3827,3778,3802,3811,2,11,372,14177540,5300
1854,jd1802,20170720,3802,3811,3785,3800,3783,3786,3788,-25,-23,88,3334280,5322
1855,jd1802,20170721,3786,3788,3768,3800,3768,3790,3791,2,3,340,12890580,5518
1856,jd1802,20170724,3790,3791,3781,3807,3772,3790,3794,-1,3,576,21853740,5662
1857,jd1802,20170725,3790,3794,3796,3879,3796,3868,3842,74,48,1158,44496140,5714
1858,jd1802,20170726,3868,3842,3861,3891,3860,3868,3874,26,32,630,24406720,5918
1859,jd1802,20170727,3868,3874,3888,3888,3872,3875,3880,1,6,572,22195600,6024
1860,jd1802,20170728,3875,3880,3885,3890,3855,3862,3872,-18,-8,812,31441920,5888
1861,jd1802,20170731,3862,3872,3888,3900,3856,3885,3881,13,9,1018,39514720,6090
1862,jd1802,20170801,3885,3881,3885,3889,3825,3825,3855,-56,-26,1468,56591840,5950
1863,jd1802,20170802,3825,3855,3752,3858,3752,3844,3840,-11,-15,1424,54695220,5772
1864,jd1802,20170803,3844,3840,3833,3851,3820,3822,3837,-18,-3,942,36148000,5800
1865,jd1802,20170804,3822,3837,3835,3937,3835,3907,3896,70,59,1894,73794080,5962
1866,jd1802,20170807,3907,3896,3928,4000,3927,3990,3983,94,87,1884,75050240,6328
1867,jd1802,20170808,3990,3983,3995,4057,3990,4050,4033,67,50,3042,122699540,6058
1868,jd1802,20170809,4050,4033,4050,4234,4041,4201,4159,168,126,2482,103226600,6180
1869,jd1802,20170810,4201,4159,4217,4219,4169,4196,4196,37,37,1742,73099020,6256
1870,jd1802,20170811,4196,4196,4205,4248,4142,4248,4186,52,-10,2354,98539960,6274
1871,jd1802,20170814,4248,4186,4186,4306,4171,4280,4259,94,73,3078,131100880,6336
1872,jd1802,20170815,4280,4259,4267,4294,4235,4260,4262,1,3,2016,85941120,6488
1873,jd1802,20170816,4260,4262,4260,4319,4204,4303,4286,41,24,1974,84624040,7010
1874,jd1802,20170817,4303,4286,4310,4340,4239,4258,4273,-28,-13,1968,84109860,7256
1875,jd1802,20170818,4258,4273,4251,4315,4251,4267,4282,-6,9,1552,66462420,7442
1876,jd1802,20170821,4267,4282,4300,4399,4270,4392,4363,110,81,3084,134556120,7198
1877,jd1802,20170822,4392,4363,4390,4401,4358,4376,4382,13,19,1574,68973640,7392
1878,jd1802,20170823,4376,4382,4331,4348,4170,4220,4231,-162,-151,3310,140073760,6384
1879,jd1802,20170824,4220,4231,4220,4246,4171,4182,4200,-49,-31,1348,56620980,6162
1880,jd1802,20170825,4182,4200,4203,4203,4135,4157,4158,-43,-42,1134,47156080,5858
1881,jd1802,20170828,4157,4158,4130,4180,4108,4151,4148,-7,-10,738,30613940,5998
1882,jd1802,20170829,4151,4148,4184,4208,4150,4158,4173,10,25,512,21367800,5888
1883,jd1802,20170830,4158,4173,4170,4181,4069,4076,4112,-97,-61,1506,61931340,6178
1884,jd1802,20170831,4076,4112,4075,4100,4050,4058,4071,-54,-41,784,31917980,6136
1885,jd1802,20170901,4058,4071,4070,4098,4044,4051,4068,-20,-3,1064,43294060,6288
1886,jd1802,20170904,4051,4068,4092,4119,4063,4063,4087,-5,19,832,34004120,6456
1887,jd1802,20170905,4063,4087,4085,4097,4023,4048,4059,-39,-28,910,36944940,6368
1888,jd1802,20170906,4048,4059,4067,4097,4053,4077,4077,18,18,580,23647580,6410
1889,jd1802,20170907,4077,4077,4057,4086,3962,3971,3999,-106,-78,2070,82786280,6376
1890,jd1802,20170908,3971,3999,3964,3980,3920,3923,3943,-76,-56,1270,50083100,6040
1891,jd1802,20170911,3923,3943,3923,3982,3902,3962,3959,19,16,822,32544420,6120
1892,jd1802,20170912,3962,3959,3981,4004,3941,3961,3966,2,7,852,33795960,6308
1893,jd1802,20170913,3961,3966,3935,3985,3875,3929,3914,-37,-52,732,28650740,6256
1894,jd1802,20170914,3929,3914,3955,3965,3910,3959,3942,45,28,682,26887580,6376
1895,jd1802,20170915,3959,3942,3935,3984,3932,3954,3957,12,15,842,33322680,6396
1896,jd1802,20170918,3954,3957,3941,3941,3857,3866,3874,-91,-83,1184,45879280,6176
1897,jd1802,20170919,3866,3874,3842,3870,3841,3850,3855,-24,-19,596,22978820,6094
1898,jd1802,20170920,3850,3855,3853,3878,3853,3873,3867,18,12,300,11601000,6142
1899,jd1802,20170921,3873,3867,3872,3980,3821,3946,3893,79,26,1234,48046020,6090
1900,jd1802,20170922,3946,3893,3973,3989,3935,3943,3957,50,64,608,24064180,6024
1901,jd1802,20170925,3943,3957,3911,3934,3852,3876,3897,-81,-60,888,34607460,5918
1902,jd1802,20170926,3876,3897,3887,3923,3878,3904,3898,7,1,436,16997260,5914
1903,jd1802,20170927,3904,3898,3892,3908,3864,3897,3887,-1,-11,436,16949380,5912
1904,jd1802,20170928,3897,3887,3895,3953,3862,3913,3904,26,17,550,21477020,5824
1905,jd1802,20170929,3913,3904,3928,3946,3914,3927,3930,23,26,268,10533340,5772
1906,jd1802,20171009,3927,3930,3940,3957,3881,3946,3919,16,-11,510,19988480,5798
1907,jd1802,20171010,3946,3919,3938,3979,3926,3951,3959,32,40,572,22648740,5950
1908,jd1802,20171011,3951,3959,3960,4036,3955,4021,4006,62,47,768,30773120,6320
1909,jd1802,20171012,4021,4006,4009,4029,4001,4007,4012,1,6,568,22792860,6452
1910,jd1802,20171013,4007,4012,4007,4017,3941,3986,3987,-26,-25,1698,67709920,6636
1911,jd1802,20171016,3986,3987,3996,4035,3984,4011,4011,24,24,1030,41319460,6744
1912,jd1802,20171017,4011,4011,4005,4034,3980,4014,4009,3,-2,694,27825980,6884
1913,jd1802,20171018,4014,4009,4020,4031,4005,4023,4021,14,12,216,8685940,6876
1914,jd1802,20171019,4023,4021,4032,4074,4018,4067,4056,46,35,848,34400800,6838
1915,jd1802,20171020,4067,4056,4086,4137,4086,4107,4112,51,56,650,26728120,6882
1916,jd1802,20171023,4107,4112,4093,4107,4061,4081,4085,-31,-27,374,15279300,6950
1917,jd1802,20171024,4081,4085,4045,4125,4045,4095,4095,10,10,408,16707840,7074
1918,jd1802,20171025,4095,4095,4103,4109,4073,4089,4092,-6,-3,196,8021300,7100
1919,jd1802,20171026,4089,4092,4092,4119,4083,4094,4100,2,8,344,14104940,7116
1920,jd1802,20171027,4094,4100,4105,4105,4026,4058,4062,-42,-38,1134,46064300,7480
1921,jd1802,20171030,4058,4062,4088,4088,4005,4008,4033,-54,-29,734,29607400,7360
1922,jd1802,20171031,4008,4033,4007,4027,4002,4020,4013,-13,-20,678,27211500,7394
1923,jd1802,20171101,4020,4013,4042,4085,4028,4054,4058,41,45,670,27192520,7362
1924,jd1802,20171102,4054,4058,4058,4078,4037,4076,4052,18,-6,370,14993280,7350
1925,jd1802,20171103,4076,4052,4082,4082,4052,4066,4065,14,13,390,15854620,7442
1926,jd1802,20171106,4066,4065,4086,4119,4069,4095,4102,30,37,638,26172180,7300
1927,jd1802,20171107,4095,4102,4102,4144,4096,4132,4114,30,12,1440,59246780,7634
1928,jd1802,20171108,4132,4114,4138,4159,4108,4125,4136,11,22,1174,48567480,7746
1929,jd1802,20171109,4125,4136,4128,4137,4107,4130,4126,-6,-10,600,24759200,7950
1930,jd1802,20171110,4130,4126,4130,4155,4115,4120,4124,-6,-2,946,39021460,8406
1931,jd1802,20171113,4120,4124,4123,4151,4097,4147,4121,23,-3,1270,52348400,9052
1932,jd1802,20171114,4147,4121,4158,4158,4127,4143,4137,22,16,736,30448780,9090
1933,jd1802,20171115,4143,4137,4110,4171,4106,4142,4153,5,16,1684,69948300,9204
1934,jd1802,20171116,4142,4153,4150,4160,4130,4142,4137,-11,-16,1630,67446760,9556
1935,jd1802,20171117,4142,4137,4131,4172,4124,4161,4141,24,4,808,33461180,9734
1936,jd1802,20171120,4161,4141,4151,4158,4113,4121,4132,-20,-9,1448,59835480,9834
1937,jd1802,20171121,4121,4132,4155,4164,4130,4157,4146,25,14,796,33007380,10204
1938,jd1802,20171122,4157,4146,4170,4250,4170,4250,4224,104,78,2234,94385180,10792
1939,jd1802,20171123,4250,4224,4285,4299,4266,4285,4287,61,63,2116,90726720,11318
1940,jd1802,20171124,4285,4287,4285,4312,4285,4302,4295,15,8,1168,50167120,11458
1941,jd1802,20171127,4302,4295,4283,4325,4283,4305,4309,10,14,1596,68774640,11490
1942,jd1802,20171128,4305,4309,4308,4343,4308,4336,4328,27,19,1340,58005240,11840
1943,jd1802,20171129,4336,4328,4350,4435,4350,4431,4394,103,66,4468,196360120,12918
1944,jd1802,20171130,4431,4394,4444,4454,4372,4376,4418,-18,24,3596,158900740,12860
1945,jd1802,20171201,4376,4418,4389,4408,4337,4352,4364,-66,-54,3850,168015540,14014
1946,jd1802,20171204,4352,4364,4325,4365,4317,4350,4338,-14,-26,2746,119131600,14080
1947,jd1802,20171205,4350,4338,4357,4373,4330,4336,4350,-2,12,2718,118236460,14556
1948,jd1802,20171206,4336,4350,4348,4348,4303,4309,4318,-41,-32,1852,79982780,14544
1949,jd1802,20171207,4309,4318,4320,4350,4310,4317,4333,-1,15,2370,102697380,15168
1950,jd1802,20171208,4317,4333,4347,4349,4287,4299,4307,-34,-26,2562,110366560,15386
1951,jd1802,20171211,4299,4307,4287,4294,4222,4244,4261,-63,-46,2676,114041300,15382
1952,jd1802,20171212,4244,4261,4208,4267,4208,4254,4245,-7,-16,2926,124233680,14740
1953,jd1802,20171213,4254,4245,4210,4285,4210,4277,4252,32,7,3332,141703360,15348
1954,jd1802,20171214,4277,4252,4268,4360,4254,4307,4292,55,40,2102,90225720,15132
1955,jd1802,20171215,4307,4292,4327,4350,4301,4316,4319,24,27,2436,105215040,15364
1956,jd1802,20171218,4316,4319,4355,4359,4320,4325,4336,6,17,1498,64965060,15546
1957,jd1802,20171219,4325,4336,4320,4320,4270,4271,4282,-65,-54,1966,84201220,15346
1958,jd1802,20171220,4271,4282,4210,4274,4210,4235,4247,-47,-35,1932,82062940,15112
1959,jd1802,20171221,4235,4247,4296,4296,4240,4283,4271,36,24,2390,102099620,14814
1960,jd1802,20171222,4283,4271,4280,4310,4280,4306,4294,35,23,1890,81171220,15456
1961,jd1802,20171225,4306,4294,4325,4325,4287,4305,4297,11,3,2468,106070740,15264
1962,jd1802,20171226,4305,4297,4296,4296,4280,4285,4284,-12,-13,1432,61359480,15378
1963,jd1802,20171227,4285,4284,4282,4292,4270,4283,4280,-1,-4,1582,67723440,15268
1964,jd1802,20171228,4283,4280,4280,4297,4271,4272,4284,-8,4,2680,114822940,14360
1965,jd1802,20171229,4272,4284,4274,4275,4220,4221,4239,-63,-45,5022,212897600,13908
1966,jd1803,20170315,3971,3971,0,0,0,3920,3920,-51,-51,0,0,0
1967,jd1803,20170316,3920,3920,0,0,0,3820,3820,-100,-100,0,0,0
1968,jd1803,20170317,3820,3820,0,0,0,3820,3820,0,0,0,0,0
1969,jd1803,20170320,3820,3820,0,0,0,3820,3820,0,0,0,0,0
1970,jd1803,20170321,3820,3820,3809,3809,3808,3808,3808,-12,-12,6,228520,6
1971,jd1803,20170322,3808,3808,3701,3729,3701,3729,3719,-79,-89,6,223160,6
1972,jd1803,20170323,3729,3719,3760,3760,3760,3760,3760,41,41,2,75200,6
1973,jd1803,20170324,3760,3760,3702,3702,3702,3702,3702,-58,-58,4,148080,6
1974,jd1803,20170327,3702,3702,3780,3780,3780,3780,3780,78,78,2,75600,6
1975,jd1803,20170328,3780,3780,0,0,0,3765,3765,-15,-15,0,0,6
1976,jd1803,20170329,3765,3765,3700,3784,3700,3729,3734,-36,-31,66,2464620,48
1977,jd1803,20170330,3729,3734,3715,3715,3599,3601,3641,-133,-93,190,6918680,130
1978,jd1803,20170331,3601,3641,3605,3605,3527,3565,3560,-76,-81,226,8046420,234
1979,jd1803,20170405,3565,3560,3565,3609,3561,3606,3591,46,31,174,6248460,296
1980,jd1803,20170406,3606,3591,3600,3610,3581,3607,3600,16,9,124,4464900,330
1981,jd1803,20170407,3607,3600,3613,3623,3600,3620,3611,20,11,52,1878080,340
1982,jd1803,20170410,3620,3611,3605,3638,3583,3617,3615,6,4,256,9256440,430
1983,jd1803,20170411,3617,3615,3625,3633,3608,3608,3618,-7,3,80,2894580,438
1984,jd1803,20170412,3608,3618,3629,3632,3615,3622,3624,4,6,74,2682100,424
1985,jd1803,20170413,3622,3624,3781,3781,3562,3594,3608,-30,-16,266,9598700,528
1986,jd1803,20170414,3594,3608,3594,3609,3576,3585,3587,-23,-21,132,4735180,602
1987,jd1803,20170417,3585,3587,3589,3591,3559,3582,3576,-5,-11,116,4148300,646
1988,jd1803,20170418,3582,3576,3570,3575,3524,3531,3535,-45,-41,236,8344280,662
1989,jd1803,20170419,3531,3535,3420,3491,3420,3450,3452,-85,-83,186,6422120,708
1990,jd1803,20170420,3450,3452,3489,3489,3446,3487,3477,35,25,126,4381060,694
1991,jd1803,20170421,3487,3477,3470,3508,3470,3508,3493,31,16,52,1816400,692
1992,jd1803,20170424,3508,3493,3489,3530,3461,3518,3507,25,14,182,6384040,744
1993,jd1803,20170425,3518,3507,3548,3576,3521,3560,3557,53,50,534,18994880,1042
1994,jd1803,20170426,3560,3557,3566,3597,3560,3593,3581,36,24,428,15327960,1032
1995,jd1803,20170427,3593,3581,3624,3672,3571,3583,3579,2,-2,308,11023460,1002
1996,jd1803,20170428,3583,3579,3627,3644,3563,3635,3618,56,39,142,5138860,1024
1997,jd1803,20170502,3635,3618,3668,3678,3622,3667,3662,49,44,358,13111820,1102
1998,jd1803,20170503,3667,3662,3687,3687,3657,3659,3668,-3,6,266,9756920,1134
1999,jd1803,20170504,3659,3668,3645,3683,3645,3657,3663,-11,-5,250,9159180,1156
2000,jd1803,20170505,3657,3663,3588,3730,3588,3669,3664,6,1,314,11507920,1186
2001,jd1803,20170508,3669,3664,3670,3670,3610,3619,3639,-45,-25,630,22927940,1356
2002,jd1803,20170509,3619,3639,3603,3685,3552,3676,3648,37,9,536,19554280,1578
2003,jd1803,20170510,3676,3648,3684,3700,3650,3656,3666,8,18,332,12173120,1564
2004,jd1803,20170511,3656,3666,3655,3655,3572,3580,3600,-86,-66,958,34495460,1688
2005,jd1803,20170512,3580,3600,3565,3599,3530,3532,3557,-68,-43,468,16648580,1782
2006,jd1803,20170515,3532,3557,3523,3538,3506,3528,3522,-29,-35,336,11835400,1818
2007,jd1803,20170516,3528,3522,3535,3595,3525,3545,3540,23,18,410,14516880,1838
2008,jd1803,20170517,3545,3540,3547,3590,3546,3585,3574,45,34,406,14513520,1938
2009,jd1803,20170518,3585,3574,3546,3629,3545,3629,3603,55,29,296,10666800,2040
2010,jd1803,20170519,3629,3603,3629,3635,3610,3633,3624,30,21,250,9062140,2078
2011,jd1803,20170522,3633,3624,3621,3643,3601,3608,3620,-16,-4,494,17885780,2058
2012,jd1803,20170523,3608,3620,3611,3631,3598,3602,3606,-18,-14,306,11035200,2046
2013,jd1803,20170524,3602,3606,3593,3635,3593,3620,3621,14,15,322,11662200,2132
2014,jd1803,20170525,3620,3621,3629,3650,3615,3627,3630,6,9,312,11326340,2142
2015,jd1803,20170526,3627,3630,3630,3639,3617,3620,3625,-10,-5,656,23784940,2332
2016,jd1803,20170531,3620,3625,3630,3765,3630,3694,3716,69,91,2036,75676000,3180
2017,jd1803,20170601,3694,3716,3700,3721,3650,3721,3695,5,-21,2514,92899580,3484
2018,jd1803,20170602,3721,3695,3722,3725,3672,3697,3690,2,-5,664,24506120,3446
2019,jd1803,20170605,3697,3690,3648,3695,3647,3682,3681,-8,-9,232,8542220,3472
2020,jd1803,20170606,3682,3681,3688,3694,3677,3680,3685,-1,4,246,9067120,3532
2021,jd1803,20170607,3680,3685,3694,3694,3652,3658,3663,-27,-22,362,13261360,3636
2022,jd1803,20170608,3658,3663,3640,3688,3640,3673,3677,10,14,668,24567700,3520
2023,jd1803,20170609,3673,3677,3683,3714,3634,3647,3665,-30,-12,782,28664520,3630
2024,jd1803,20170612,3647,3665,3631,3656,3545,3592,3585,-73,-80,1888,67700020,3574
2025,jd1803,20170613,3592,3585,3579,3608,3569,3596,3590,11,5,770,27646300,3724
2026,jd1803,20170614,3596,3590,3606,3606,3578,3592,3591,2,1,350,12568940,3782
2027,jd1803,20170615,3592,3591,3555,3602,3555,3572,3582,-19,-9,1008,36113700,3580
2028,jd1803,20170616,3572,3582,3582,3602,3502,3532,3553,-50,-29,1162,41287960,3840
2029,jd1803,20170619,3532,3553,3542,3568,3537,3561,3556,8,3,556,19773920,3772
2030,jd1803,20170620,3561,3556,3552,3556,3532,3532,3540,-24,-16,484,17137920,3924
2031,jd1803,20170621,3532,3540,3532,3547,3516,3536,3530,-4,-10,682,24081340,4192
2032,jd1803,20170622,3536,3530,3531,3580,3530,3545,3556,15,26,1202,42747900,4236
2033,jd1803,20170623,3545,3556,3530,3565,3530,3547,3544,-9,-12,700,24809020,4052
2034,jd1803,20170626,3547,3544,3510,3560,3510,3543,3550,-1,6,464,16474240,3962
2035,jd1803,20170627,3543,3550,3530,3586,3530,3561,3569,11,19,476,16990220,3980
2036,jd1803,20170628,3561,3569,3571,3584,3564,3567,3569,-2,0,382,13637100,3934
2037,jd1803,20170629,3567,3569,3576,3576,3541,3541,3552,-28,-17,454,16130200,3864
2038,jd1803,20170630,3541,3552,3515,3533,3500,3510,3513,-42,-39,370,13001160,3838
2039,jd1803,20170703,3510,3513,3508,3538,3461,3533,3523,20,10,318,11205140,3892
2040,jd1803,20170704,3533,3523,3525,3527,3466,3471,3494,-52,-29,740,25860060,3866
2041,jd1803,20170705,3471,3494,3485,3522,3461,3512,3503,18,9,342,11980300,3820
2042,jd1803,20170706,3512,3503,3525,3599,3523,3586,3567,83,64,818,29178580,3876
2043,jd1803,20170707,3586,3567,3574,3593,3557,3570,3577,3,10,324,11589640,3780
2044,jd1803,20170710,3570,3577,3589,3589,3545,3545,3578,-32,1,510,18251680,3666
2045,jd1803,20170711,3545,3578,3528,3563,3526,3546,3550,-32,-28,300,10651560,3578
2046,jd1803,20170712,3546,3550,3545,3559,3541,3541,3549,-9,-1,804,28538140,3136
2047,jd1803,20170713,3541,3549,3550,3554,3543,3549,3548,0,-1,194,6883180,3102
2048,jd1803,20170714,3549,3548,3560,3583,3548,3558,3566,10,18,292,10414920,3138
2049,jd1803,20170717,3558,3566,3561,3599,3558,3591,3579,25,13,428,15319360,2984
2050,jd1803,20170718,3591,3579,3600,3617,3575,3596,3604,17,25,208,7496800,3010
2051,jd1803,20170719,3596,3604,3603,3628,3603,3607,3613,3,9,500,18068860,3086
2052,jd1803,20170720,3607,3613,3616,3616,3601,3603,3607,-10,-6,202,7286140,3056
2053,jd1803,20170721,3603,3607,3611,3614,3590,3601,3605,-6,-2,144,5191680,3064
2054,jd1803,20170724,3601,3605,3606,3615,3593,3604,3604,-1,-1,348,12542420,3032
2055,jd1803,20170725,3604,3604,3618,3700,3613,3682,3662,78,58,908,33256240,3176
2056,jd1803,20170726,3682,3662,3688,3698,3660,3663,3679,1,17,394,14498040,3260
2057,jd1803,20170727,3663,3679,3670,3681,3658,3673,3669,-6,-10,234,8587020,3298
2058,jd1803,20170728,3673,3669,3679,3685,3655,3671,3672,2,3,488,17920180,3424
2059,jd1803,20170731,3671,3672,3700,3700,3668,3684,3678,12,6,722,26561880,3796
2060,jd1803,20170801,3684,3678,3681,3681,3642,3656,3664,-22,-14,534,19566620,3834
2061,jd1803,20170802,3656,3664,3645,3667,3645,3655,3656,-9,-8,302,11043960,3790
2062,jd1803,20170803,3655,3656,3662,3689,3653,3662,3661,6,5,332,12155200,3852
2063,jd1803,20170804,3662,3661,3680,3745,3658,3732,3705,71,44,898,33279160,3848
2064,jd1803,20170807,3732,3705,3758,3818,3758,3795,3797,90,92,1146,43514240,3956
2065,jd1803,20170808,3795,3797,3795,3878,3795,3865,3837,68,40,1276,48967060,4112
2066,jd1803,20170809,3865,3837,3871,4028,3866,3993,3972,156,135,2206,87622940,3922
2067,jd1803,20170810,3993,3972,3985,4010,3971,3991,3992,19,20,2612,104284540,5410
2068,jd1803,20170811,3991,3992,3994,4030,3954,4009,3985,17,-7,2182,86956180,5872
2069,jd1803,20170814,4009,3985,4000,4033,3968,4014,3996,29,11,1242,49641800,6114
2070,jd1803,20170815,4014,3996,3990,3994,3951,3969,3973,-27,-23,948,37668760,6004
2071,jd1803,20170816,3969,3973,3975,4008,3972,3992,3992,19,19,338,13494680,6110
2072,jd1803,20170817,3992,3992,3998,4008,3945,3962,3972,-30,-20,1154,45845700,6128
2073,jd1803,20170818,3962,3972,3957,4003,3957,3972,3982,0,10,414,16486040,6186
2074,jd1803,20170821,3972,3982,3965,4040,3965,4040,4015,58,33,1494,59990720,5986
2075,jd1803,20170822,4040,4015,4008,4048,4008,4014,4024,-1,9,888,35741820,6078
2076,jd1803,20170823,4014,4024,3983,3999,3872,3913,3928,-111,-96,1076,42271120,5824
2077,jd1803,20170824,3913,3928,3930,3936,3891,3891,3904,-37,-24,518,20224100,5740
2078,jd1803,20170825,3891,3904,3891,3900,3840,3864,3872,-40,-32,712,27569300,5670
2079,jd1803,20170828,3864,3872,3862,3873,3841,3848,3847,-24,-25,930,35785420,5240
2080,jd1803,20170829,3848,3847,3868,3887,3850,3853,3866,6,19,500,19332600,5120
2081,jd1803,20170830,3853,3866,3854,3870,3804,3807,3837,-59,-29,956,36689120,5212
2082,jd1803,20170831,3807,3837,3807,3822,3798,3813,3809,-24,-28,474,18058840,5300
2083,jd1803,20170901,3813,3809,3819,3837,3800,3810,3813,1,4,330,12584740,5368
2084,jd1803,20170904,3810,3813,3880,3880,3817,3830,3846,17,33,882,33922460,5672
2085,jd1803,20170905,3830,3846,3846,3846,3798,3818,3822,-28,-24,504,19267660,5620
2086,jd1803,20170906,3818,3822,3812,3845,3812,3828,3830,6,8,226,8656820,5694
2087,jd1803,20170907,3828,3830,3818,3824,3753,3766,3783,-64,-47,1122,42454060,5370
2088,jd1803,20170908,3766,3783,3756,3771,3733,3745,3751,-38,-32,512,19207220,5122
2089,jd1803,20170911,3745,3751,3734,3790,3723,3776,3767,25,16,586,22076860,5116
2090,jd1803,20170912,3776,3767,3790,3804,3754,3776,3778,9,11,370,13980680,5056
2091,jd1803,20170913,3776,3778,3780,3780,3700,3727,3727,-51,-51,446,16623720,5102
2092,jd1803,20170914,3727,3727,3728,3756,3723,3746,3743,19,16,212,7936960,5060
2093,jd1803,20170915,3746,3743,3740,3767,3733,3743,3748,0,5,316,11845680,5000
2094,jd1803,20170918,3743,3748,3712,3716,3667,3675,3686,-73,-62,544,20055320,4990
2095,jd1803,20170919,3675,3686,3675,3683,3657,3657,3667,-29,-19,292,10709100,5036
2096,jd1803,20170920,3657,3667,3668,3687,3668,3677,3675,10,8,400,14701020,4982
2097,jd1803,20170921,3677,3675,3689,3745,3639,3724,3694,49,19,922,34067360,4844
2098,jd1803,20170922,3724,3694,3729,3766,3720,3737,3741,43,47,716,26792280,4650
2099,jd1803,20170925,3737,3741,3707,3725,3663,3687,3692,-54,-49,504,18612360,4792
2100,jd1803,20170926,3687,3692,3693,3726,3688,3707,3714,15,22,522,19387500,4760
2101,jd1803,20170927,3707,3714,3690,3717,3678,3706,3693,-8,-21,320,11817700,4848
2102,jd1803,20170928,3706,3693,3713,3741,3683,3710,3705,17,12,420,15564760,4792
2103,jd1803,20170929,3710,3705,3732,3740,3709,3722,3721,17,16,226,8410500,4720
2104,jd1803,20171009,3722,3721,3723,3735,3689,3726,3710,5,-11,292,10833520,4710
2105,jd1803,20171010,3726,3710,3718,3777,3718,3748,3753,38,43,544,20421280,4884
2106,jd1803,20171011,3748,3753,3760,3800,3758,3794,3780,41,27,1386,52403720,5644
2107,jd1803,20171012,3794,3780,3794,3794,3768,3772,3774,-8,-6,436,16456200,5752
2108,jd1803,20171013,3772,3774,3770,3778,3693,3752,3738,-22,-36,2232,83451380,7230
2109,jd1803,20171016,3752,3738,3754,3799,3754,3775,3781,37,43,718,27152800,7382
2110,jd1803,20171017,3775,3781,3756,3795,3736,3788,3769,7,-12,432,16283080,7450
2111,jd1803,20171018,3788,3769,3795,3808,3788,3808,3798,39,29,632,24003860,7516
2112,jd1803,20171019,3808,3798,3811,3862,3807,3841,3845,43,47,586,22534440,7558
2113,jd1803,20171020,3841,3845,3853,3896,3852,3868,3877,23,32,860,33345920,7832
2114,jd1803,20171023,3868,3877,3854,3861,3829,3837,3840,-40,-37,264,10139140,7824
2115,jd1803,20171024,3837,3840,3834,3867,3826,3845,3847,5,7,370,14234700,7758
2116,jd1803,20171025,3845,3847,3850,3856,3831,3839,3841,-8,-6,196,7530100,7812
2117,jd1803,20171026,3839,3841,3850,3879,3835,3837,3852,-4,11,352,13561820,7836
2118,jd1803,20171027,3837,3852,3850,3850,3794,3825,3814,-27,-38,764,29145840,8104
2119,jd1803,20171030,3825,3814,3825,3840,3774,3776,3811,-38,-3,486,18523280,8176
2120,jd1803,20171031,3776,3811,3771,3790,3766,3783,3780,-28,-31,314,11870420,8258
2121,jd1803,20171101,3783,3780,3788,3829,3787,3803,3810,23,30,724,27588880,8506
2122,jd1803,20171102,3803,3810,3818,3818,3792,3816,3804,6,-6,188,7151840,8540
2123,jd1803,20171103,3816,3804,3818,3838,3795,3805,3805,1,1,286,10883480,8568
2124,jd1803,20171106,3805,3805,3818,3840,3815,3825,3826,20,21,498,19055400,8546
2125,jd1803,20171107,3825,3826,3830,3850,3823,3840,3834,14,8,544,20858960,8576
2126,jd1803,20171108,3840,3834,3850,3860,3817,3821,3843,-13,9,776,29823320,8592
2127,jd1803,20171109,3821,3843,3829,3829,3791,3828,3810,-15,-33,540,20577640,8706
2128,jd1803,20171110,3828,3810,3822,3850,3785,3801,3810,-9,0,1098,41840320,9198
2129,jd1803,20171113,3801,3810,3813,3825,3770,3810,3789,0,-21,1528,57897480,9294
2130,jd1803,20171114,3810,3789,3817,3817,3796,3804,3806,15,17,282,10733200,9402
2131,jd1803,20171115,3804,3806,3788,3831,3788,3814,3815,8,9,576,21977260,9462
2132,jd1803,20171116,3814,3815,3829,3829,3810,3823,3815,8,0,556,21214080,9376
2133,jd1803,20171117,3823,3815,3827,3860,3812,3850,3836,35,21,530,20335540,9406
2134,jd1803,20171120,3850,3836,3855,3860,3825,3838,3839,2,3,606,23269600,9462
2135,jd1803,20171121,3838,3839,3828,3864,3828,3864,3851,25,12,786,30272700,9946
2136,jd1803,20171122,3864,3851,3865,3907,3865,3897,3893,46,42,978,38077820,10266
2137,jd1803,20171123,3897,3893,3910,3926,3904,3905,3916,12,23,850,33289560,10510
2138,jd1803,20171124,3905,3916,3905,3937,3905,3931,3919,15,3,704,27593800,10634
2139,jd1803,20171127,3931,3919,3912,3958,3725,3937,3935,18,16,852,33532380,10710
2140,jd1803,20171128,3937,3935,3945,3970,3938,3968,3953,33,18,540,21349120,10918
2141,jd1803,20171129,3968,3953,3982,4046,3950,4046,4012,93,59,1664,66765560,11050
2142,jd1803,20171130,4046,4012,4045,4070,4010,4020,4046,8,34,2074,83931320,10920
2143,jd1803,20171201,4020,4046,4020,4033,3984,3996,4006,-50,-40,1786,71563300,11028
2144,jd1803,20171204,3996,4006,4006,4018,3970,3994,3988,-12,-18,766,30551440,11026
2145,jd1803,20171205,3994,3988,3996,4010,3947,3957,3977,-31,-11,1128,44863660,11182
2146,jd1803,20171206,3957,3977,3968,3968,3901,3908,3920,-69,-57,2062,80850180,11156
2147,jd1803,20171207,3908,3920,3913,3945,3895,3919,3921,-1,1,2066,81011000,11800
2148,jd1803,20171208,3919,3921,3925,3935,3900,3905,3914,-16,-7,1592,62316080,11736
2149,jd1803,20171211,3905,3914,3806,3897,3806,3854,3866,-60,-48,1270,49107740,11680
2150,jd1803,20171212,3854,3866,3840,3885,3840,3861,3869,-5,3,1078,41712620,11532
2151,jd1803,20171213,3861,3869,3853,3922,3838,3898,3875,29,6,1606,62238600,11690
2152,jd1803,20171214,3898,3875,3888,3918,3888,3911,3903,36,28,1002,39112560,11788
2153,jd1803,20171215,3911,3903,3920,3942,3883,3916,3910,13,7,1780,69598620,12246
2154,jd1803,20171218,3916,3910,3936,3958,3921,3930,3934,20,24,1006,39581860,12346
2155,jd1803,20171219,3930,3934,3920,3920,3861,3865,3879,-69,-55,1148,44532280,12664
2156,jd1803,20171220,3865,3879,3805,3865,3805,3835,3847,-44,-32,1198,46089600,12602
2157,jd1803,20171221,3835,3847,3845,3866,3821,3842,3848,-5,1,1816,69882500,12696
2158,jd1803,20171222,3842,3848,3839,3875,3837,3870,3858,22,10,1358,52394360,13198
2159,jd1803,20171225,3870,3858,3875,3895,3859,3893,3875,35,17,1336,51772900,13392
2160,jd1803,20171226,3893,3875,3885,3893,3859,3872,3869,-3,-6,1530,59210320,13648
2161,jd1803,20171227,3872,3869,3858,3880,3858,3875,3866,6,-3,780,30162180,13636
2162,jd1803,20171228,3875,3866,3866,3871,3849,3850,3861,-16,-5,2448,94525740,13906
2163,jd1803,20171229,3850,3861,3855,3860,3815,3830,3835,-31,-26,1686,64671760,13886
2164,jd1804,20170426,3557,3557,3541,3606,3541,3582,3581,25,24,36,1289220,22
2165,jd1804,20170427,3582,3581,3596,3605,3595,3605,3599,24,18,50,1799940,54
2166,jd1804,20170428,3605,3599,3608,3659,3608,3644,3632,45,33,64,2324620,88
2167,jd1804,20170502,3644,3632,3666,3723,3654,3723,3681,91,49,276,10162240,294
2168,jd1804,20170503,3723,3681,3718,3720,3682,3690,3697,9,16,634,23439960,804
2169,jd1804,20170504,3690,3697,3690,3713,3686,3708,3704,11,7,810,30002700,1414
2170,jd1804,20170505,3708,3704,3700,3719,3699,3714,3711,10,7,256,9501280,1604
2171,jd1804,20170508,3714,3711,3720,3720,3661,3681,3689,-30,-22,982,36230540,1802
2172,jd1804,20170509,3681,3689,3619,3749,3619,3733,3714,44,25,786,29193400,2276
2173,jd1804,20170510,3733,3714,3730,3756,3726,3740,3743,26,29,1264,47320840,3052
2174,jd1804,20170511,3740,3743,3731,3731,3611,3615,3672,-128,-71,2984,109595220,3798
2175,jd1804,20170512,3615,3672,3620,3620,3531,3551,3571,-121,-101,2326,83066260,4096
2176,jd1804,20170515,3551,3571,3551,3569,3522,3569,3551,-2,-20,1010,35867500,4178
2177,jd1804,20170516,3569,3551,3533,3620,3532,3612,3592,61,41,1384,49714800,4702
2178,jd1804,20170517,3612,3592,3610,3618,3561,3597,3605,5,13,3150,113585800,5944
2179,jd1804,20170518,3597,3605,3605,3639,3603,3638,3619,33,14,1500,54290800,6772
2180,jd1804,20170519,3638,3619,3649,3668,3630,3641,3644,22,25,904,32943580,6978
2181,jd1804,20170522,3641,3644,3650,3655,3616,3638,3639,-6,-5,1046,38070460,7186
2182,jd1804,20170523,3638,3639,3630,3650,3615,3628,3629,-11,-10,1286,46680240,7510
2183,jd1804,20170524,3628,3629,3638,3640,3630,3636,3636,7,7,1010,36724980,7852
2184,jd1804,20170525,3636,3636,3646,3688,3630,3662,3653,26,17,1144,41791060,7882
2185,jd1804,20170526,3662,3653,3665,3695,3640,3678,3673,25,20,1074,39449360,7480
2186,jd1804,20170531,3678,3673,3674,3837,3674,3748,3786,75,113,3850,145791860,7322
2187,jd1804,20170601,3748,3786,3750,3770,3686,3756,3728,-30,-58,4002,149221240,7132
2188,jd1804,20170602,3756,3728,3729,3773,3728,3742,3746,14,18,1580,59195560,7448
2189,jd1804,20170605,3742,3746,3897,3897,3734,3746,3753,0,7,1310,49174560,7780
2190,jd1804,20170606,3746,3753,3743,3766,3743,3745,3752,-8,-1,210,7880040,7842
2191,jd1804,20170607,3745,3752,3745,3745,3704,3711,3712,-41,-40,746,27698400,7750
2192,jd1804,20170608,3711,3712,3712,3721,3675,3687,3701,-25,-11,944,34943040,7456
2193,jd1804,20170609,3687,3701,3679,3706,3626,3653,3667,-48,-34,1412,51786160,7250
2194,jd1804,20170612,3653,3667,3641,3644,3523,3574,3566,-93,-101,3058,109050520,7222
2195,jd1804,20170613,3574,3566,3577,3581,3541,3570,3560,4,-6,1296,46145340,7190
2196,jd1804,20170614,3570,3560,3571,3591,3570,3580,3576,20,16,966,34546340,7154
2197,jd1804,20170615,3580,3576,3572,3583,3535,3555,3554,-21,-22,1310,46559380,7148
2198,jd1804,20170616,3555,3554,3559,3564,3490,3515,3532,-39,-22,1446,51083520,7378
2199,jd1804,20170619,3515,3532,3526,3550,3512,3533,3528,1,-4,1456,51377020,7374
2200,jd1804,20170620,3533,3528,3536,3536,3510,3520,3519,-8,-9,440,15484520,7448
2201,jd1804,20170621,3520,3519,3527,3528,3498,3515,3509,-4,-10,862,30251680,7592
2202,jd1804,20170622,3515,3509,3529,3546,3509,3512,3526,3,17,2146,75687300,7070
2203,jd1804,20170623,3512,3526,3506,3544,3506,3533,3530,7,4,1184,41798040,6682
2204,jd1804,20170626,3533,3530,3501,3534,3501,3530,3524,0,-6,854,30103240,6296
2205,jd1804,20170627,3530,3524,3536,3553,3528,3539,3539,15,15,646,22865780,6268
2206,jd1804,20170628,3539,3539,3534,3557,3534,3546,3546,7,7,486,17237320,6262
2207,jd1804,20170629,3546,3546,3543,3543,3508,3516,3520,-30,-26,832,29292020,6282
2208,jd1804,20170630,3516,3520,3508,3515,3470,3472,3482,-48,-38,960,33433060,6236
2209,jd1804,20170703,3472,3482,3486,3505,3483,3499,3497,17,15,552,19304640,6200
2210,jd1804,20170704,3499,3497,3486,3505,3442,3447,3469,-50,-28,1212,42054300,6300
2211,jd1804,20170705,3447,3469,3436,3487,3436,3483,3475,14,6,598,20782380,6296
2212,jd1804,20170706,3483,3475,3490,3565,3480,3558,3536,83,61,1350,47737140,6480
2213,jd1804,20170707,3558,3536,3557,3560,3529,3541,3544,5,8,686,24316080,6508
2214,jd1804,20170710,3541,3544,3543,3548,3518,3531,3535,-13,-9,236,8344820,6484
2215,jd1804,20170711,3531,3535,3522,3531,3516,3529,3525,-6,-10,170,5993140,6494
2216,jd1804,20170712,3529,3525,3531,3539,3520,3523,3526,-2,1,268,9451860,6436
2217,jd1804,20170713,3523,3526,3521,3526,3521,3522,3522,-4,-4,102,3593240,6432
2218,jd1804,20170714,3522,3522,3516,3543,3516,3536,3528,14,6,218,7692620,6396
2219,jd1804,20170717,3536,3528,3537,3576,3529,3560,3552,32,24,626,22240520,6358
2220,jd1804,20170718,3560,3552,3563,3583,3553,3568,3569,16,17,218,7781060,6338
2221,jd1804,20170719,3568,3569,3579,3585,3569,3573,3579,4,10,262,9377520,6408
2222,jd1804,20170720,3573,3579,3565,3584,3564,3564,3568,-15,-11,166,5923640,6414
2223,jd1804,20170721,3564,3568,3563,3575,3553,3567,3562,-1,-6,274,9762200,6382
2224,jd1804,20170724,3567,3562,3559,3574,3538,3557,3550,-5,-12,300,10651860,6296
2225,jd1804,20170725,3557,3550,3574,3598,3562,3590,3580,40,30,1322,47337140,6268
2226,jd1804,20170726,3590,3580,3595,3607,3564,3575,3585,-5,5,696,24957120,6240
2227,jd1804,20170727,3575,3585,3594,3594,3579,3586,3582,1,-3,236,8455620,6236
2228,jd1804,20170728,3586,3582,3592,3610,3582,3600,3597,18,15,776,27920180,6228
2229,jd1804,20170731,3600,3597,3620,3638,3596,3631,3621,34,24,652,23610980,6242
2230,jd1804,20170801,3631,3621,3631,3631,3599,3612,3615,-9,-6,978,35356700,6264
2231,jd1804,20170802,3612,3615,3611,3622,3606,3614,3611,-1,-4,300,10834600,6146
2232,jd1804,20170803,3614,3611,3613,3634,3613,3616,3621,5,10,460,16656640,6150
2233,jd1804,20170804,3616,3621,3626,3706,3601,3690,3658,69,37,1564,57221760,6016
2234,jd1804,20170807,3690,3658,3708,3790,3708,3776,3760,118,102,1466,55129680,6098
2235,jd1804,20170808,3776,3760,3765,3805,3748,3802,3778,42,18,998,37704660,6122
2236,jd1804,20170809,3802,3778,3806,3950,3804,3910,3899,132,121,1900,74086300,6406
2237,jd1804,20170810,3910,3899,3915,3936,3902,3923,3917,24,18,1324,51866600,6506
2238,jd1804,20170811,3923,3917,3930,3948,3876,3927,3904,10,-13,1794,70052820,6928
2239,jd1804,20170814,3927,3904,3927,3930,3880,3899,3903,-5,-1,2106,82199240,8062
2240,jd1804,20170815,3899,3903,3895,3895,3860,3872,3871,-31,-32,1022,39567880,8472
2241,jd1804,20170816,3872,3871,3884,3901,3866,3880,3884,9,13,522,20275800,8544
2242,jd1804,20170817,3880,3884,3889,3890,3836,3861,3859,-23,-25,872,33656780,8504
2243,jd1804,20170818,3861,3859,3866,3898,3854,3870,3878,11,19,476,18463360,8492
2244,jd1804,20170821,3870,3878,3890,3925,3886,3924,3907,46,29,844,32977200,8656
2245,jd1804,20170822,3924,3907,3918,3928,3901,3902,3913,-5,6,604,23636060,8562
2246,jd1804,20170823,3902,3913,3876,3892,3802,3818,3820,-95,-93,1270,48518300,7968
2247,jd1804,20170824,3818,3820,3831,3831,3788,3794,3803,-26,-17,272,10345800,7962
2248,jd1804,20170825,3794,3803,3794,3807,3752,3767,3768,-36,-35,672,25322380,7888
2249,jd1804,20170828,3767,3768,3760,3780,3751,3769,3765,1,-3,668,25154060,7842
2250,jd1804,20170829,3769,3765,3780,3796,3752,3779,3779,14,14,366,13832940,7816
2251,jd1804,20170830,3779,3779,3780,3789,3710,3737,3739,-42,-40,652,24380880,7666
2252,jd1804,20170831,3737,3739,3721,3730,3702,3713,3712,-26,-27,422,15664780,7646
2253,jd1804,20170901,3713,3712,3719,3744,3709,3719,3716,7,4,342,12712120,7646
2254,jd1804,20170904,3719,3716,3720,3775,3720,3734,3733,18,17,608,22698640,7736
2255,jd1804,20170905,3734,3733,3738,3738,3706,3724,3721,-9,-12,432,16076760,7808
2256,jd1804,20170906,3724,3721,3730,3747,3723,3736,3734,15,13,360,13443300,7760
2257,jd1804,20170907,3736,3734,3721,3736,3676,3683,3698,-51,-36,1206,44606100,7328
2258,jd1804,20170908,3683,3698,3680,3698,3665,3690,3682,-8,-16,730,26879480,7036
2259,jd1804,20170911,3690,3682,3682,3718,3682,3713,3707,31,25,422,15645400,6982
2260,jd1804,20170912,3713,3707,3720,3727,3688,3719,3711,12,4,400,14844620,7002
2261,jd1804,20170913,3719,3711,3705,3715,3650,3659,3671,-52,-40,674,24748000,7044
2262,jd1804,20170914,3659,3671,3668,3689,3660,3682,3675,11,4,598,21981420,6794
2263,jd1804,20170915,3682,3675,3678,3685,3661,3671,3670,-4,-5,288,10571820,6842
2264,jd1804,20170918,3671,3670,3670,3670,3603,3610,3618,-60,-52,728,26343860,6722
2265,jd1804,20170919,3610,3618,3603,3615,3588,3596,3601,-22,-17,454,16350060,6618
2266,jd1804,20170920,3596,3601,3590,3615,3590,3605,3604,4,3,510,18381200,6610
2267,jd1804,20170921,3605,3604,3606,3648,3582,3632,3620,28,16,1078,39031680,6516
2268,jd1804,20170922,3632,3620,3632,3665,3629,3642,3643,22,23,930,33885580,6552
2269,jd1804,20170925,3642,3643,3615,3654,3586,3595,3596,-48,-47,1838,66095720,6642
2270,jd1804,20170926,3595,3596,3600,3628,3597,3616,3605,20,9,472,17018260,6724
2271,jd1804,20170927,3616,3605,3611,3613,3581,3603,3595,-2,-10,362,13014060,6754
2272,jd1804,20170928,3603,3595,3600,3640,3573,3615,3605,20,10,610,21994920,6686
2273,jd1804,20170929,3615,3605,3615,3634,3615,3625,3625,20,20,362,13123000,6688
2274,jd1804,20171009,3625,3625,3640,3653,3601,3646,3628,21,3,446,16183080,6704
2275,jd1804,20171010,3646,3628,3645,3692,3645,3669,3670,41,42,550,20185400,6618
2276,jd1804,20171011,3669,3670,3673,3730,3673,3728,3717,58,47,636,23644940,6454
2277,jd1804,20171012,3728,3717,3734,3739,3711,3713,3721,-4,4,432,16075400,6446
2278,jd1804,20171013,3713,3721,3711,3720,3652,3698,3691,-23,-30,1594,58841460,7278
2279,jd1804,20171016,3698,3691,3700,3758,3700,3737,3739,46,48,810,30288600,7530
2280,jd1804,20171017,3737,3739,3723,3760,3715,3744,3737,5,-2,514,19208320,7648
2281,jd1804,20171018,3744,3737,3750,3759,3736,3753,3750,16,13,1452,54461440,8106
2282,jd1804,20171019,3753,3750,3760,3789,3759,3780,3779,30,29,438,16554480,8106
2283,jd1804,20171020,3780,3779,3780,3820,3780,3796,3804,17,25,786,29903840,8472
2284,jd1804,20171023,3796,3804,3820,3820,3748,3774,3770,-30,-34,234,8822660,8494
2285,jd1804,20171024,3774,3770,3760,3795,3760,3777,3779,7,9,398,15041220,8522
2286,jd1804,20171025,3777,3779,3782,3784,3746,3755,3762,-24,-17,646,24306500,9014
2287,jd1804,20171026,3755,3762,3775,3792,3768,3772,3781,10,19,294,11116500,9046
2288,jd1804,20171027,3772,3781,3780,3780,3715,3741,3741,-40,-40,472,17658380,9158
2289,jd1804,20171030,3741,3741,3744,3755,3692,3692,3721,-49,-20,568,21135640,9346
2290,jd1804,20171031,3692,3721,3690,3699,3678,3690,3689,-31,-32,618,22798700,9530
2291,jd1804,20171101,3690,3689,3695,3726,3693,3701,3709,12,20,932,34570160,9870
2292,jd1804,20171102,3701,3709,3700,3724,3680,3709,3702,0,-7,1180,43692960,9822
2293,jd1804,20171103,3709,3702,3710,3720,3700,3710,3706,8,4,416,15419580,9754
2294,jd1804,20171106,3710,3706,3720,3745,3719,3723,3736,17,30,788,29440200,9378
2295,jd1804,20171107,3723,3736,3740,3752,3735,3747,3741,11,5,664,24844220,9378
2296,jd1804,20171108,3747,3741,3760,3771,3720,3727,3753,-14,12,516,19366900,9418
2297,jd1804,20171109,3727,3753,3727,3737,3706,3725,3725,-28,-28,376,14006460,9288
2298,jd1804,20171110,3725,3725,3732,3739,3700,3707,3728,-18,3,686,25575980,9394
2299,jd1804,20171113,3707,3728,3706,3717,3687,3714,3702,-14,-26,544,20141120,9546
2300,jd1804,20171114,3714,3702,3721,3730,3697,3712,3707,10,5,402,14902980,9590
2301,jd1804,20171115,3712,3707,3687,3727,3687,3710,3709,3,2,324,12020320,9612
2302,jd1804,20171116,3710,3709,3717,3739,3710,3738,3722,29,13,372,13849100,9634
2303,jd1804,20171117,3738,3722,3743,3779,3730,3772,3755,50,33,1002,37629520,9200
2304,jd1804,20171120,3772,3755,3766,3787,3753,3753,3773,-2,18,596,22492680,9036
2305,jd1804,20171121,3753,3773,3761,3788,3761,3784,3775,11,2,322,12155560,9108
2306,jd1804,20171122,3784,3775,3790,3808,3785,3807,3800,32,25,656,24932740,9372
2307,jd1804,20171123,3807,3800,3810,3829,3810,3810,3818,10,18,666,25434020,9608
2308,jd1804,20171124,3810,3818,3810,3850,3810,3848,3832,30,14,510,19543940,9612
2309,jd1804,20171127,3848,3832,3828,3878,3828,3860,3861,28,29,670,25872040,9742
2310,jd1804,20171128,3860,3861,3860,3880,3857,3880,3869,19,8,420,16251060,9736
2311,jd1804,20171129,3880,3869,3889,3946,3882,3946,3920,77,51,954,37399860,9662
2312,jd1804,20171130,3946,3920,3952,4093,3888,3920,3956,0,36,964,38139240,9752
2313,jd1804,20171201,3920,3956,3928,3939,3883,3896,3905,-60,-51,614,23982060,9924
2314,jd1804,20171204,3896,3905,3893,3928,3890,3900,3903,-5,-2,494,19284860,9818
2315,jd1804,20171205,3900,3903,3908,3928,3815,3855,3878,-48,-25,854,33119880,10024
2316,jd1804,20171206,3855,3878,3853,3858,3809,3809,3830,-69,-48,480,18386880,9934
2317,jd1804,20171207,3809,3830,3800,3847,3788,3809,3824,-21,-6,864,33042160,10144
2318,jd1804,20171208,3809,3824,3844,3844,3808,3818,3821,-6,-3,640,24456700,10198
2319,jd1804,20171211,3818,3821,3800,3817,3757,3775,3787,-46,-34,938,35524760,10250
2320,jd1804,20171212,3775,3787,3767,3798,3760,3780,3783,-7,-4,342,12939280,10224
2321,jd1804,20171213,3780,3783,3760,3816,3744,3809,3783,26,0,680,25725880,10310
2322,jd1804,20171214,3809,3783,3800,3826,3800,3820,3815,37,32,420,16023920,10384
2323,jd1804,20171215,3820,3815,3824,3847,3798,3831,3828,16,13,866,33157280,10384
2324,jd1804,20171218,3831,3828,3855,3887,3840,3851,3853,23,25,652,25125780,10562
2325,jd1804,20171219,3851,3853,3866,3866,3785,3787,3801,-66,-52,518,19693880,10640
2326,jd1804,20171220,3787,3801,3766,3784,3758,3765,3774,-36,-27,468,17662900,10714
2327,jd1804,20171221,3765,3774,3779,3803,3725,3753,3769,-21,-5,334,12590640,10702
2328,jd1804,20171222,3753,3769,3763,3791,3759,3781,3774,12,5,458,17288400,10742
2329,jd1804,20171225,3781,3774,3797,3809,3763,3803,3787,29,13,538,20378200,10796
2330,jd1804,20171226,3803,3787,3807,3807,3780,3789,3787,2,0,474,17953280,10998
2331,jd1804,20171227,3789,3787,3783,3798,3780,3790,3787,3,0,216,8180880,10980
2332,jd1804,20171228,3790,3787,3822,3822,3781,3789,3801,2,14,606,23036920,10874
2333,jd1804,20171229,3789,3801,3775,3806,3770,3786,3785,-15,-16,436,16504060,10896
2334,jd1805,20170525,3636,3636,3798,3850,3754,3843,3819,207,183,9854,376398120,6346
2335,jd1805,20170526,3843,3819,3840,3895,3836,3894,3869,75,50,10198,394656520,10420
2336,jd1805,20170531,3894,3869,3903,3998,3896,3955,3965,86,96,17556,696210320,15588
2337,jd1805,20170601,3955,3965,3964,3987,3885,3936,3936,-29,-29,28624,1126725220,17092
2338,jd1805,20170602,3936,3936,3933,3933,3888,3928,3912,-8,-24,13082,511830880,18712
2339,jd1805,20170605,3928,3912,3925,3928,3895,3917,3916,5,4,7320,286712220,20288
2340,jd1805,20170606,3917,3916,3918,3925,3897,3906,3909,-10,-7,6506,254383600,19872
2341,jd1805,20170607,3906,3909,3908,3908,3816,3843,3847,-66,-62,13068,502818040,20408
2342,jd1805,20170608,3843,3847,3835,3859,3820,3827,3836,-20,-11,6274,240696780,20602
2343,jd1805,20170609,3827,3836,3831,3851,3773,3800,3811,-36,-25,12572,479213320,19228
2344,jd1805,20170612,3800,3811,3804,3810,3724,3750,3754,-61,-57,11870,445684180,20272
2345,jd1805,20170613,3750,3754,3751,3800,3698,3737,3727,-17,-27,15428,575112400,21730
2346,jd1805,20170614,3737,3727,3740,3759,3730,3747,3745,20,18,5976,223807160,21706
2347,jd1805,20170615,3747,3745,3752,3755,3693,3701,3712,-44,-33,13242,491673360,24056
2348,jd1805,20170616,3701,3712,3708,3710,3605,3634,3656,-78,-56,18910,691394040,27318
2349,jd1805,20170619,3634,3656,3640,3708,3640,3687,3675,31,19,20978,770971440,26660
2350,jd1805,20170620,3687,3675,3687,3687,3652,3669,3667,-6,-8,6966,255504580,25740
2351,jd1805,20170621,3669,3667,3670,3687,3645,3671,3664,4,-3,8428,308841020,25720
2352,jd1805,20170622,3671,3664,3670,3683,3653,3660,3666,-4,2,18642,683483120,23866
2353,jd1805,20170623,3660,3666,3660,3718,3635,3685,3689,19,23,20410,753103240,21600
2354,jd1805,20170626,3685,3689,3690,3706,3661,3678,3682,-11,-7,7692,283285120,21506
2355,jd1805,20170627,3678,3682,3677,3699,3676,3693,3685,11,3,5608,206698720,21570
2356,jd1805,20170628,3693,3685,3694,3723,3690,3705,3705,20,20,6424,238029960,21006
2357,jd1805,20170629,3705,3705,3708,3713,3668,3668,3683,-37,-22,5220,192284840,20052
2358,jd1805,20170630,3668,3683,3668,3672,3612,3620,3631,-63,-52,8692,315668100,21710
2359,jd1805,20170703,3620,3631,3615,3673,3610,3645,3655,14,24,7088,259080940,21056
2360,jd1805,20170704,3645,3655,3644,3652,3559,3580,3609,-75,-46,12566,453583200,21088
2361,jd1805,20170705,3580,3609,3564,3639,3564,3622,3619,13,10,9482,343214400,19752
2362,jd1805,20170706,3622,3619,3630,3675,3624,3660,3655,41,36,11128,406791200,18918
2363,jd1805,20170707,3660,3655,3664,3668,3640,3646,3654,-9,-1,4612,168534580,18458
2364,jd1805,20170710,3646,3654,3650,3677,3634,3642,3647,-12,-7,4792,174797860,18236
2365,jd1805,20170711,3642,3647,3647,3652,3625,3645,3639,-2,-8,2296,83557720,18300
2366,jd1805,20170712,3645,3639,3646,3655,3628,3642,3640,3,1,2782,101265620,18408
2367,jd1805,20170713,3642,3640,3638,3645,3633,3642,3640,2,0,1376,50099640,18316
2368,jd1805,20170714,3642,3640,3636,3649,3630,3645,3641,5,1,2274,82799920,18228
2369,jd1805,20170717,3645,3641,3639,3684,3638,3678,3660,37,19,4296,157264460,18030
2370,jd1805,20170718,3678,3660,3685,3698,3668,3678,3680,18,20,3496,128669900,17846
2371,jd1805,20170719,3678,3680,3682,3699,3676,3684,3686,4,6,2042,75269100,17986
2372,jd1805,20170720,3684,3686,3686,3690,3674,3680,3681,-6,-5,2500,92041620,17884
2373,jd1805,20170721,3680,3681,3686,3689,3673,3679,3678,-2,-3,1638,60250620,17822
2374,jd1805,20170724,3679,3678,3680,3683,3660,3673,3672,-5,-6,2652,97401960,17532
2375,jd1805,20170725,3673,3672,3678,3710,3678,3706,3696,34,24,5596,206833540,17588
2376,jd1805,20170726,3706,3696,3713,3727,3695,3702,3708,6,12,3642,135075900,17460
2377,jd1805,20170727,3702,3708,3714,3718,3706,3715,3712,7,4,1910,70910860,17912
2378,jd1805,20170728,3715,3712,3711,3768,3711,3752,3747,40,35,7624,285688920,19630
2379,jd1805,20170731,3752,3747,3770,3805,3753,3801,3782,54,35,6818,257895660,20308
2380,jd1805,20170801,3801,3782,3810,3811,3764,3764,3786,-18,4,4286,162285860,20690
2381,jd1805,20170802,3764,3786,3750,3786,3738,3777,3767,-9,-19,4288,161559420,20922
2382,jd1805,20170803,3777,3767,3782,3789,3761,3770,3774,3,7,2702,101992820,21242
2383,jd1805,20170804,3770,3774,3774,3868,3774,3848,3822,74,48,11652,445354840,22738
2384,jd1805,20170807,3848,3822,3889,3945,3868,3885,3906,63,84,11704,457207580,25026
2385,jd1805,20170808,3885,3906,3868,3914,3860,3908,3902,2,-4,7422,289661600,27222
2386,jd1805,20170809,3908,3902,3902,4012,3902,3990,3978,88,76,13102,521313420,28618
2387,jd1805,20170810,3990,3978,4002,4004,3963,3982,3983,4,5,13872,552583180,29818
2388,jd1805,20170811,3982,3983,3990,3994,3910,3970,3954,-13,-29,10280,406533820,30706
2389,jd1805,20170814,3970,3954,3953,3966,3902,3929,3929,-25,-25,12836,504360180,29726
2390,jd1805,20170815,3929,3929,3916,3946,3880,3925,3915,-4,-14,9664,378373900,30146
2391,jd1805,20170816,3925,3915,3948,3959,3921,3930,3940,15,25,5980,235651660,30370
2392,jd1805,20170817,3930,3940,3934,3948,3903,3918,3918,-22,-22,7762,304129820,29688
2393,jd1805,20170818,3918,3918,3916,3950,3916,3930,3936,12,18,5440,214155380,29756
2394,jd1805,20170821,3930,3936,3939,4001,3933,3994,3975,58,39,12472,495799140,29254
2395,jd1805,20170822,3994,3975,4028,4028,3977,3985,3992,10,17,6584,262841920,28940
2396,jd1805,20170823,3985,3992,3963,3965,3875,3902,3908,-90,-84,13858,541627480,29350
2397,jd1805,20170824,3902,3908,3890,3915,3859,3862,3877,-46,-31,6464,250614000,29996
2398,jd1805,20170825,3862,3877,3869,3879,3819,3836,3848,-41,-29,8204,315731740,30558
2399,jd1805,20170828,3836,3848,3800,3866,3782,3843,3835,-5,-13,6190,237418100,30692
2400,jd1805,20170829,3843,3835,3870,3893,3861,3870,3875,35,40,7512,291156600,29232
2401,jd1805,20170830,3870,3875,3875,3890,3799,3810,3824,-65,-51,9160,350349060,30346
2402,jd1805,20170831,3810,3824,3804,3823,3791,3807,3805,-17,-19,6270,238612020,29068
2403,jd1805,20170901,3807,3805,3827,3833,3793,3809,3811,4,6,5724,218182060,28326
2404,jd1805,20170904,3809,3811,3820,3876,3806,3818,3829,7,18,6798,260319960,28526
2405,jd1805,20170905,3818,3829,3828,3838,3790,3811,3809,-18,-20,6716,255848720,29538
2406,jd1805,20170906,3811,3809,3812,3831,3812,3818,3822,9,13,4822,184330040,29796
2407,jd1805,20170907,3818,3822,3815,3820,3757,3773,3783,-49,-39,11552,437073300,30078
2408,jd1805,20170908,3773,3783,3776,3793,3764,3784,3779,1,-4,8148,307944140,29224
2409,jd1805,20170911,3784,3779,3778,3819,3772,3810,3800,31,21,6296,239292440,29532
2410,jd1805,20170912,3810,3800,3800,3823,3768,3789,3794,-11,-6,8104,307508300,30472
2411,jd1805,20170913,3789,3794,3778,3801,3713,3733,3742,-61,-52,13064,488922500,32876
2412,jd1805,20170914,3733,3742,3739,3758,3728,3747,3745,5,3,8766,328362280,32504
2413,jd1805,20170915,3747,3745,3744,3754,3720,3734,3735,-11,-10,8008,299150800,32588
2414,jd1805,20170918,3734,3735,3716,3721,3670,3687,3688,-48,-47,12854,474055700,33364
2415,jd1805,20170919,3687,3688,3680,3695,3656,3674,3677,-14,-11,7726,284137420,34000
2416,jd1805,20170920,3674,3677,3661,3692,3661,3685,3680,8,3,5008,184329520,33448
2417,jd1805,20170921,3685,3680,3689,3760,3650,3729,3706,49,26,17610,652771360,33836
2418,jd1805,20170922,3729,3706,3724,3767,3722,3747,3747,41,41,11326,424424460,34274
2419,jd1805,20170925,3747,3747,3724,3744,3670,3691,3697,-56,-50,10770,398179720,34910
2420,jd1805,20170926,3691,3697,3693,3723,3688,3709,3707,12,10,5070,187945020,34910
2421,jd1805,20170927,3709,3707,3699,3719,3677,3697,3693,-10,-14,7472,275952660,35524
2422,jd1805,20170928,3697,3693,3690,3754,3680,3717,3711,24,18,10928,405642080,35460
2423,jd1805,20170929,3717,3711,3713,3744,3709,3733,3729,22,18,8536,318383220,35626
2424,jd1805,20171009,3733,3729,3722,3762,3705,3756,3740,27,11,12988,485876100,37020
2425,jd1805,20171010,3756,3740,3752,3813,3746,3789,3783,49,43,19360,732443800,39802
2426,jd1805,20171011,3789,3783,3790,3873,3781,3869,3845,86,62,23394,899667260,45892
2427,jd1805,20171012,3869,3845,3875,3882,3840,3856,3856,11,11,13290,512591180,46932
2428,jd1805,20171013,3856,3856,3856,3872,3842,3861,3855,5,-1,18800,724850780,51376
2429,jd1805,20171016,3861,3855,3865,3935,3860,3888,3904,33,49,28932,1129628360,57050
2430,jd1805,20171017,3888,3904,3888,3912,3861,3894,3890,-10,-14,11128,432971080,56008
2431,jd1805,20171018,3894,3890,3888,3904,3865,3880,3881,-10,-9,13968,542216280,57862
2432,jd1805,20171019,3880,3881,3903,3920,3880,3894,3901,13,20,16864,658015500,58114
2433,jd1805,20171020,3894,3901,3900,3932,3900,3910,3915,9,14,16698,653889520,59772
2434,jd1805,20171023,3910,3915,3908,3910,3850,3879,3886,-36,-29,12214,474651260,61068
2435,jd1805,20171024,3879,3886,3871,3903,3865,3884,3887,-2,1,12558,488130840,62946
2436,jd1805,20171025,3884,3887,3887,3895,3878,3890,3887,3,0,6952,270235060,62888
2437,jd1805,20171026,3890,3887,3896,3917,3879,3893,3900,6,13,15890,619715800,66398
2438,jd1805,20171027,3893,3900,3893,3904,3810,3845,3848,-55,-52,28282,1088539680,65240
2439,jd1805,20171030,3845,3848,3855,3864,3783,3786,3820,-62,-28,15392,588069100,66002
2440,jd1805,20171031,3786,3820,3790,3800,3761,3782,3781,-38,-39,15768,596303520,67244
2441,jd1805,20171101,3782,3781,3783,3839,3783,3797,3805,16,24,21154,805078300,69342
2442,jd1805,20171102,3797,3805,3796,3809,3775,3806,3794,1,-11,13444,510174060,70278
2443,jd1805,20171103,3806,3794,3809,3815,3787,3794,3796,0,2,9620,365217420,71556
2444,jd1805,20171106,3794,3796,3810,3838,3802,3816,3820,20,24,18922,722991660,73282
2445,jd1805,20171107,3816,3820,3822,3839,3812,3836,3824,16,4,18074,691272660,75858
2446,jd1805,20171108,3836,3824,3842,3860,3786,3802,3826,-22,2,33634,1287148920,78534
2447,jd1805,20171109,3802,3826,3813,3815,3790,3807,3802,-19,-24,17896,680566360,81156
2448,jd1805,20171110,3807,3802,3805,3828,3770,3787,3798,-15,-4,22214,843868180,83156
2449,jd1805,20171113,3787,3798,3780,3804,3751,3803,3780,5,-18,31434,1188406320,82218
2450,jd1805,20171114,3803,3780,3802,3809,3766,3795,3788,15,8,17532,664263580,82078
2451,jd1805,20171115,3795,3788,3780,3820,3770,3805,3801,17,13,27246,1035680640,81174
2452,jd1805,20171116,3805,3801,3806,3856,3805,3854,3831,53,30,36630,1403477660,87038
2453,jd1805,20171117,3854,3831,3855,3893,3835,3871,3862,40,31,39112,1510792040,91690
2454,jd1805,20171120,3871,3862,3874,3895,3853,3862,3874,0,12,38938,1508660920,96988
2455,jd1805,20171121,3862,3874,3870,3880,3857,3873,3869,-1,-5,19786,765655460,98120
2456,jd1805,20171122,3873,3869,3880,3905,3876,3904,3890,35,21,40286,1567489340,100668
2457,jd1805,20171123,3904,3890,3920,3930,3905,3907,3914,17,24,29120,1139956360,106484
2458,jd1805,20171124,3907,3914,3916,3961,3902,3959,3934,45,20,42222,1661057200,119028
2459,jd1805,20171127,3959,3934,3943,3998,3943,3973,3978,39,44,53404,2124834440,126474
2460,jd1805,20171128,3973,3978,3980,4005,3970,3994,3985,16,7,42520,1694721020,133128
2461,jd1805,20171129,3994,3985,4020,4061,3998,4057,4024,72,39,75890,3054456640,148134
2462,jd1805,20171130,4057,4024,4080,4086,4010,4025,4053,1,29,88970,3606164940,154820
2463,jd1805,20171201,4025,4053,4031,4044,3972,3987,4001,-66,-52,81574,3264290660,156168
2464,jd1805,20171204,3987,4001,3980,4035,3962,4007,4001,6,0,98204,3929243320,166844
2465,jd1805,20171205,4007,4001,4007,4040,3838,3936,3967,-65,-34,171456,6802616020,162188
2466,jd1805,20171206,3936,3967,3940,3945,3880,3890,3905,-77,-62,105040,4102767480,160188
2467,jd1805,20171207,3890,3905,3895,3922,3825,3846,3878,-59,-27,130334,5055118580,158364
2468,jd1805,20171208,3846,3878,3866,3875,3835,3866,3860,-12,-18,77640,2997248180,158008
2469,jd1805,20171211,3866,3860,3862,3870,3796,3820,3829,-40,-31,120756,4623856040,167166
2470,jd1805,20171212,3820,3829,3830,3844,3805,3824,3827,-5,-2,63428,2427602140,167150
2471,jd1805,20171213,3824,3827,3812,3859,3760,3842,3813,15,-14,170660,6508615400,173302
2472,jd1805,20171214,3842,3813,3842,3870,3829,3857,3853,44,40,87856,3385619460,173540
2473,jd1805,20171215,3857,3853,3862,3888,3805,3858,3851,5,-2,150506,5796089900,181604
2474,jd1805,20171218,3858,3851,3885,3910,3855,3870,3880,19,29,114130,4429187580,177666
2475,jd1805,20171219,3870,3880,3870,3870,3801,3808,3820,-72,-60,150456,5747811100,194888
2476,jd1805,20171220,3808,3820,3796,3819,3770,3781,3797,-39,-23,94258,3579664980,191824
2477,jd1805,20171221,3781,3797,3781,3823,3739,3775,3782,-22,-15,140756,5324472340,195768
2478,jd1805,20171222,3775,3782,3792,3799,3770,3789,3783,7,1,63754,2411935400,188266
2479,jd1805,20171225,3789,3783,3810,3825,3751,3809,3792,26,9,120710,4578357940,188308
2480,jd1805,20171226,3809,3792,3801,3810,3774,3781,3791,-11,-1,84154,3190528680,192052
2481,jd1805,20171227,3781,3791,3784,3812,3775,3805,3796,14,5,86452,3281897280,188694
2482,jd1805,20171228,3805,3796,3805,3845,3787,3820,3820,24,24,135784,5188217820,190642
2483,jd1805,20171229,3820,3820,3810,3843,3796,3815,3816,-5,-4,104930,4004865760,181610
2484,jd1806,20170628,3685,3685,3705,3747,3675,3678,3693,-7,8,268,9899280,184
2485,jd1806,20170629,3678,3693,3671,3683,3622,3640,3659,-53,-34,156,5709160,244
2486,jd1806,20170630,3640,3659,3638,3638,3584,3585,3606,-74,-53,84,3029200,282
2487,jd1806,20170703,3585,3606,3653,3658,3612,3629,3638,23,32,358,13025400,488
2488,jd1806,20170704,3629,3638,3623,3623,3562,3580,3595,-58,-43,248,8916480,562
2489,jd1806,20170705,3580,3595,3579,3634,3579,3609,3606,14,11,198,7139980,644
2490,jd1806,20170706,3609,3606,3614,3695,3612,3646,3633,40,27,264,9593660,686
2491,jd1806,20170707,3646,3633,3645,3651,3631,3633,3638,0,5,44,1601080,690
2492,jd1806,20170710,3633,3638,3643,3643,3614,3623,3632,-15,-6,96,3487460,710
2493,jd1806,20170711,3623,3632,3630,3630,3601,3627,3622,-5,-10,56,2028680,710
2494,jd1806,20170712,3627,3622,3616,3636,3616,3629,3626,7,4,56,2031100,734
2495,jd1806,20170713,3629,3626,3634,3634,3626,3630,3627,4,1,62,2249160,764
2496,jd1806,20170714,3630,3627,3634,3639,3625,3635,3633,8,6,68,2470540,786
2497,jd1806,20170717,3635,3633,3637,3665,3630,3664,3654,31,21,296,10815960,866
2498,jd1806,20170718,3664,3654,3672,3685,3663,3665,3671,11,17,288,10574300,824
2499,jd1806,20170719,3665,3671,3672,3683,3672,3672,3675,1,4,20,735180,820
2500,jd1806,20170720,3672,3675,3601,3673,3601,3673,3655,-2,-20,36,1316080,826
2501,jd1806,20170721,3673,3655,3677,3677,3661,3673,3668,18,13,26,953840,828
2502,jd1806,20170724,3673,3668,3655,3663,3655,3663,3660,-5,-8,38,1390880,832
2503,jd1806,20170725,3663,3660,3670,3700,3670,3695,3687,35,27,188,6932560,918
2504,jd1806,20170726,3695,3687,3702,3702,3664,3685,3692,-2,5,296,10929640,986
2505,jd1806,20170727,3685,3692,3688,3695,3687,3690,3690,-2,-2,68,2509700,980
2506,jd1806,20170728,3690,3690,3692,3716,3692,3714,3707,24,17,448,16608480,1122
2507,jd1806,20170731,3714,3707,3706,3767,3697,3766,3745,59,38,486,18201940,1088
2508,jd1806,20170801,3766,3745,3760,3760,3736,3737,3745,-8,0,100,3745700,1070
2509,jd1806,20170802,3737,3745,3720,3746,3720,3743,3739,-2,-6,86,3215920,1052
2510,jd1806,20170803,3743,3739,3731,3753,3731,3747,3743,8,4,104,3893700,1030
2511,jd1806,20170804,3747,3743,3760,3863,3759,3843,3816,100,73,546,20837860,1156
2512,jd1806,20170807,3843,3816,3856,3917,3852,3885,3885,69,69,540,20983100,1168
2513,jd1806,20170808,3885,3885,3894,3913,3885,3909,3895,24,10,388,15116080,1336
2514,jd1806,20170809,3909,3895,3906,4006,3906,3993,3956,98,61,542,21446460,1492
2515,jd1806,20170810,3993,3956,3984,3988,3955,3980,3971,24,15,284,11280400,1404
2516,jd1806,20170811,3980,3971,3986,3986,3911,3950,3942,-21,-29,416,16400680,1274
2517,jd1806,20170814,3950,3942,3985,3985,3852,3939,3931,-3,-11,228,8963720,1294
2518,jd1806,20170815,3939,3931,3903,3944,3903,3922,3918,-9,-13,132,5172640,1324
2519,jd1806,20170816,3922,3918,3934,3945,3928,3928,3935,10,17,110,4328740,1306
2520,jd1806,20170817,3928,3935,3935,3935,3911,3919,3919,-16,-16,90,3527300,1314
2521,jd1806,20170818,3919,3919,3935,3935,3920,3920,3929,1,10,120,4715680,1306
2522,jd1806,20170821,3920,3929,3940,3980,3935,3977,3957,48,28,372,14720860,1332
2523,jd1806,20170822,3977,3957,4028,4028,3965,3965,3981,8,24,152,6052480,1288
2524,jd1806,20170823,3965,3981,3946,3946,3875,3890,3917,-91,-64,288,11281840,1242
2525,jd1806,20170824,3890,3917,3906,3978,3875,3876,3893,-41,-24,160,6229340,1250
2526,jd1806,20170825,3876,3893,3865,3888,3855,3866,3872,-27,-21,166,6428900,1254
2527,jd1806,20170828,3866,3872,3867,3872,3858,3872,3865,0,-7,54,2087340,1260
2528,jd1806,20170829,3872,3865,3893,3901,3876,3885,3892,20,27,66,2569080,1272
2529,jd1806,20170830,3885,3892,3871,3872,3830,3839,3849,-53,-43,200,7699860,1300
2530,jd1806,20170831,3839,3849,3836,3845,3825,3833,3835,-16,-14,126,4832540,1298
2531,jd1806,20170901,3833,3835,3849,3849,3820,3831,3832,-4,-3,118,4521760,1288
2532,jd1806,20170904,3831,3832,3836,3860,3833,3850,3847,18,15,154,5924520,1276
2533,jd1806,20170905,3850,3847,3898,3898,3825,3849,3846,2,-1,256,9847620,1294
2534,jd1806,20170906,3849,3846,3890,3890,3820,3868,3863,22,17,224,8653500,1288
2535,jd1806,20170907,3868,3863,3905,3905,3754,3798,3813,-65,-50,402,15328520,1244
2536,jd1806,20170908,3798,3813,3836,3836,3754,3795,3786,-18,-27,294,11133580,1218
2537,jd1806,20170911,3795,3786,3808,3815,3800,3808,3803,22,17,70,2662560,1200
2538,jd1806,20170912,3808,3803,3827,3827,3790,3792,3804,-11,1,72,2739360,1192
2539,jd1806,20170913,3792,3804,3799,3799,3724,3748,3753,-56,-51,116,4353620,1168
2540,jd1806,20170914,3748,3753,3738,3771,3738,3771,3754,18,1,108,4054860,1150
2541,jd1806,20170915,3771,3754,3789,3789,3732,3734,3755,-20,1,172,6459700,1162
2542,jd1806,20170918,3734,3755,3699,3699,3657,3694,3682,-61,-73,110,4050300,1138
2543,jd1806,20170919,3694,3682,3686,3699,3672,3684,3685,2,3,36,1326720,1140
2544,jd1806,20170920,3684,3685,3685,3692,3677,3679,3682,-6,-3,142,5229140,1066
2545,jd1806,20170921,3679,3682,3670,3736,3656,3711,3686,29,4,192,7078560,990
2546,jd1806,20170922,3711,3686,3750,3750,3729,3733,3736,47,50,24,896820,984
2547,jd1806,20170925,3733,3736,3718,3721,3660,3675,3688,-61,-48,72,2655920,984
2548,jd1806,20170926,3675,3688,3681,3704,3681,3695,3694,7,6,62,2290360,978
2549,jd1806,20170927,3695,3694,3687,3694,3675,3694,3685,0,-9,32,1179260,964
2550,jd1806,20170928,3694,3685,3684,3730,3673,3695,3687,10,2,136,5014440,1024
2551,jd1806,20170929,3695,3687,3699,3727,3699,3727,3712,40,25,88,3267160,994
2552,jd1806,20171009,3727,3712,3706,3739,3706,3739,3724,27,12,64,2383560,988
2553,jd1806,20171010,3739,3724,3750,3774,3750,3765,3764,41,40,76,2860960,1016
2554,jd1806,20171011,3765,3764,3766,3828,3765,3822,3807,58,43,72,2741200,1034
2555,jd1806,20171012,3822,3807,3850,3850,3810,3810,3821,3,14,36,1375760,1038
2556,jd1806,20171013,3810,3821,3805,3810,3755,3777,3782,-44,-39,500,18913260,1420
2557,jd1806,20171016,3777,3782,3799,3840,3793,3803,3824,21,42,252,9636580,1512
2558,jd1806,20171017,3803,3824,3801,3820,3783,3803,3801,-21,-23,92,3497360,1520
2559,jd1806,20171018,3803,3801,3795,3797,3780,3786,3790,-15,-11,70,2653500,1520
2560,jd1806,20171019,3786,3790,3809,3836,3802,3802,3808,12,18,130,4951020,1578
2561,jd1806,20171020,3802,3808,3809,3860,3804,3810,3820,2,12,158,6036060,1666
2562,jd1806,20171023,3810,3820,3800,3810,3781,3788,3794,-32,-26,96,3643060,1700
2563,jd1806,20171024,3788,3794,3791,3800,3780,3781,3789,-13,-5,52,1970540,1714
2564,jd1806,20171025,3781,3789,3809,3809,3787,3787,3791,-2,2,38,1440700,1702
2565,jd1806,20171026,3787,3791,3806,3829,3783,3787,3793,-4,2,252,9558700,1844
2566,jd1806,20171027,3787,3793,3788,3788,3713,3762,3752,-31,-41,666,24993160,2252
2567,jd1806,20171030,3762,3752,3756,3758,3700,3706,3733,-46,-19,496,18516240,2576
2568,jd1806,20171031,3706,3733,3702,3729,3680,3690,3700,-43,-33,366,13543860,2782
2569,jd1806,20171101,3690,3700,3726,3734,3703,3715,3719,15,19,182,6769500,2768
2570,jd1806,20171102,3715,3719,3704,3712,3687,3710,3704,-9,-15,64,2371120,2778
2571,jd1806,20171103,3710,3704,3715,3715,3686,3690,3694,-14,-10,432,15959900,3158
2572,jd1806,20171106,3690,3694,3707,3730,3707,3720,3721,26,27,154,5731260,3194
2573,jd1806,20171107,3720,3721,3725,3735,3718,3729,3726,8,5,82,3055340,3196
2574,jd1806,20171108,3729,3726,3740,3756,3700,3708,3733,-18,7,798,29795380,3016
2575,jd1806,20171109,3708,3733,3700,3712,3686,3705,3696,-28,-37,278,10275360,3194
2576,jd1806,20171110,3705,3696,3705,3720,3686,3686,3704,-10,8,168,6223920,3206
2577,jd1806,20171113,3686,3704,3679,3692,3642,3676,3658,-28,-46,1290,47200860,4164
2578,jd1806,20171114,3676,3658,3670,3677,3640,3652,3652,-6,-6,906,33092600,4658
2579,jd1806,20171115,3652,3652,3640,3651,3630,3641,3640,-11,-12,496,18056460,4776
2580,jd1806,20171116,3641,3640,3631,3669,3631,3669,3646,29,6,920,33546820,5150
2581,jd1806,20171117,3669,3646,3670,3705,3660,3693,3679,47,33,702,25830720,5178
2582,jd1806,20171120,3693,3679,3702,3708,3681,3688,3696,9,17,204,7541200,5200
2583,jd1806,20171121,3688,3696,3700,3714,3691,3705,3700,9,4,466,17243020,5108
2584,jd1806,20171122,3705,3700,3720,3740,3718,3731,3727,31,27,394,14687820,5114
2585,jd1806,20171123,3731,3727,3748,3756,3741,3743,3747,16,20,444,16640020,5096
2586,jd1806,20171124,3743,3747,3752,3817,3749,3805,3777,58,30,966,36488080,5076
2587,jd1806,20171127,3805,3777,3801,3850,3801,3819,3829,42,52,660,25272880,5202
2588,jd1806,20171128,3819,3829,3822,3848,3820,3837,3833,8,4,704,26989780,5284
2589,jd1806,20171129,3837,3833,3848,3890,3842,3890,3860,57,27,826,31891160,5500
2590,jd1806,20171130,3890,3860,3896,3914,3842,3842,3881,-18,21,1152,44720540,5418
2591,jd1806,20171201,3842,3881,3855,3860,3811,3832,3836,-49,-45,622,23865460,5654
2592,jd1806,20171204,3832,3836,3820,3870,3810,3855,3848,19,12,666,25630860,5548
2593,jd1806,20171205,3855,3848,3860,3876,3756,3820,3821,-28,-27,1006,38444660,5514
2594,jd1806,20171206,3820,3821,3810,3827,3766,3777,3797,-44,-24,864,32814100,5578
2595,jd1806,20171207,3777,3797,3802,3830,3780,3797,3802,0,5,1808,68748320,5504
2596,jd1806,20171208,3797,3802,3808,3822,3781,3804,3801,2,-1,1056,40145160,5710
2597,jd1806,20171211,3804,3801,3800,3804,3757,3765,3781,-36,-20,1014,38342420,6128
2598,jd1806,20171212,3765,3781,3763,3782,3762,3774,3771,-7,-10,338,12747940,6296
2599,jd1806,20171213,3774,3771,3770,3809,3735,3801,3777,30,6,748,28259020,6508
2600,jd1806,20171214,3801,3777,3805,3817,3797,3806,3807,29,30,380,14468240,6628
2601,jd1806,20171215,3806,3807,3804,3831,3780,3825,3814,18,7,684,26094020,6696
2602,jd1806,20171218,3825,3814,3854,3864,3834,3836,3849,22,35,684,26332360,6934
2603,jd1806,20171219,3836,3849,3845,3845,3790,3794,3800,-55,-49,564,21436340,6998
2604,jd1806,20171220,3794,3800,3780,3791,3753,3753,3775,-47,-25,518,19556100,7088
2605,jd1806,20171221,3753,3775,3770,3785,3720,3747,3751,-28,-24,724,27161960,7340
2606,jd1806,20171222,3747,3751,3750,3758,3737,3751,3749,0,-2,274,10273500,7322
2607,jd1806,20171225,3751,3749,3769,3777,3730,3760,3752,11,3,382,14334500,7326
2608,jd1806,20171226,3760,3752,3764,3769,3743,3750,3754,-2,2,244,9160520,7378
2609,jd1806,20171227,3750,3754,3742,3757,3735,3754,3748,0,-6,264,9896340,7340
2610,jd1806,20171228,3754,3748,3752,3776,3748,3767,3765,19,17,408,15363720,7348
2611,jd1806,20171229,3767,3765,3760,3780,3751,3760,3761,-5,-4,280,10532720,7342
2612,jd1807,20170727,3692,3692,3874,3874,3761,3789,3775,97,83,322,12156880,190
2613,jd1807,20170728,3789,3775,3771,3818,3771,3792,3805,17,30,218,8295100,306
2614,jd1807,20170731,3792,3805,3800,3840,3798,3830,3823,25,18,364,13916920,532
2615,jd1807,20170801,3830,3823,3830,3845,3808,3808,3827,-15,4,168,6429680,574
2616,jd1807,20170802,3808,3827,3816,3817,3796,3810,3805,-17,-22,282,10732040,748
2617,jd1807,20170803,3810,3805,3805,3820,3786,3820,3809,15,4,166,6323540,836
2618,jd1807,20170804,3820,3809,3825,3891,3825,3881,3862,72,53,396,15295560,1018
2619,jd1807,20170807,3881,3862,3920,3930,3895,3910,3917,48,55,488,19118820,1254
2620,jd1807,20170808,3910,3917,3906,3922,3902,3916,3914,-1,-3,196,7671440,1404
2621,jd1807,20170809,3916,3914,3926,4009,3926,4005,3981,91,67,904,35992420,1726
2622,jd1807,20170810,4005,3981,3988,4004,3977,3993,3989,12,8,342,13643080,1814
2623,jd1807,20170811,3993,3989,4005,4005,3928,3970,3956,-19,-33,408,16140540,1942
2624,jd1807,20170814,3970,3956,3960,3960,3923,3945,3939,-11,-17,284,11187980,1904
2625,jd1807,20170815,3945,3939,3920,3958,3910,3927,3925,-12,-14,274,10755240,1984
2626,jd1807,20170816,3927,3925,3945,3955,3935,3940,3942,15,17,166,6544320,2030
2627,jd1807,20170817,3940,3942,3932,3940,3915,3930,3929,-12,-13,140,5500780,2040
2628,jd1807,20170818,3930,3929,3935,3960,3925,3935,3941,6,12,188,7409720,2074
2629,jd1807,20170821,3935,3941,3950,4006,3950,3998,3981,57,40,524,20864700,2136
2630,jd1807,20170822,3998,3981,4010,4014,3981,4007,4005,26,24,548,21949880,2364
2631,jd1807,20170823,4007,4005,3968,3990,3931,3940,3963,-65,-42,794,31469520,2048
2632,jd1807,20170824,3940,3963,3953,3953,3915,3925,3929,-38,-34,222,8724220,2058
2633,jd1807,20170825,3925,3929,3932,3932,3880,3891,3896,-38,-33,302,11766700,1968
2634,jd1807,20170828,3891,3896,3861,3899,3861,3885,3883,-11,-13,214,8311540,1968
2635,jd1807,20170829,3885,3883,3910,3921,3892,3892,3904,9,21,308,12025860,2018
2636,jd1807,20170830,3892,3904,3894,3894,3840,3840,3861,-64,-43,276,10658540,1918
2637,jd1807,20170831,3840,3861,3840,3869,3829,3851,3844,-10,-17,140,5381840,1896
2638,jd1807,20170901,3851,3844,3875,3877,3845,3845,3855,1,11,300,11565720,1896
2639,jd1807,20170904,3845,3855,3870,3892,3845,3869,3874,14,19,310,12011240,1846
2640,jd1807,20170905,3869,3874,3866,3870,3850,3869,3860,-5,-14,208,8029960,1704
2641,jd1807,20170906,3869,3860,3881,3887,3871,3879,3879,19,19,116,4500000,1674
2642,jd1807,20170907,3879,3879,3930,3930,3820,3827,3845,-52,-34,220,8460160,1626
2643,jd1807,20170908,3827,3845,3820,3848,3818,3823,3833,-22,-12,118,4523260,1574
2644,jd1807,20170911,3823,3833,3855,3861,3834,3849,3848,16,15,30,1154580,1574
2645,jd1807,20170912,3849,3848,3840,3875,3836,3867,3850,19,2,244,9394240,1518
2646,jd1807,20170913,3867,3850,3910,3910,3800,3806,3834,-44,-16,348,13345020,1358
2647,jd1807,20170914,3806,3834,3845,3850,3798,3823,3834,-11,0,80,3067260,1378
2648,jd1807,20170915,3823,3834,3808,3831,3808,3813,3819,-21,-15,60,2291880,1394
2649,jd1807,20170918,3813,3819,3736,3847,3736,3781,3780,-38,-39,196,7409860,1348
2650,jd1807,20170919,3781,3780,3750,3793,3750,3775,3777,-5,-3,112,4231160,1360
2651,jd1807,20170920,3775,3777,3770,3781,3770,3771,3773,-6,-4,110,4150420,1300
2652,jd1807,20170921,3771,3773,3765,3827,3753,3811,3776,38,3,120,4532160,1318
2653,jd1807,20170922,3811,3776,3815,3824,3790,3801,3812,25,36,114,4346140,1350
2654,jd1807,20170925,3801,3812,3799,3799,3761,3775,3772,-37,-40,142,5356740,1340
2655,jd1807,20170926,3775,3772,3765,3786,3765,3785,3777,13,5,28,1057820,1352
2656,jd1807,20170927,3785,3777,3771,3780,3751,3762,3761,-15,-16,118,4438360,1378
2657,jd1807,20170928,3762,3761,3761,3800,3752,3775,3771,14,10,188,7091180,1308
2658,jd1807,20170929,3775,3771,3767,3788,3764,3776,3771,5,0,154,5808660,1304
2659,jd1807,20171009,3776,3771,3801,3803,3761,3793,3789,22,18,132,5001920,1272
2660,jd1807,20171010,3793,3789,3793,3850,3793,3830,3827,41,38,606,23193780,1662
2661,jd1807,20171011,3830,3827,3837,3902,3837,3896,3873,69,46,464,17972660,1946
2662,jd1807,20171012,3896,3873,3904,3909,3876,3885,3886,12,13,194,7540560,2032
2663,jd1807,20171013,3885,3886,3884,3891,3835,3851,3863,-35,-23,1352,52238580,2914
2664,jd1807,20171016,3851,3863,3851,3922,3851,3889,3901,26,38,200,7803860,2984
2665,jd1807,20171017,3889,3901,3890,3899,3881,3893,3889,-8,-12,80,3111900,3024
2666,jd1807,20171018,3893,3889,3885,3896,3872,3883,3887,-6,-2,122,4742160,3060
2667,jd1807,20171019,3883,3887,3901,3920,3886,3886,3900,-1,13,60,2340480,3060
2668,jd1807,20171020,3886,3900,3907,3928,3905,3909,3913,9,13,250,9782920,3094
2669,jd1807,20171023,3909,3913,3891,3895,3872,3885,3885,-28,-28,58,2253600,3106
2670,jd1807,20171024,3885,3885,3878,3893,3861,3879,3878,-6,-7,316,12256580,3210
2671,jd1807,20171025,3879,3878,3885,3886,3879,3885,3882,7,4,50,1941280,3220
2672,jd1807,20171026,3885,3882,3885,3906,3884,3900,3896,18,14,204,7947960,3220
2673,jd1807,20171027,3900,3896,3904,3904,3821,3870,3861,-26,-35,260,10040380,3158
2674,jd1807,20171030,3870,3861,3847,3862,3811,3812,3847,-49,-14,364,14005500,3148
2675,jd1807,20171031,3812,3847,3809,3829,3795,3807,3810,-40,-37,224,8535800,3078
2676,jd1807,20171101,3807,3810,3807,3859,3807,3818,3826,8,16,256,9797000,3038
2677,jd1807,20171102,3818,3826,3823,3828,3800,3800,3807,-26,-19,140,5329880,2974
2678,jd1807,20171103,3800,3807,3810,3810,3773,3786,3785,-21,-22,238,9010000,2972
2679,jd1807,20171106,3786,3785,3813,3815,3797,3799,3803,14,18,128,4868260,2898
2680,jd1807,20171107,3799,3803,3807,3819,3797,3808,3809,5,6,120,4571960,2894
2681,jd1807,20171108,3808,3809,3818,3830,3776,3792,3811,-17,2,266,10137860,2920
2682,jd1807,20171109,3792,3811,3778,3788,3763,3784,3775,-27,-36,156,5889740,2906
2683,jd1807,20171110,3784,3775,3784,3784,3756,3756,3774,-19,-1,208,7850140,2894
2684,jd1807,20171113,3756,3774,3770,3770,3726,3762,3743,-12,-31,428,16023860,3008
2685,jd1807,20171114,3762,3743,3766,3766,3736,3745,3747,2,4,154,5771600,3006
2686,jd1807,20171115,3745,3747,3746,3752,3731,3745,3740,-2,-7,402,15035700,2902
2687,jd1807,20171116,3745,3740,3733,3753,3722,3735,3736,-5,-4,196,7323020,2846
2688,jd1807,20171117,3735,3736,3749,3791,3749,3770,3770,34,34,254,9577560,2798
2689,jd1807,20171120,3770,3770,3782,3791,3765,3774,3781,4,11,134,5067600,2804
2690,jd1807,20171121,3774,3781,3774,3785,3766,3772,3775,-9,-6,96,3624560,2802
2691,jd1807,20171122,3772,3775,3783,3798,3783,3798,3791,23,16,134,5080620,2846
2692,jd1807,20171123,3798,3791,3805,3812,3795,3809,3807,18,16,262,9975980,2822
2693,jd1807,20171124,3809,3807,3810,3839,3799,3837,3818,30,11,194,7408000,2886
2694,jd1807,20171127,3837,3818,3838,3868,3838,3842,3855,24,37,176,6784960,2922
2695,jd1807,20171128,3842,3855,3853,3862,3843,3862,3849,7,-6,532,20479860,3290
2696,jd1807,20171129,3862,3849,3863,3920,3863,3920,3885,71,36,724,28131900,3666
2697,jd1807,20171130,3920,3885,3923,3938,3880,3889,3920,4,35,558,21875320,3732
2698,jd1807,20171201,3889,3920,3904,3906,3862,3862,3878,-58,-42,490,19005020,4108
2699,jd1807,20171204,3862,3878,3854,3891,3839,3885,3875,7,-3,226,8759180,4136
2700,jd1807,20171205,3885,3875,3888,3897,3786,3850,3854,-25,-21,598,23049960,4442
2701,jd1807,20171206,3850,3854,3830,3849,3803,3811,3828,-43,-26,212,8115700,4430
2702,jd1807,20171207,3811,3828,3811,3867,3805,3805,3823,-23,-5,338,12922020,4526
2703,jd1807,20171208,3805,3823,3825,3825,3793,3808,3811,-15,-12,378,14406680,4366
2704,jd1807,20171211,3808,3811,3797,3810,3765,3781,3786,-30,-25,256,9694380,4344
2705,jd1807,20171212,3781,3786,3777,3792,3764,3787,3774,1,-12,168,6340600,4378
2706,jd1807,20171213,3787,3774,3785,3810,3748,3803,3786,29,12,576,21813020,4240
2707,jd1807,20171214,3803,3786,3809,3817,3792,3809,3812,23,26,200,7624840,4290
2708,jd1807,20171215,3809,3812,3825,3834,3792,3822,3818,10,6,456,17411060,4234
2709,jd1807,20171218,3822,3818,3853,3873,3832,3841,3854,23,36,348,13412020,4280
2710,jd1807,20171219,3841,3854,3824,3850,3793,3800,3804,-54,-50,96,3652100,4292
2711,jd1807,20171220,3800,3804,3777,3798,3756,3777,3782,-27,-22,134,5068980,4300
2712,jd1807,20171221,3777,3782,3779,3797,3750,3756,3764,-26,-18,354,13326520,4348
2713,jd1807,20171222,3756,3764,3769,3769,3746,3760,3758,-4,-6,86,3232260,4368
2714,jd1807,20171225,3760,3758,3767,3780,3738,3776,3761,18,3,90,3385260,4360
2715,jd1807,20171226,3776,3761,3783,3783,3756,3763,3771,2,10,132,4978860,4334
2716,jd1807,20171227,3763,3771,3760,3776,3752,3776,3767,5,-4,112,4219880,4322
2717,jd1807,20171228,3776,3767,3773,3796,3773,3785,3787,18,20,156,5909240,4348
2718,jd1807,20171229,3785,3787,3782,3790,3767,3787,3779,0,-8,106,4006320,4348
2719,jd1808,20170829,3883,3883,3968,4086,3968,4064,4070,181,187,158,6431800,120
2720,jd1808,20170830,4064,4070,4075,4077,4005,4016,4027,-54,-43,148,5960020,170
2721,jd1808,20170831,4016,4027,4019,4047,4018,4038,4034,11,7,132,5324900,192
2722,jd1808,20170901,4038,4034,4046,4048,4028,4036,4036,2,2,390,15743160,436
2723,jd1808,20170904,4036,4036,4047,4080,4028,4048,4061,12,25,306,12428820,540
2724,jd1808,20170905,4048,4061,4045,4069,4044,4052,4054,-9,-7,90,3649300,576
2725,jd1808,20170906,4052,4054,4067,4075,4053,4073,4068,19,14,80,3254660,600
2726,jd1808,20170907,4073,4068,4060,4068,4031,4038,4046,-30,-22,128,5179720,624
2727,jd1808,20170908,4038,4046,4050,4050,4037,4050,4045,4,-1,308,12460520,622
2728,jd1808,20170911,4050,4045,4050,4077,4050,4069,4066,24,21,240,9760580,732
2729,jd1808,20170912,4069,4066,4083,4084,4056,4072,4068,6,2,76,3091960,730
2730,jd1808,20170913,4072,4068,4062,4062,4028,4033,4043,-35,-25,174,7034940,688
2731,jd1808,20170914,4033,4043,4033,4053,4022,4036,4033,-7,-10,350,14116280,874
2732,jd1808,20170915,4036,4033,4040,4042,4026,4030,4032,-3,-1,172,6935760,854
2733,jd1808,20170918,4030,4032,4012,4029,3973,3986,3995,-46,-37,216,8631280,820
2734,jd1808,20170919,3986,3995,3955,3988,3955,3970,3975,-25,-20,180,7155860,842
2735,jd1808,20170920,3970,3975,3979,3994,3970,3982,3980,7,5,196,7801160,878
2736,jd1808,20170921,3982,3980,4000,4038,3966,4013,4002,33,22,326,13048260,1020
2737,jd1808,20170922,4013,4002,4011,4030,4008,4012,4016,10,14,218,8754900,1142
2738,jd1808,20170925,4012,4016,3993,4005,3970,3988,3989,-28,-27,334,13323620,1184
2739,jd1808,20170926,3988,3989,3999,4005,3983,4000,3995,11,6,182,7272600,1260
2740,jd1808,20170927,4000,3995,3992,4008,3983,4000,3995,5,0,176,7032220,1276
2741,jd1808,20170928,4000,3995,4007,4040,3988,4017,4012,22,17,144,5778600,1280
2742,jd1808,20170929,4017,4012,4045,4045,4023,4036,4030,24,18,116,4675180,1280
2743,jd1808,20171009,4036,4030,4069,4069,4039,4058,4053,28,23,190,7701160,1360
2744,jd1808,20171010,4058,4053,4058,4105,4058,4089,4082,36,29,322,13146440,1458
2745,jd1808,20171011,4089,4082,4076,4195,4076,4172,4156,90,74,824,34251780,1914
2746,jd1808,20171012,4172,4156,4175,4193,4142,4155,4158,-1,2,326,13555120,2088
2747,jd1808,20171013,4155,4158,4155,4164,4141,4159,4151,1,-7,386,16023060,2346
2748,jd1808,20171016,4159,4151,4160,4218,4160,4176,4196,25,45,472,19807860,2684
2749,jd1808,20171017,4176,4196,4131,4203,4131,4193,4172,-3,-24,188,7844300,2754
2750,jd1808,20171018,4193,4172,4205,4205,4173,4175,4180,3,8,156,6520900,2752
2751,jd1808,20171019,4175,4180,4180,4220,4179,4191,4192,11,12,268,11234760,2804
2752,jd1808,20171020,4191,4192,4200,4212,4190,4195,4199,3,7,214,8987140,2896
2753,jd1808,20171023,4195,4199,4200,4200,4170,4179,4181,-20,-18,126,5268520,2890
2754,jd1808,20171024,4179,4181,4171,4197,4171,4180,4184,-1,3,116,4853580,2904
2755,jd1808,20171025,4180,4184,4180,4185,4178,4185,4181,1,-3,42,1756060,2872
2756,jd1808,20171026,4185,4181,4189,4197,4183,4183,4189,2,8,50,2094860,2862
2757,jd1808,20171027,4183,4189,4177,4184,4116,4148,4145,-41,-44,302,12519440,2738
2758,jd1808,20171030,4148,4145,4141,4141,4097,4118,4118,-27,-27,86,3541620,2732
2759,jd1808,20171031,4118,4118,4071,4089,4054,4073,4068,-45,-50,150,6103440,2644
2760,jd1808,20171101,4073,4068,4092,4135,4066,4078,4094,10,26,180,7369800,2714
2761,jd1808,20171102,4078,4094,4086,4087,4060,4072,4069,-22,-25,218,8872520,2638
2762,jd1808,20171103,4072,4069,4090,4090,4034,4037,4050,-32,-19,190,7695800,2576
2763,jd1808,20171106,4037,4050,4050,4069,4040,4051,4051,1,1,466,18881720,2490
2764,jd1808,20171107,4051,4051,4052,4076,4049,4068,4058,17,7,254,10308700,2412
2765,jd1808,20171108,4068,4058,4070,4089,4025,4035,4064,-23,6,182,7397620,2354
2766,jd1808,20171109,4035,4064,4025,4028,4002,4006,4011,-58,-53,432,17329320,2334
2767,jd1808,20171110,4006,4011,4005,4018,3989,3989,4002,-22,-9,410,16411200,2304
2768,jd1808,20171113,3989,4002,3990,4027,3986,4020,4013,18,11,1150,46153180,2696
2769,jd1808,20171114,4020,4013,4020,4032,4006,4012,4018,-1,5,606,24352660,2922
2770,jd1808,20171115,4012,4018,4015,4031,4006,4016,4019,-2,1,476,19132060,3046
2771,jd1808,20171116,4016,4019,4016,4040,4015,4040,4025,21,6,160,6440820,3118
2772,jd1808,20171117,4040,4025,4057,4088,4033,4079,4061,54,36,500,20306520,3098
2773,jd1808,20171120,4079,4061,4089,4094,4070,4080,4084,19,23,132,5391940,3126
2774,jd1808,20171121,4080,4084,4078,4087,4071,4076,4076,-8,-8,376,15327660,3288
2775,jd1808,20171122,4076,4076,4088,4096,4082,4086,4088,10,12,294,12018980,3492
2776,jd1808,20171123,4086,4088,4110,4110,4080,4094,4094,6,6,744,30462000,3594
2777,jd1808,20171124,4094,4094,4092,4125,4092,4125,4106,31,12,314,12895260,3768
2778,jd1808,20171127,4125,4106,4136,4145,4115,4134,4134,28,28,242,10004320,3916
2779,jd1808,20171128,4134,4134,4147,4154,4134,4150,4145,16,11,180,7461220,4026
2780,jd1808,20171129,4150,4145,4173,4214,4152,4213,4187,68,42,364,15244100,4016
2781,jd1808,20171130,4213,4187,4224,4227,4185,4191,4216,4,29,446,18805000,4006
2782,jd1808,20171201,4191,4216,4201,4201,4160,4170,4178,-46,-38,194,8105540,3982
2783,jd1808,20171204,4170,4178,4178,4180,4146,4171,4169,-7,-9,182,7588980,4044
2784,jd1808,20171205,4171,4169,4187,4194,4111,4160,4169,-9,0,288,12009060,4024
2785,jd1808,20171206,4160,4169,4131,4155,4121,4122,4133,-47,-36,278,11490400,3932
2786,jd1808,20171207,4122,4133,4126,4145,4104,4105,4124,-28,-9,344,14188980,3824
2787,jd1808,20171208,4105,4124,4115,4123,4081,4091,4096,-33,-28,442,18106320,3988
2788,jd1808,20171211,4091,4096,4080,4093,4050,4066,4065,-30,-31,416,16911740,3946
2789,jd1808,20171212,4066,4065,4057,4091,4053,4082,4077,17,12,316,12886080,4116
2790,jd1808,20171213,4082,4077,4060,4105,4053,4100,4080,23,3,234,9547300,4076
2791,jd1808,20171214,4100,4080,4099,4115,4095,4106,4103,26,23,88,3611500,4090
2792,jd1808,20171215,4106,4103,4118,4123,4091,4109,4108,6,5,334,13722260,4092
2793,jd1808,20171218,4109,4108,4073,4149,4073,4104,4102,-4,-6,364,14934260,4084
2794,jd1808,20171219,4104,4102,4099,4101,4080,4080,4087,-22,-15,300,12262640,3960
2795,jd1808,20171220,4080,4087,4056,4087,4056,4073,4081,-14,-6,232,9468320,4026
2796,jd1808,20171221,4073,4081,4080,4134,4060,4075,4079,-6,-2,360,14687960,4126
2797,jd1808,20171222,4075,4079,4079,4087,4065,4067,4069,-12,-10,150,6104660,4014
2798,jd1808,20171225,4067,4069,4071,4095,4063,4091,4076,22,7,186,7581860,4080
2799,jd1808,20171226,4091,4076,4112,4112,4066,4071,4084,-5,8,284,11600920,4024
2800,jd1808,20171227,4071,4084,4078,4087,4076,4080,4080,-4,-4,78,3182900,4008
2801,jd1808,20171228,4080,4080,4079,4107,4078,4100,4093,20,13,284,11624640,4146
2802,jd1808,20171229,4100,4093,4147,4147,4074,4091,4099,-2,6,458,18777060,4066
2803,jd1809,20170927,3995,3995,4210,4260,4210,4228,4230,233,235,1966,83174480,1586
2804,jd1809,20170928,4228,4230,4210,4297,4206,4263,4248,33,18,1194,50722660,2104
2805,jd1809,20170929,4263,4248,4265,4290,4256,4282,4273,34,25,910,38886060,2542
2806,jd1809,20171009,4282,4273,4303,4325,4259,4307,4293,34,20,1362,58478920,3370
2807,jd1809,20171010,4307,4293,4291,4350,4291,4325,4321,32,28,2552,110274920,4702
2808,jd1809,20171011,4325,4321,4320,4365,4316,4360,4343,39,22,3236,140551160,6868
2809,jd1809,20171012,4360,4343,4350,4365,4337,4346,4347,3,4,1468,63814000,7426
2810,jd1809,20171013,4346,4347,4345,4358,4336,4350,4346,3,-1,1448,62930700,7928
2811,jd1809,20171016,4350,4346,4346,4397,4346,4369,4380,23,34,2082,91198660,8850
2812,jd1809,20171017,4369,4380,4362,4390,4353,4378,4374,-2,-6,1092,47767040,9154
2813,jd1809,20171018,4378,4374,4376,4386,4362,4363,4369,-11,-5,1192,52082220,9294
2814,jd1809,20171019,4363,4369,4361,4390,4361,4374,4380,5,11,1924,84275820,10042
2815,jd1809,20171020,4374,4380,4380,4399,4377,4390,4390,10,10,2226,97726520,10768
2816,jd1809,20171023,4390,4390,4410,4410,4355,4377,4377,-13,-13,1036,45346340,10868
2817,jd1809,20171024,4377,4377,4399,4399,4357,4385,4384,8,7,1738,76206720,11438
2818,jd1809,20171025,4385,4384,4389,4390,4376,4387,4384,3,0,1038,45513160,11480
2819,jd1809,20171026,4387,4384,4392,4398,4380,4387,4390,3,6,1724,75686960,12322
2820,jd1809,20171027,4387,4390,4385,4389,4349,4363,4367,-27,-23,2878,125701140,12032
2821,jd1809,20171030,4363,4367,4368,4374,4314,4315,4341,-52,-26,2116,91870420,12024
2822,jd1809,20171031,4315,4341,4312,4320,4285,4302,4300,-39,-41,2938,126362500,12370
2823,jd1809,20171101,4302,4300,4310,4328,4297,4303,4310,3,10,2954,127335860,12880
2824,jd1809,20171102,4303,4310,4305,4308,4278,4297,4292,-13,-18,3104,133235180,13242
2825,jd1809,20171103,4297,4292,4297,4298,4271,4281,4279,-11,-13,3356,143635960,13932
2826,jd1809,20171106,4281,4279,4276,4315,4276,4296,4296,17,17,2034,87397660,14254
2827,jd1809,20171107,4296,4296,4296,4306,4286,4298,4294,2,-2,2296,98599360,14582
2828,jd1809,20171108,4298,4294,4295,4315,4244,4254,4274,-40,-20,6816,291346760,15994
2829,jd1809,20171109,4254,4274,4270,4270,4233,4253,4246,-21,-28,3512,149150200,15916
2830,jd1809,20171110,4253,4246,4246,4268,4238,4241,4247,-5,1,2576,109406400,15500
2831,jd1809,20171113,4241,4247,4244,4247,4225,4245,4236,-2,-11,3832,162326600,16034
2832,jd1809,20171114,4245,4236,4242,4247,4230,4233,4235,-3,-1,2558,108343060,16788
2833,jd1809,20171115,4233,4235,4215,4237,4211,4221,4224,-14,-11,3120,131791020,17308
2834,jd1809,20171116,4221,4224,4224,4257,4210,4255,4230,31,6,3664,155013560,17838
2835,jd1809,20171117,4255,4230,4250,4287,4239,4276,4264,46,34,5032,214611160,18172
2836,jd1809,20171120,4276,4264,4298,4301,4272,4281,4287,17,23,5946,254963380,17844
2837,jd1809,20171121,4281,4287,4289,4292,4274,4284,4281,-3,-6,2366,101304660,17920
2838,jd1809,20171122,4284,4281,4290,4297,4283,4295,4289,14,8,3058,131159420,18900
2839,jd1809,20171123,4295,4289,4303,4315,4284,4287,4297,-2,8,3178,136566400,19882
2840,jd1809,20171124,4287,4297,4290,4315,4285,4312,4296,15,-1,3952,169810060,21304
2841,jd1809,20171127,4312,4296,4300,4324,4297,4310,4314,14,18,4350,187662200,22050
2842,jd1809,20171128,4310,4314,4314,4319,4305,4315,4313,1,-1,2468,106445820,22896
2843,jd1809,20171129,4315,4313,4320,4364,4318,4360,4337,47,24,4952,214790340,24588
2844,jd1809,20171130,4360,4337,4365,4399,4360,4365,4378,28,41,9802,429211760,27032
2845,jd1809,20171201,4365,4378,4377,4385,4342,4354,4359,-24,-19,6238,271956180,29500
2846,jd1809,20171204,4354,4359,4350,4387,4337,4364,4363,5,4,5228,228149820,30920
2847,jd1809,20171205,4364,4363,4365,4390,4325,4346,4361,-17,-2,6782,295824320,31074
2848,jd1809,20171206,4346,4361,4340,4358,4315,4323,4338,-38,-23,7790,337944240,31748
2849,jd1809,20171207,4323,4338,4330,4345,4300,4301,4321,-37,-17,8140,351762300,32240
2850,jd1809,20171208,4301,4321,4310,4315,4269,4284,4288,-37,-33,6472,277553300,33998
2851,jd1809,20171211,4284,4288,4269,4277,4225,4231,4249,-57,-39,9170,389663080,35896
2852,jd1809,20171212,4231,4249,4226,4263,4226,4252,4247,3,-2,5184,220202820,36914
2853,jd1809,20171213,4252,4247,4240,4296,4233,4290,4268,43,21,9754,416382900,38574
2854,jd1809,20171214,4290,4268,4286,4300,4281,4294,4292,26,24,3914,167992480,38838
2855,jd1809,20171215,4294,4292,4296,4315,4260,4295,4291,3,-1,8316,356884920,40798
2856,jd1809,20171218,4295,4291,4300,4318,4270,4285,4295,-6,4,8750,375894200,43898
2857,jd1809,20171219,4285,4295,4290,4290,4251,4253,4262,-42,-33,6994,298118460,44024
2858,jd1809,20171220,4253,4262,4240,4252,4221,4232,4240,-30,-22,5750,243825400,45026
2859,jd1809,20171221,4232,4240,4225,4273,4208,4238,4239,-2,-1,9984,423293900,45240
2860,jd1809,20171222,4238,4239,4252,4258,4231,4240,4239,1,0,3552,150596460,44828
2861,jd1809,20171225,4240,4239,4250,4262,4221,4251,4239,12,0,6274,265983520,45860
2862,jd1809,20171226,4251,4239,4245,4250,4226,4232,4237,-7,-2,4544,192553820,45378
2863,jd1809,20171227,4232,4237,4234,4250,4227,4250,4240,13,3,3930,166634540,45964
2864,jd1809,20171228,4250,4240,4246,4265,4230,4248,4251,8,11,5838,248198200,46526
2865,jd1809,20171229,4248,4251,4249,4261,4231,4246,4243,-5,-8,6282,266590200,46076
2866,jd1810,20171027,4390,4390,4092,4092,4039,4039,4057,-351,-333,290,11768100,234
2867,jd1810,20171030,4039,4057,4040,4040,3925,3928,3957,-129,-100,438,17334500,504
2868,jd1810,20171031,3928,3957,3900,3915,3888,3888,3898,-69,-59,170,6628140,604
2869,jd1810,20171101,3888,3898,3901,3907,3877,3885,3894,-13,-4,270,10516180,792
2870,jd1810,20171102,3885,3894,3876,3885,3862,3882,3874,-12,-20,128,4959460,868
2871,jd1810,20171103,3882,3874,3884,3884,3857,3867,3865,-7,-9,112,4329060,874
2872,jd1810,20171106,3867,3865,3879,3879,3860,3870,3871,5,6,94,3639500,912
2873,jd1810,20171107,3870,3871,3879,3879,3863,3870,3869,-1,-2,110,4256980,938
2874,jd1810,20171108,3870,3869,3881,3883,3827,3827,3863,-42,-6,144,5562980,938
2875,jd1810,20171109,3827,3863,3839,3839,3799,3812,3806,-51,-57,278,10582700,1050
2876,jd1810,20171110,3812,3806,3800,3810,3786,3794,3797,-12,-9,468,17774400,1080
2877,jd1810,20171113,3794,3797,3795,3798,3776,3786,3784,-11,-13,254,9611700,1270
2878,jd1810,20171114,3786,3784,3781,3800,3774,3788,3785,4,1,534,20214660,1430
2879,jd1810,20171115,3788,3785,3790,3790,3770,3775,3781,-10,-4,64,2420420,1434
2880,jd1810,20171116,3775,3781,3775,3800,3770,3798,3778,17,-3,170,6423080,1426
2881,jd1810,20171117,3798,3778,3806,3827,3791,3818,3808,40,30,380,14474120,1614
2882,jd1810,20171120,3818,3808,3821,3845,3808,3826,3828,18,20,468,17915580,1834
2883,jd1810,20171121,3826,3828,3837,3837,3821,3829,3828,1,0,96,3675420,1856
2884,jd1810,20171122,3829,3828,3844,3859,3831,3846,3841,18,13,178,6837780,1932
2885,jd1810,20171123,3846,3841,3847,3858,3835,3840,3844,-1,3,376,14456120,2088
2886,jd1810,20171124,3840,3844,3851,3855,3829,3855,3843,11,-1,346,13299700,2230
2887,jd1810,20171127,3855,3843,3866,3867,3851,3863,3859,20,16,414,15977740,2310
2888,jd1810,20171128,3863,3859,3864,3876,3857,3857,3864,-2,5,94,3632880,2312
2889,jd1810,20171129,3857,3864,3860,3901,3856,3901,3882,37,18,400,15528400,2420
2890,jd1810,20171130,3901,3882,3902,3935,3894,3909,3918,27,36,634,24842800,2688
2891,jd1810,20171201,3909,3918,3925,3925,3885,3900,3898,-18,-20,328,12785640,2756
2892,jd1810,20171204,3900,3898,3891,3909,3881,3903,3895,5,-3,230,8960400,2840
2893,jd1810,20171205,3903,3895,3936,3936,3868,3898,3898,3,3,354,13798920,2830
2894,jd1810,20171206,3898,3898,3889,3895,3860,3863,3876,-35,-22,374,14497540,2756
2895,jd1810,20171207,3863,3876,3879,3897,3839,3846,3866,-30,-10,298,11521220,2602
2896,jd1810,20171208,3846,3866,3859,3859,3811,3827,3834,-39,-32,302,11580520,2608
2897,jd1810,20171211,3827,3834,3815,3815,3769,3777,3788,-57,-46,274,10379780,2654
2898,jd1810,20171212,3777,3788,3770,3802,3766,3802,3794,14,6,202,7664680,2636
2899,jd1810,20171213,3802,3794,3797,3845,3780,3836,3818,42,24,390,14893440,2752
2900,jd1810,20171214,3836,3818,3797,3849,3797,3845,3833,27,15,146,5597400,2752
2901,jd1810,20171215,3845,3833,3856,3869,3815,3850,3845,17,12,254,9766420,2682
2902,jd1810,20171218,3850,3845,3866,3875,3828,3850,3844,5,-1,458,17605640,2934
2903,jd1810,20171219,3850,3844,3831,3831,3810,3817,3819,-27,-25,288,10999260,2918
2904,jd1810,20171220,3817,3819,3806,3809,3795,3795,3803,-24,-16,176,6694760,2960
2905,jd1810,20171221,3795,3803,3795,3810,3780,3798,3798,-5,-5,216,8205640,2980
2906,jd1810,20171222,3798,3798,3807,3808,3786,3798,3801,0,3,98,3725040,2936
2907,jd1810,20171225,3798,3801,3807,3817,3782,3817,3798,16,-3,140,5317760,2944
2908,jd1810,20171226,3817,3798,3802,3813,3798,3809,3804,11,6,372,14151640,2778
2909,jd1810,20171227,3809,3804,3800,3819,3800,3807,3807,3,3,92,3503260,2776
2910,jd1810,20171228,3807,3807,3814,3827,3795,3825,3818,18,11,224,8552640,2816
2911,jd1810,20171229,3825,3818,3822,3822,3803,3816,3814,-2,-4,204,7782060,2770
2912,jd1811,20171128,3859,3859,3844,3844,3801,3818,3821,-41,-38,80,3057240,62
2913,jd1811,20171129,3818,3821,3818,3848,3818,3840,3830,19,9,78,2987620,116
2914,jd1811,20171130,3840,3830,3844,3855,3830,3833,3838,3,8,102,3914960,174
2915,jd1811,20171201,3833,3838,3820,3825,3812,3820,3817,-18,-21,76,2901600,214
2916,jd1811,20171204,3820,3817,3846,3846,3820,3824,3827,7,10,74,2832080,254
2917,jd1811,20171205,3824,3827,3831,3835,3802,3818,3820,-9,-7,90,3438300,286
2918,jd1811,20171206,3818,3820,3803,3818,3803,3806,3809,-14,-11,8,304720,286
2919,jd1811,20171207,3806,3809,3807,3816,3796,3802,3810,-7,1,70,2667020,276
2920,jd1811,20171208,3802,3810,3802,3808,3775,3785,3791,-25,-19,142,5384440,284
2921,jd1811,20171211,3785,3791,3786,3789,3741,3741,3756,-50,-35,110,4132680,296
2922,jd1811,20171212,3741,3756,3761,3762,3754,3759,3757,3,1,46,1728560,302
2923,jd1811,20171213,3759,3757,3765,3805,3713,3805,3776,48,19,96,3625500,270
2924,jd1811,20171214,3805,3776,3781,3836,3781,3804,3801,28,25,82,3117160,310
2925,jd1811,20171215,3804,3801,3832,3833,3785,3810,3809,9,8,60,2285880,312
2926,jd1811,20171218,3810,3809,3800,3812,3785,3805,3802,-4,-7,58,2205460,320
2927,jd1811,20171219,3805,3802,3786,3787,3775,3778,3779,-24,-23,52,1965500,336
2928,jd1811,20171220,3778,3779,3770,3780,3755,3763,3767,-16,-12,38,1431760,344
2929,jd1811,20171221,3763,3767,3770,3774,3755,3768,3764,1,-3,64,2409560,366
2930,jd1811,20171222,3768,3764,3764,3773,3758,3769,3763,5,-1,46,1731020,382
2931,jd1811,20171225,3769,3763,3770,3789,3756,3769,3763,6,0,80,3010780,406
2932,jd1811,20171226,3769,3763,3760,3763,3753,3755,3757,-8,-6,66,2479620,418
2933,jd1811,20171227,3755,3757,3769,3769,3754,3768,3760,11,3,34,1278700,420
2934,jd1811,20171228,3768,3760,3761,3775,3759,3771,3767,11,7,46,1733240,406
2935,jd1811,20171229,3771,3767,3764,3789,3756,3779,3769,12,2,106,3995820,360
2936,jd1812,20171227,3757,3757,3780,3834,3780,3800,3798,43,41,56,2127060,34
2937,jd1812,20171228,3800,3798,3805,3813,3788,3809,3803,11,5,44,1673400,62
2938,jd1812,20171229,3809,3803,3796,3816,3796,3816,3804,13,1,44,1673880,94
