   ,合约,日期,前收盘价,前结算价,开盘价,最高价,最低价,收盘价,结算价,涨跌1,涨跌2,成交量,成交金额,持仓量
1,j1109,20110415,0,2180,2300,2300,2225,2247,2255,67,75,57134,12887467600,6404
2,j1109,20110418,2247,2255,2233,2388,2233,2381,2344,126,89,132702,31109082200,19488
3,j1109,20110419,2381,2344,2375,2384,2320,2336,2344,-8,0,204462,47943881000,23270
4,j1109,20110420,2336,2344,2350,2395,2328,2343,2352,-1,8,175506,41284932200,23484
5,j1109,20110421,2343,2352,2353,2363,2323,2335,2346,-17,-6,97576,22891350000,22246
6,j1109,20110422,2335,2346,2336,2351,2297,2330,2319,-16,-27,128218,29736098800,18880
7,j1109,20110425,2330,2319,2340,2359,2317,2329,2334,10,15,64954,15165091400,18038
8,j1109,20110426,2329,2334,2315,2329,2303,2322,2316,-12,-18,44336,10269163200,17852
9,j1109,20110427,2322,2316,2332,2339,2315,2320,2327,4,11,32038,7455898800,16356
10,j1109,20110428,2320,2327,2330,2347,2326,2337,2335,10,8,26286,6139532200,14190
11,j1109,20110429,2337,2335,2337,2343,2323,2329,2332,-6,-3,17654,4117706400,11762
12,j1109,20110503,2329,2332,2330,2354,2326,2344,2342,12,10,26594,6230842000,12876
13,j1109,20110504,2344,2342,2341,2346,2320,2329,2331,-13,-11,14518,3385485800,10782
14,j1109,20110505,2329,2331,2309,2319,2293,2308,2308,-23,-23,13896,3207532000,10736
15,j1109,20110506,2308,2308,2255,2289,2255,2271,2274,-37,-34,14736,3351935000,10206
16,j1109,20110509,2271,2274,2280,2284,2273,2280,2278,6,4,7240,1649553600,9292
17,j1109,20110510,2280,2278,2285,2288,2275,2287,2281,9,3,7890,1800361000,8290
18,j1109,20110511,2287,2281,2293,2338,2286,2314,2321,33,40,30078,6983378000,9430
19,j1109,20110512,2314,2321,2290,2352,2288,2344,2333,23,12,61826,14430103200,17712
20,j1109,20110513,2344,2333,2360,2444,2353,2419,2411,86,78,134808,32505755000,26414
21,j1109,20110516,2419,2411,2415,2423,2396,2407,2410,-4,-1,57056,13753587200,25800
22,j1109,20110517,2407,2410,2414,2417,2371,2391,2392,-19,-18,57660,13793401600,21764
23,j1109,20110518,2391,2392,2400,2423,2370,2372,2396,-20,4,70386,16868029000,21830
24,j1109,20110519,2372,2396,2394,2394,2363,2367,2374,-29,-22,47602,11302192400,18316
25,j1109,20110520,2367,2374,2364,2392,2362,2376,2377,2,3,37048,8809309000,18196
26,j1109,20110523,2376,2377,2388,2389,2350,2357,2363,-20,-14,18982,4485878200,17736
27,j1109,20110524,2357,2363,2356,2380,2345,2380,2371,17,8,30504,7234447200,20964
28,j1109,20110525,2380,2371,2382,2385,2366,2375,2373,4,2,18206,4320948000,18796
29,j1109,20110526,2375,2373,2385,2398,2377,2378,2387,5,14,19554,4669179600,19388
30,j1109,20110527,2378,2387,2379,2380,2351,2371,2362,-16,-25,21708,5128421800,18558
31,j1109,20110530,2371,2362,2370,2382,2360,2365,2371,3,9,16418,3893057000,17792
32,j1109,20110531,2365,2371,2370,2378,2361,2364,2371,-7,0,15208,3605924600,15882
33,j1109,20110601,2364,2371,2370,2375,2357,2359,2364,-12,-7,13608,3217637000,15718
34,j1109,20110602,2359,2364,2351,2363,2337,2339,2348,-25,-16,18632,4376358200,15418
35,j1109,20110603,2339,2348,2340,2344,2320,2326,2330,-22,-18,16864,3930557200,15508
36,j1109,20110607,2326,2330,2321,2341,2312,2331,2331,1,1,15600,3637384800,14872
37,j1109,20110608,2331,2331,2338,2338,2320,2326,2327,-5,-4,7924,1844468000,14088
38,j1109,20110609,2326,2327,2330,2333,2318,2318,2326,-9,-1,8022,1865987600,14184
39,j1109,20110610,2318,2326,2324,2324,2306,2311,2314,-15,-12,12900,2986102600,15946
40,j1109,20110613,2311,2314,2306,2321,2295,2320,2311,6,-3,9360,2163965800,17520
41,j1109,20110614,2320,2311,2313,2353,2313,2334,2334,23,23,42350,9887837200,15432
42,j1109,20110615,2334,2334,2339,2342,2321,2323,2330,-11,-4,9736,2268762400,14966
43,j1109,20110616,2323,2330,2315,2321,2299,2307,2310,-23,-20,9420,2176301400,14454
44,j1109,20110617,2307,2310,2310,2320,2304,2307,2310,-3,0,6440,1487787000,14474
45,j1109,20110620,2307,2310,2306,2310,2280,2281,2293,-29,-17,8336,1911622400,15056
46,j1109,20110621,2281,2293,2288,2300,2270,2295,2282,2,-11,10346,2361110800,14996
47,j1109,20110622,2295,2282,2290,2296,2283,2288,2289,6,7,6136,1404766000,14434
48,j1109,20110623,2288,2289,2287,2322,2280,2318,2309,29,20,23256,5370499600,15954
49,j1109,20110624,2318,2309,2318,2323,2300,2302,2308,-7,-1,13368,3086205800,14442
50,j1109,20110627,2302,2308,2296,2318,2291,2308,2306,0,-2,12430,2866609200,14432
51,j1109,20110628,2308,2306,2316,2338,2302,2303,2319,-3,13,18786,4357065800,15274
52,j1109,20110629,2303,2319,2310,2313,2288,2296,2298,-23,-21,10906,2506516000,15078
53,j1109,20110630,2296,2298,2299,2312,2296,2309,2306,11,8,11084,2556744800,14546
54,j1109,20110701,2309,2306,2308,2317,2295,2296,2306,-10,0,7398,1706469800,14530
55,j1109,20110704,2296,2306,2299,2325,2293,2316,2312,10,6,15622,3611928600,15352
56,j1109,20110705,2316,2312,2317,2322,2306,2315,2313,3,1,9450,2186640800,15922
57,j1109,20110706,2315,2313,2321,2345,2316,2342,2334,29,21,22492,5251116800,18846
58,j1109,20110707,2342,2334,2340,2348,2307,2311,2325,-23,-9,19208,4466265800,15390
59,j1109,20110708,2311,2325,2316,2322,2302,2307,2312,-18,-13,12320,2849001200,14696
60,j1109,20110711,2307,2312,2303,2316,2302,2304,2308,-8,-4,6404,1478653200,13954
61,j1109,20110712,2304,2308,2306,2315,2290,2297,2299,-11,-9,7230,1662832800,13448
62,j1109,20110713,2297,2299,2304,2313,2300,2310,2308,11,9,5688,1313190400,12648
63,j1109,20110714,2310,2308,2316,2316,2297,2305,2305,-3,-3,6374,1469227600,12444
64,j1109,20110715,2305,2305,2303,2309,2298,2303,2304,-2,-1,3296,759670200,11752
65,j1109,20110718,2303,2304,2307,2314,2303,2305,2308,1,4,5970,1378399200,11822
66,j1109,20110719,2305,2308,2306,2310,2302,2305,2304,-3,-4,2810,647629200,11162
67,j1109,20110720,2305,2304,2308,2314,2296,2298,2304,-6,0,6294,1450375800,11772
68,j1109,20110721,2298,2304,2300,2300,2283,2286,2289,-18,-15,6128,1403145800,12006
69,j1109,20110722,2286,2289,2279,2293,2276,2286,2287,-3,-2,3014,689506800,11562
70,j1109,20110725,2286,2287,2285,2298,2282,2286,2288,-1,1,4536,1038264200,10992
71,j1109,20110726,2286,2288,2290,2293,2280,2289,2286,1,-2,2430,555666200,10314
72,j1109,20110727,2289,2286,2293,2293,2283,2284,2286,-2,0,2342,535398000,10060
73,j1109,20110728,2284,2286,2283,2294,2280,2285,2287,-1,1,4140,947095000,9164
74,j1109,20110729,2285,2287,2288,2291,2284,2285,2286,-2,-1,2262,517284000,8752
75,j1109,20110801,2285,2286,2287,2288,2282,2285,2285,-1,-1,1748,399463400,8350
76,j1109,20110802,2285,2285,2285,2287,2282,2285,2284,0,-1,1478,337714600,7802
77,j1109,20110803,2285,2284,2286,2288,2283,2285,2284,1,0,1316,300690200,7226
78,j1109,20110804,2285,2284,2285,2305,2282,2303,2291,19,7,2604,596745200,6926
79,j1109,20110805,2303,2291,2295,2312,2285,2297,2295,6,4,8058,1850090600,6166
80,j1109,20110808,2297,2295,2290,2290,2266,2270,2275,-25,-20,3502,796883200,4490
81,j1109,20110809,2270,2275,2260,2260,2180,2229,2216,-46,-59,2930,649338400,3224
82,j1109,20110810,2229,2216,2240,2250,2231,2234,2239,18,23,742,166198200,3220
83,j1109,20110811,2234,2239,2214,2236,2214,2229,2226,-10,-13,668,148708000,3078
84,j1109,20110812,2229,2226,2244,2244,2220,2225,2231,-1,5,610,136108400,2948
85,j1109,20110815,2225,2231,2226,2229,2193,2197,2208,-34,-23,1410,311441000,3010
86,j1109,20110816,2197,2208,2197,2197,2162,2167,2178,-41,-30,1472,320693800,3030
87,j1109,20110817,2167,2178,2159,2175,2149,2156,2162,-22,-16,1804,390122200,2890
88,j1109,20110818,2156,2162,2156,2162,2131,2139,2146,-23,-16,1410,302643200,2774
89,j1109,20110819,2139,2146,2131,2131,2106,2108,2115,-38,-31,912,192927000,2534
90,j1109,20110822,2108,2115,2101,2110,2055,2057,2078,-58,-37,1446,300487400,2136
91,j1109,20110823,2057,2078,2047,2050,1980,1991,2002,-87,-76,1842,368946400,1986
92,j1109,20110824,1991,2002,1988,2010,1988,2009,2001,7,-1,604,120901000,1778
93,j1109,20110825,2009,2001,2009,2032,2003,2015,2017,14,16,328,66167600,1662
94,j1109,20110826,2015,2017,2017,2028,2014,2026,2023,9,6,522,105614400,1510
95,j1109,20110829,2026,2023,2037,2037,2003,2008,2010,-15,-13,164,32978000,1466
96,j1109,20110830,2008,2010,2005,2019,2003,2010,2008,0,-2,298,59858000,1358
97,j1109,20110831,2010,2008,2011,2039,2006,2014,2014,6,6,550,110789000,1340
98,j1109,20110901,2014,2014,2014,2040,2005,2040,2035,26,21,272,55363400,1356
99,j1109,20110902,2040,2035,0,0,0,2035,2035,0,0,0,0,1356
100,j1109,20110905,2035,2035,2020,2020,2020,2020,2020,-15,-15,22,4444000,1336
101,j1109,20110906,2020,2020,2025,2025,2022,2022,2023,2,3,44,8902800,1336
102,j1109,20110907,2022,2023,2030,2030,2030,2030,2030,7,7,136,27608000,1200
103,j1109,20110908,2030,2030,2021,2021,2021,2021,2021,-9,-9,60,12126000,1140
104,j1109,20110909,2021,2021,0,0,0,2021,2021,0,0,0,0,1140
105,j1109,20110913,2021,2021,0,0,0,2021,2021,0,0,0,0,1140
106,j1109,20110914,2021,2021,2000,2000,2000,2000,2000,-21,-21,40,8000000,1100
107,j1109,20110915,2000,2000,1980,1980,1980,1980,2027,-20,27,20,3960000,0
108,j1110,20110418,2275,2279,2275,2413,2257,2392,2341,113,62,56,13114400,38
109,j1110,20110419,2392,2341,2393,2393,2298,2342,2358,1,17,188,44339800,72
110,j1110,20110420,2342,2358,2378,2381,2347,2348,2364,-10,6,108,25539400,94
111,j1110,20110421,2348,2364,2369,2370,2333,2342,2340,-22,-24,114,26685000,102
112,j1110,20110422,2342,2340,2352,2352,2313,2324,2321,-16,-19,196,45498000,174
113,j1110,20110425,2324,2321,2323,2339,2319,2331,2327,10,6,58,13499200,182
114,j1110,20110426,2331,2327,2322,2322,2300,2316,2308,-11,-19,138,31854200,210
115,j1110,20110427,2316,2308,2331,2331,2317,2317,2322,9,14,12,2787000,208
116,j1110,20110428,2317,2322,2324,2340,2324,2331,2331,9,9,26,6062600,208
117,j1110,20110429,2331,2331,2326,2333,2312,2322,2319,-9,-12,72,16700600,208
118,j1110,20110503,2322,2319,2326,2346,2323,2340,2334,21,15,56,13073800,212
119,j1110,20110504,2340,2334,2329,2331,2311,2322,2320,-12,-14,72,16705600,220
120,j1110,20110505,2322,2320,2296,2307,2291,2303,2298,-17,-22,42,9654000,206
121,j1110,20110506,2303,2298,2256,2277,2256,2270,2267,-28,-31,62,14060200,190
122,j1110,20110509,2270,2267,2263,2273,2263,2270,2267,3,0,10,2267400,190
123,j1110,20110510,2270,2267,2271,2275,2268,2272,2271,5,4,14,3180400,190
124,j1110,20110511,2272,2271,2280,2328,2280,2303,2311,32,40,60,13869400,208
125,j1110,20110512,2303,2311,2286,2337,2286,2330,2321,19,10,120,27861800,236
126,j1110,20110513,2330,2321,2339,2418,2339,2403,2386,82,65,172,41041400,258
127,j1110,20110516,2403,2386,2386,2411,2386,2394,2396,8,10,18,4313600,262
128,j1110,20110517,2394,2396,2388,2388,2364,2376,2377,-20,-19,80,19019600,274
129,j1110,20110518,2376,2377,2388,2408,2359,2363,2373,-14,-4,84,19936000,288
130,j1110,20110519,2363,2373,2361,2367,2351,2362,2358,-11,-15,80,18866400,284
131,j1110,20110520,2362,2358,2374,2374,2352,2357,2357,-1,-1,18,4243600,292
132,j1110,20110523,2357,2357,2350,2353,2343,2353,2351,-4,-6,46,10816200,270
133,j1110,20110524,2353,2351,2355,2360,2355,2360,2358,9,7,6,1415000,264
134,j1110,20110525,2360,2358,2366,2371,2358,2358,2364,0,6,16,3782800,266
135,j1110,20110526,2358,2364,2372,2375,2372,2372,2373,8,9,26,6172200,262
136,j1110,20110527,2372,2373,2361,2361,2342,2352,2354,-21,-19,26,6120400,258
137,j1110,20110530,2352,2354,2361,2368,2345,2346,2352,-8,-2,52,12233800,260
138,j1110,20110531,2346,2352,2358,2365,2352,2359,2358,7,6,28,6603600,262
139,j1110,20110601,2359,2358,2350,2359,2342,2350,2349,-8,-9,68,15977000,256
140,j1110,20110602,2350,2349,2337,2350,2326,2335,2340,-14,-9,68,15913000,260
141,j1110,20110603,2335,2340,2333,2334,2308,2319,2318,-21,-22,174,40345200,242
142,j1110,20110607,2319,2318,2306,2321,2215,2315,2302,-3,-16,36,8288000,248
143,j1110,20110608,2315,2302,2311,2311,2290,2304,2302,2,0,266,61239400,382
144,j1110,20110609,2304,2302,2305,2309,2293,2299,2302,-3,0,118,27168200,368
145,j1110,20110610,2299,2302,2300,2308,2290,2302,2299,0,-3,146,33569800,290
146,j1110,20110613,2302,2299,2300,2309,2294,2303,2300,4,1,34,7821000,288
147,j1110,20110614,2303,2300,2325,2330,2310,2318,2319,18,19,68,15773400,298
148,j1110,20110615,2318,2319,2456,2456,2314,2317,2323,-2,4,74,17195000,250
149,j1110,20110616,2317,2323,2299,2314,2299,2307,2307,-16,-16,108,24917400,244
150,j1110,20110617,2307,2307,2315,2315,2300,2308,2307,1,0,90,20771400,214
151,j1110,20110620,2308,2307,2307,2307,2292,2299,2298,-8,-9,158,36312600,144
152,j1110,20110621,2299,2298,2295,2308,2289,2308,2297,10,-1,20,4594400,136
153,j1110,20110622,2308,2297,2309,2309,2302,2309,2305,12,8,26,5994200,130
154,j1110,20110623,2309,2305,2302,2320,2302,2320,2313,15,8,48,11105800,126
155,j1110,20110624,2320,2313,2315,2315,2307,2312,2311,-1,-2,24,5547800,126
156,j1110,20110627,2312,2311,2312,2312,2301,2302,2305,-9,-6,32,7377000,122
157,j1110,20110628,2302,2305,2322,2328,2307,2307,2314,2,9,20,4629400,120
158,j1110,20110629,2307,2314,2306,2310,2301,2304,2306,-10,-8,36,8303800,118
159,j1110,20110630,2304,2306,2310,2320,2308,2316,2312,10,6,16,3700600,118
160,j1110,20110701,2316,2312,2319,2319,2310,2311,2312,-1,0,18,4163000,116
161,j1110,20110704,2311,2312,2321,2330,2321,2329,2324,17,12,12,2789800,112
162,j1110,20110705,2329,2324,0,0,0,2324,2324,0,0,0,0,112
163,j1110,20110706,2324,2324,2348,2353,2340,2353,2347,29,23,20,4694600,106
164,j1110,20110707,2353,2347,2354,2354,2335,2335,2344,-12,-3,20,4688000,108
165,j1110,20110708,2335,2344,2341,2347,2341,2341,2343,-3,-1,12,2812600,112
166,j1110,20110711,2341,2343,2332,2352,2332,2334,2342,-9,-1,16,3747400,110
167,j1110,20110712,2334,2342,2338,2338,2322,2322,2325,-20,-17,18,4185800,112
168,j1110,20110713,2322,2325,2325,2336,2325,2336,2329,11,4,6,1397400,112
169,j1110,20110714,2336,2329,2327,2336,2326,2326,2328,-3,-1,8,1863000,108
170,j1110,20110715,2326,2328,2326,2337,2315,2315,2327,-13,-1,10,2327400,110
171,j1110,20110718,2315,2327,2328,2335,2328,2335,2332,8,5,8,1865600,106
172,j1110,20110719,2335,2332,2335,2337,2335,2336,2335,4,3,16,3737400,106
173,j1110,20110720,2336,2335,2337,2342,2330,2334,2335,-1,0,16,3736000,104
174,j1110,20110721,2334,2335,2315,2315,2309,2309,2313,-26,-22,6,1387800,100
175,j1110,20110722,2309,2313,0,0,0,2313,2313,0,0,0,0,100
176,j1110,20110725,2313,2313,0,0,0,2313,2313,0,0,0,0,100
177,j1110,20110726,2313,2313,2326,2326,2325,2325,2325,12,12,4,930200,100
178,j1110,20110727,2325,2325,2331,2331,2320,2320,2323,-5,-2,6,1394200,98
179,j1110,20110728,2320,2323,2315,2324,2315,2324,2318,1,-5,6,1390800,96
180,j1110,20110729,2324,2318,2310,2317,2297,2304,2305,-14,-13,30,6917600,100
181,j1110,20110801,2304,2305,2310,2311,2310,2311,2310,6,5,4,924200,98
182,j1110,20110802,2311,2310,2303,2303,2303,2303,2303,-7,-7,2,460600,98
183,j1110,20110803,2303,2303,2302,2312,2302,2302,2306,-1,3,18,4151600,98
184,j1110,20110804,2302,2306,2301,2312,2301,2312,2306,6,0,8,1845400,98
185,j1110,20110805,2312,2306,2330,2383,2278,2306,2305,0,-1,38,8761600,94
186,j1110,20110808,2306,2305,2305,2305,2287,2299,2297,-6,-8,28,6432400,80
187,j1110,20110809,2299,2297,2259,2263,2251,2251,2256,-46,-41,36,8123200,88
188,j1110,20110810,2251,2256,2251,2295,2251,2292,2286,36,30,94,21489000,78
189,j1110,20110811,2292,2286,2283,2291,2281,2291,2284,5,-2,16,3654800,78
190,j1110,20110812,2291,2284,2293,2293,2283,2283,2288,-1,4,10,2288400,76
191,j1110,20110815,2283,2288,2279,2279,2251,2251,2263,-37,-25,16,3620800,82
192,j1110,20110816,2251,2263,2235,2239,2231,2231,2237,-32,-26,16,3579400,78
193,j1110,20110817,2231,2237,2259,2259,2219,2219,2229,-18,-8,16,3566800,82
194,j1110,20110818,2219,2229,2208,2222,2199,2199,2215,-30,-14,24,5316400,90
195,j1110,20110819,2199,2215,2139,2209,2139,2180,2171,-35,-44,12,2605800,92
196,j1110,20110822,2180,2171,2135,2180,2120,2130,2140,-41,-31,28,5993000,94
197,j1110,20110823,2130,2140,2106,2120,2052,2059,2071,-81,-69,72,14915600,106
198,j1110,20110824,2059,2071,2066,2079,2057,2071,2066,0,-5,68,14051000,104
199,j1110,20110825,2071,2066,2062,2083,2062,2074,2073,8,7,10,2073400,104
200,j1110,20110826,2074,2073,2165,2165,2074,2084,2089,11,16,50,10446600,114
201,j1110,20110829,2084,2089,2061,2079,2061,2072,2073,-17,-16,34,7051400,108
202,j1110,20110830,2072,2073,2075,2075,2075,2075,2075,2,2,8,1660000,104
203,j1110,20110831,2075,2075,2109,2109,2066,2072,2085,-3,10,124,25862000,190
204,j1110,20110901,2072,2085,2061,2083,2061,2083,2073,-2,-12,96,19903200,182
205,j1110,20110902,2083,2073,2117,2117,2060,2065,2064,-8,-9,58,11976600,166
206,j1110,20110905,2065,2064,2067,2067,2063,2065,2065,1,1,6,1239000,166
207,j1110,20110906,2065,2065,2065,2084,2065,2065,2076,0,11,10,2076400,170
208,j1110,20110907,2065,2076,2083,2083,2083,2083,2083,7,7,4,833200,166
209,j1110,20110908,2083,2083,2067,2070,2056,2056,2066,-27,-17,14,2892600,166
210,j1110,20110909,2056,2066,2056,2059,2050,2059,2055,-7,-11,12,2466800,166
211,j1110,20110913,2059,2055,2011,2044,2011,2044,2032,-11,-23,6,1219600,168
212,j1110,20110914,2044,2032,2038,2045,2028,2040,2038,8,6,22,4484400,166
213,j1110,20110915,2040,2038,2050,2050,2039,2039,2046,1,8,6,1227800,160
214,j1110,20110916,2039,2046,2046,2050,2040,2050,2042,4,-4,16,3267800,158
215,j1110,20110919,2050,2042,2022,2037,2022,2028,2027,-14,-15,30,6083800,138
216,j1110,20110920,2028,2027,2025,2033,2022,2023,2025,-4,-2,56,11341400,82
217,j1110,20110921,2023,2025,2050,2050,2050,2050,2050,25,25,2,410000,82
218,j1110,20110922,2050,2050,2006,2028,2006,2017,2014,-33,-36,22,4432000,62
219,j1110,20110923,2017,2014,1996,1996,1989,1989,1991,-25,-23,18,3583800,44
220,j1110,20110926,1989,1991,1960,1960,1910,1910,1935,-81,-56,4,774000,42
221,j1110,20110927,1910,1935,0,0,0,1935,1935,0,0,0,0,42
222,j1110,20110928,1935,1935,1930,1930,1930,1930,1930,-5,-5,2,386000,40
223,j1110,20110929,1930,1930,1834,1834,1834,1834,1834,-96,-96,8,1467200,40
224,j1110,20110930,1834,1834,1706,1880,1706,1750,1744,-84,-90,28,4885400,40
225,j1110,20111010,1750,1744,1866,1866,1866,1866,1866,122,122,2,373200,40
226,j1110,20111011,1866,1866,0,0,0,1866,1866,0,0,0,0,40
227,j1110,20111012,1866,1866,1970,1970,1970,1970,1970,104,104,2,394000,40
228,j1110,20111013,1970,1970,1852,1852,1852,1852,1852,-118,-118,20,3704000,40
229,j1110,20111014,1852,1852,0,0,0,1852,1852,0,0,0,0,40
230,j1110,20111017,1852,1852,0,0,0,1852,1852,0,0,0,0,40
231,j1110,20111018,1852,1852,0,0,0,1852,1852,0,0,0,0,40
232,j1110,20111019,1852,1852,0,0,0,1852,1852,0,0,0,0,40
233,j1110,20111020,1852,1852,0,0,0,1852,1852,0,0,0,0,40
234,j1110,20111021,1852,1852,0,0,0,1852,1863,0,11,0,0,0
235,j1111,20110418,2276,2298,2323,2420,2323,2420,2369,122,71,8,1895400,24
236,j1111,20110419,2420,2369,2381,2412,2381,2412,2389,43,20,6,1433400,24
237,j1111,20110420,2412,2389,2412,2412,2381,2381,2396,-8,7,12,2876200,26
238,j1111,20110421,2381,2396,2382,2382,2382,2382,2382,-14,-14,4,952800,22
239,j1111,20110422,2382,2382,2346,2353,2346,2353,2349,-29,-33,4,939800,22
240,j1111,20110425,2353,2349,0,0,0,2349,2349,0,0,0,0,22
241,j1111,20110426,2349,2349,2350,2350,2338,2347,2344,-2,-5,10,2344600,24
242,j1111,20110427,2347,2344,2370,2381,2370,2381,2375,37,31,4,950200,22
243,j1111,20110428,2381,2375,0,0,0,2375,2375,0,0,0,0,22
244,j1111,20110429,2375,2375,0,0,0,2375,2375,0,0,0,0,22
245,j1111,20110503,2375,2375,0,0,0,2375,2375,0,0,0,0,22
246,j1111,20110504,2375,2375,2360,2360,2352,2352,2356,-23,-19,4,942400,24
247,j1111,20110505,2352,2356,0,0,0,2356,2356,0,0,0,0,24
248,j1111,20110506,2356,2356,2319,2319,2319,2319,2319,-37,-37,2,463800,22
249,j1111,20110509,2319,2319,0,0,0,2319,2319,0,0,0,0,22
250,j1111,20110510,2319,2319,0,0,0,2319,2319,0,0,0,0,22
251,j1111,20110511,2319,2319,2337,2347,2337,2344,2343,25,24,10,2343400,22
252,j1111,20110512,2344,2343,2308,2350,2308,2350,2333,7,-10,6,1400200,26
253,j1111,20110513,2350,2333,2381,2381,2381,2381,2381,48,48,2,476200,26
254,j1111,20110516,2381,2381,2396,2396,2396,2396,2396,15,15,2,479200,26
255,j1111,20110517,2396,2396,0,0,0,2396,2396,0,0,0,0,26
256,j1111,20110518,2396,2396,0,0,0,2396,2396,0,0,0,0,26
257,j1111,20110519,2396,2396,2370,2370,2351,2351,2360,-45,-36,4,944200,28
258,j1111,20110520,2351,2360,0,0,0,2360,2360,0,0,0,0,28
259,j1111,20110523,2360,2360,0,0,0,2360,2360,0,0,0,0,28
260,j1111,20110524,2360,2360,0,0,0,2360,2360,0,0,0,0,28
261,j1111,20110525,2360,2360,0,0,0,2360,2360,0,0,0,0,28
262,j1111,20110526,2360,2360,0,0,0,2360,2360,0,0,0,0,28
263,j1111,20110527,2360,2360,0,0,0,2360,2360,0,0,0,0,28
264,j1111,20110530,2360,2360,0,0,0,2360,2360,0,0,0,0,28
265,j1111,20110531,2360,2360,0,0,0,2360,2360,0,0,0,0,28
266,j1111,20110601,2360,2360,2358,2358,2358,2358,2358,-2,-2,2,471600,28
267,j1111,20110602,2358,2358,2336,2347,2334,2347,2338,-11,-20,8,1870400,22
268,j1111,20110603,2347,2338,2332,2337,2332,2337,2335,-1,-3,6,1401200,20
269,j1111,20110607,2337,2335,0,0,0,2335,2335,0,0,0,0,20
270,j1111,20110608,2335,2335,0,0,0,2335,2335,0,0,0,0,20
271,j1111,20110609,2335,2335,2353,2353,2344,2347,2349,12,14,8,1879400,18
272,j1111,20110610,2347,2349,0,0,0,2349,2349,0,0,0,0,18
273,j1111,20110613,2349,2349,0,0,0,2349,2349,0,0,0,0,18
274,j1111,20110614,2349,2349,2365,2365,2365,2365,2365,16,16,2,473000,16
275,j1111,20110615,2365,2365,0,0,0,2365,2365,0,0,0,0,16
276,j1111,20110616,2365,2365,2348,2348,2348,2348,2348,-17,-17,2,469600,16
277,j1111,20110617,2348,2348,0,0,0,2348,2348,0,0,0,0,16
278,j1111,20110620,2348,2348,0,0,0,2348,2348,0,0,0,0,16
279,j1111,20110621,2348,2348,0,0,0,2348,2348,0,0,0,0,16
280,j1111,20110622,2348,2348,0,0,0,2348,2348,0,0,0,0,16
281,j1111,20110623,2348,2348,2339,2339,2339,2339,2339,-9,-9,4,935600,14
282,j1111,20110624,2339,2339,2345,2345,2345,2345,2345,6,6,2,469000,14
283,j1111,20110627,2345,2345,0,0,0,2345,2345,0,0,0,0,14
284,j1111,20110628,2345,2345,0,0,0,2345,2345,0,0,0,0,14
285,j1111,20110629,2345,2345,0,0,0,2345,2345,0,0,0,0,14
286,j1111,20110630,2345,2345,0,0,0,2345,2345,0,0,0,0,14
287,j1111,20110701,2345,2345,0,0,0,2345,2345,0,0,0,0,14
288,j1111,20110704,2345,2345,0,0,0,2345,2345,0,0,0,0,14
289,j1111,20110705,2345,2345,0,0,0,2345,2345,0,0,0,0,14
290,j1111,20110706,2345,2345,0,0,0,2345,2345,0,0,0,0,14
291,j1111,20110707,2345,2345,0,0,0,2345,2345,0,0,0,0,14
292,j1111,20110708,2345,2345,0,0,0,2345,2345,0,0,0,0,14
293,j1111,20110711,2345,2345,0,0,0,2345,2345,0,0,0,0,14
294,j1111,20110712,2345,2345,0,0,0,2345,2345,0,0,0,0,14
295,j1111,20110713,2345,2345,2347,2382,2346,2382,2361,37,16,8,1889000,14
296,j1111,20110714,2382,2361,0,0,0,2361,2361,0,0,0,0,14
297,j1111,20110715,2361,2361,0,0,0,2361,2361,0,0,0,0,14
298,j1111,20110718,2361,2361,0,0,0,2361,2361,0,0,0,0,14
299,j1111,20110719,2361,2361,0,0,0,2361,2361,0,0,0,0,14
300,j1111,20110720,2361,2361,0,0,0,2361,2361,0,0,0,0,14
301,j1111,20110721,2361,2361,0,0,0,2361,2361,0,0,0,0,14
302,j1111,20110722,2361,2361,0,0,0,2361,2361,0,0,0,0,14
303,j1111,20110725,2361,2361,0,0,0,2361,2361,0,0,0,0,14
304,j1111,20110726,2361,2361,0,0,0,2361,2361,0,0,0,0,14
305,j1111,20110727,2361,2361,0,0,0,2361,2361,0,0,0,0,14
306,j1111,20110728,2361,2361,0,0,0,2361,2361,0,0,0,0,14
307,j1111,20110729,2361,2361,0,0,0,2361,2361,0,0,0,0,14
308,j1111,20110801,2361,2361,0,0,0,2361,2361,0,0,0,0,14
309,j1111,20110802,2361,2361,0,0,0,2361,2361,0,0,0,0,14
310,j1111,20110803,2361,2361,0,0,0,2361,2361,0,0,0,0,14
311,j1111,20110804,2361,2361,0,0,0,2361,2361,0,0,0,0,14
312,j1111,20110805,2361,2361,0,0,0,2361,2361,0,0,0,0,14
313,j1111,20110808,2361,2361,0,0,0,2361,2361,0,0,0,0,14
314,j1111,20110809,2361,2361,2294,2294,2294,2294,2294,-67,-67,2,458800,14
315,j1111,20110810,2294,2294,0,0,0,2294,2294,0,0,0,0,14
316,j1111,20110811,2294,2294,0,0,0,2294,2294,0,0,0,0,14
317,j1111,20110812,2294,2294,0,0,0,2294,2294,0,0,0,0,14
318,j1111,20110815,2294,2294,2303,2303,2303,2303,2303,9,9,2,460600,12
319,j1111,20110816,2303,2303,0,0,0,2303,2303,0,0,0,0,12
320,j1111,20110817,2303,2303,0,0,0,2303,2303,0,0,0,0,12
321,j1111,20110818,2303,2303,0,0,0,2303,2303,0,0,0,0,12
322,j1111,20110819,2303,2303,0,0,0,2303,2303,0,0,0,0,12
323,j1111,20110822,2303,2303,2181,2182,2181,2182,2181,-121,-122,6,1308800,16
324,j1111,20110823,2182,2181,0,0,0,2181,2181,0,0,0,0,16
325,j1111,20110824,2181,2181,0,0,0,2181,2181,0,0,0,0,16
326,j1111,20110825,2181,2181,0,0,0,2181,2181,0,0,0,0,16
327,j1111,20110826,2181,2181,0,0,0,2181,2181,0,0,0,0,16
328,j1111,20110829,2181,2181,2146,2146,2146,2146,2146,-35,-35,4,858400,16
329,j1111,20110830,2146,2146,0,0,0,2146,2146,0,0,0,0,16
330,j1111,20110831,2146,2146,2167,2167,2139,2139,2148,-7,2,26,5585000,34
331,j1111,20110901,2139,2148,2055,2130,2055,2130,2092,-18,-56,4,837000,34
332,j1111,20110902,2130,2092,2111,2111,2111,2111,2111,19,19,8,1688800,26
333,j1111,20110905,2111,2111,0,0,0,2111,2111,0,0,0,0,26
334,j1111,20110906,2111,2111,0,0,0,2111,2111,0,0,0,0,26
335,j1111,20110907,2111,2111,0,0,0,2111,2111,0,0,0,0,26
336,j1111,20110908,2111,2111,2146,2155,2141,2145,2145,34,34,12,2574600,22
337,j1111,20110909,2145,2145,2149,2149,2149,2149,2149,4,4,2,429800,22
338,j1111,20110913,2149,2149,0,0,0,2149,2149,0,0,0,0,22
339,j1111,20110914,2149,2149,0,0,0,2149,2149,0,0,0,0,22
340,j1111,20110915,2149,2149,0,0,0,2149,2149,0,0,0,0,22
341,j1111,20110916,2149,2149,0,0,0,2149,2149,0,0,0,0,22
342,j1111,20110919,2149,2149,0,0,0,2149,2149,0,0,0,0,22
343,j1111,20110920,2149,2149,0,0,0,2149,2149,0,0,0,0,22
344,j1111,20110921,2149,2149,2110,2110,2110,2110,2110,-39,-39,2,422000,24
345,j1111,20110922,2110,2110,2110,2110,2070,2070,2086,-40,-24,10,2086000,28
346,j1111,20110923,2070,2086,2048,2048,2048,2048,2048,-38,-38,2,409600,26
347,j1111,20110926,2048,2048,2014,2014,2001,2001,2010,-47,-38,8,1608600,24
348,j1111,20110927,2001,2010,0,0,0,2010,2010,0,0,0,0,24
349,j1111,20110928,2010,2010,0,0,0,2010,2010,0,0,0,0,24
350,j1111,20110929,2010,2010,1931,1931,1912,1912,1921,-98,-89,4,768600,22
351,j1111,20110930,1912,1921,0,0,0,1921,1921,0,0,0,0,22
352,j1111,20111010,1921,1921,1929,1929,1913,1914,1917,-7,-4,8,1534000,22
353,j1111,20111011,1914,1917,0,0,0,1917,1917,0,0,0,0,22
354,j1111,20111012,1917,1917,0,0,0,1917,1917,0,0,0,0,22
355,j1111,20111013,1917,1917,0,0,0,1917,1917,0,0,0,0,22
356,j1111,20111014,1917,1917,0,0,0,1917,1917,0,0,0,0,22
357,j1111,20111017,1917,1917,0,0,0,1917,1917,0,0,0,0,22
358,j1111,20111018,1917,1917,1824,1844,1824,1844,1834,-73,-83,4,733600,22
359,j1111,20111019,1844,1834,0,0,0,1834,1834,0,0,0,0,22
360,j1111,20111020,1834,1834,1743,1743,1743,1743,1743,-91,-91,2,348600,20
361,j1111,20111021,1743,1743,1668,1668,1668,1668,1668,-75,-75,2,333600,20
362,j1111,20111024,1668,1668,1688,1688,1688,1688,1688,20,20,4,675200,20
363,j1111,20111025,1688,1688,1772,1772,1772,1772,1772,84,84,2,354400,20
364,j1111,20111026,1772,1772,0,0,0,1772,1772,0,0,0,0,20
365,j1111,20111027,1772,1772,1772,1772,1772,1772,1771,0,-1,24,4252200,20
366,j1111,20111028,1772,1771,1780,1780,1780,1780,1780,9,9,2,356000,20
367,j1111,20111031,1780,1780,0,0,0,1780,1780,0,0,0,0,20
368,j1111,20111101,1780,1780,0,0,0,1780,1780,0,0,0,0,20
369,j1111,20111102,1780,1780,0,0,0,1780,1780,0,0,0,0,20
370,j1111,20111103,1780,1780,0,0,0,1780,1780,0,0,0,0,20
371,j1111,20111104,1780,1780,0,0,0,1780,1780,0,0,0,0,20
372,j1111,20111107,1780,1780,1850,1850,1850,1850,1850,70,70,20,3700000,0
373,j1111,20111108,1850,1850,0,0,0,1850,1850,0,0,0,0,0
374,j1111,20111109,1850,1850,0,0,0,1850,1850,0,0,0,0,0
375,j1111,20111110,1850,1850,0,0,0,1850,1850,0,0,0,0,0
376,j1111,20111111,1850,1850,0,0,0,1850,1850,0,0,0,0,0
377,j1111,20111114,1850,1850,0,0,0,1850,1850,0,0,0,0,0
378,j1112,20110418,2309,2305,2339,2443,2339,2430,2399,125,94,8,1919400,4
379,j1112,20110419,2430,2399,2393,2402,2381,2402,2390,3,-9,8,1912400,4
380,j1112,20110420,2402,2390,0,0,0,2390,2390,0,0,0,0,4
381,j1112,20110421,2390,2390,2393,2393,2393,2393,2393,3,3,2,478600,2
382,j1112,20110422,2393,2393,0,0,0,2393,2393,0,0,0,0,2
383,j1112,20110425,2393,2393,0,0,0,2393,2393,0,0,0,0,2
384,j1112,20110426,2393,2393,0,0,0,2393,2393,0,0,0,0,2
385,j1112,20110427,2393,2393,0,0,0,2393,2393,0,0,0,0,2
386,j1112,20110428,2393,2393,0,0,0,2393,2393,0,0,0,0,2
387,j1112,20110429,2393,2393,2437,2437,2437,2437,2437,44,44,2,487400,2
388,j1112,20110503,2437,2437,0,0,0,2437,2437,0,0,0,0,2
389,j1112,20110504,2437,2437,0,0,0,2437,2437,0,0,0,0,2
390,j1112,20110505,2437,2437,2351,2432,2323,2354,2371,-83,-66,18,4268800,4
391,j1112,20110506,2354,2371,2319,2359,2319,2359,2339,-12,-32,4,935600,4
392,j1112,20110509,2359,2339,0,0,0,2339,2339,0,0,0,0,4
393,j1112,20110510,2339,2339,0,0,0,2339,2339,0,0,0,0,4
394,j1112,20110511,2339,2339,0,0,0,2339,2339,0,0,0,0,4
395,j1112,20110512,2339,2339,0,0,0,2339,2339,0,0,0,0,4
396,j1112,20110513,2339,2339,2449,2459,2449,2450,2453,111,114,10,2453400,4
397,j1112,20110516,2450,2453,2516,2516,2442,2442,2479,-11,26,4,991600,4
398,j1112,20110517,2442,2479,2390,2390,2386,2386,2387,-93,-92,6,1432400,10
399,j1112,20110518,2386,2387,2411,2411,2411,2411,2411,24,24,2,482200,10
400,j1112,20110519,2411,2411,2377,2380,2357,2380,2371,-31,-40,6,1422800,14
401,j1112,20110520,2380,2371,0,0,0,2371,2371,0,0,0,0,14
402,j1112,20110523,2371,2371,0,0,0,2371,2371,0,0,0,0,14
403,j1112,20110524,2371,2371,0,0,0,2371,2371,0,0,0,0,14
404,j1112,20110525,2371,2371,0,0,0,2371,2371,0,0,0,0,14
405,j1112,20110526,2371,2371,0,0,0,2371,2371,0,0,0,0,14
406,j1112,20110527,2371,2371,0,0,0,2371,2371,0,0,0,0,14
407,j1112,20110530,2371,2371,0,0,0,2371,2371,0,0,0,0,14
408,j1112,20110531,2371,2371,0,0,0,2371,2371,0,0,0,0,14
409,j1112,20110601,2371,2371,0,0,0,2371,2371,0,0,0,0,14
410,j1112,20110602,2371,2371,0,0,0,2371,2371,0,0,0,0,14
411,j1112,20110603,2371,2371,2341,2387,2331,2359,2358,-12,-13,16,3772800,10
412,j1112,20110607,2359,2358,2436,2436,2374,2378,2396,20,38,6,1437600,6
413,j1112,20110608,2378,2396,0,0,0,2396,2396,0,0,0,0,6
414,j1112,20110609,2396,2396,0,0,0,2396,2396,0,0,0,0,6
415,j1112,20110610,2396,2396,2365,2365,2365,2365,2365,-31,-31,2,473000,6
416,j1112,20110613,2365,2365,2380,2380,2380,2380,2380,15,15,2,476000,6
417,j1112,20110614,2380,2380,0,0,0,2380,2380,0,0,0,0,6
418,j1112,20110615,2380,2380,0,0,0,2380,2380,0,0,0,0,6
419,j1112,20110616,2380,2380,2355,2355,2355,2355,2355,-25,-25,4,942000,6
420,j1112,20110617,2355,2355,0,0,0,2355,2355,0,0,0,0,6
421,j1112,20110620,2355,2355,0,0,0,2355,2355,0,0,0,0,6
422,j1112,20110621,2355,2355,2367,2429,2367,2389,2399,34,44,10,2399000,14
423,j1112,20110622,2389,2399,2305,2376,2305,2362,2349,-37,-50,14,3288800,6
424,j1112,20110623,2362,2349,0,0,0,2349,2349,0,0,0,0,6
425,j1112,20110624,2349,2349,0,0,0,2349,2349,0,0,0,0,6
426,j1112,20110627,2349,2349,0,0,0,2349,2349,0,0,0,0,6
427,j1112,20110628,2349,2349,0,0,0,2349,2349,0,0,0,0,6
428,j1112,20110629,2349,2349,0,0,0,2349,2349,0,0,0,0,6
429,j1112,20110630,2349,2349,0,0,0,2349,2349,0,0,0,0,6
430,j1112,20110701,2349,2349,0,0,0,2349,2349,0,0,0,0,6
431,j1112,20110704,2349,2349,0,0,0,2349,2349,0,0,0,0,6
432,j1112,20110705,2349,2349,0,0,0,2349,2349,0,0,0,0,6
433,j1112,20110706,2349,2349,2420,2420,2420,2420,2420,71,71,2,484000,6
434,j1112,20110707,2420,2420,0,0,0,2420,2420,0,0,0,0,6
435,j1112,20110708,2420,2420,0,0,0,2420,2420,0,0,0,0,6
436,j1112,20110711,2420,2420,0,0,0,2420,2420,0,0,0,0,6
437,j1112,20110712,2420,2420,2378,2378,2378,2378,2378,-42,-42,2,475600,6
438,j1112,20110713,2378,2378,0,0,0,2378,2378,0,0,0,0,6
439,j1112,20110714,2378,2378,2378,2378,2378,2378,2378,0,0,2,475600,6
440,j1112,20110715,2378,2378,0,0,0,2378,2378,0,0,0,0,6
441,j1112,20110718,2378,2378,0,0,0,2378,2378,0,0,0,0,6
442,j1112,20110719,2378,2378,0,0,0,2378,2378,0,0,0,0,6
443,j1112,20110720,2378,2378,0,0,0,2378,2378,0,0,0,0,6
444,j1112,20110721,2378,2378,0,0,0,2378,2378,0,0,0,0,6
445,j1112,20110722,2378,2378,0,0,0,2378,2378,0,0,0,0,6
446,j1112,20110725,2378,2378,0,0,0,2378,2378,0,0,0,0,6
447,j1112,20110726,2378,2378,0,0,0,2378,2378,0,0,0,0,6
448,j1112,20110727,2378,2378,2377,2377,2377,2377,2377,-1,-1,2,475400,6
449,j1112,20110728,2377,2377,0,0,0,2377,2377,0,0,0,0,6
450,j1112,20110729,2377,2377,0,0,0,2377,2377,0,0,0,0,6
451,j1112,20110801,2377,2377,0,0,0,2377,2377,0,0,0,0,6
452,j1112,20110802,2377,2377,0,0,0,2377,2377,0,0,0,0,6
453,j1112,20110803,2377,2377,0,0,0,2377,2377,0,0,0,0,6
454,j1112,20110804,2377,2377,0,0,0,2377,2377,0,0,0,0,6
455,j1112,20110805,2377,2377,0,0,0,2377,2377,0,0,0,0,6
456,j1112,20110808,2377,2377,0,0,0,2377,2377,0,0,0,0,6
457,j1112,20110809,2377,2377,2345,2345,2345,2345,2345,-32,-32,2,469000,6
458,j1112,20110810,2345,2345,0,0,0,2345,2345,0,0,0,0,6
459,j1112,20110811,2345,2345,0,0,0,2345,2345,0,0,0,0,6
460,j1112,20110812,2345,2345,2351,2351,2350,2350,2350,5,5,4,940200,4
461,j1112,20110815,2350,2350,0,0,0,2350,2350,0,0,0,0,4
462,j1112,20110816,2350,2350,2248,2357,2248,2357,2302,7,-48,4,921000,4
463,j1112,20110817,2357,2302,0,0,0,2302,2302,0,0,0,0,4
464,j1112,20110818,2302,2302,0,0,0,2302,2302,0,0,0,0,4
465,j1112,20110819,2302,2302,0,0,0,2302,2302,0,0,0,0,4
466,j1112,20110822,2302,2302,0,0,0,2302,2302,0,0,0,0,4
467,j1112,20110823,2302,2302,2164,2164,2164,2164,2164,-138,-138,2,432800,4
468,j1112,20110824,2164,2164,2101,2130,2101,2130,2115,-34,-49,4,846200,2
469,j1112,20110825,2130,2115,0,0,0,2115,2115,0,0,0,0,2
470,j1112,20110826,2115,2115,0,0,0,2115,2115,0,0,0,0,2
471,j1112,20110829,2115,2115,2211,2211,2137,2137,2174,22,59,4,869600,2
472,j1112,20110830,2137,2174,0,0,0,2174,2174,0,0,0,0,2
473,j1112,20110831,2174,2174,0,0,0,2174,2174,0,0,0,0,2
474,j1112,20110901,2174,2174,0,0,0,2174,2174,0,0,0,0,2
475,j1112,20110902,2174,2174,0,0,0,2174,2174,0,0,0,0,2
476,j1112,20110905,2174,2174,0,0,0,2174,2174,0,0,0,0,2
477,j1112,20110906,2174,2174,0,0,0,2174,2174,0,0,0,0,2
478,j1112,20110907,2174,2174,0,0,0,2174,2174,0,0,0,0,2
479,j1112,20110908,2174,2174,0,0,0,2174,2174,0,0,0,0,2
480,j1112,20110909,2174,2174,0,0,0,2174,2174,0,0,0,0,2
481,j1112,20110913,2174,2174,0,0,0,2174,2174,0,0,0,0,2
482,j1112,20110914,2174,2174,0,0,0,2174,2174,0,0,0,0,2
483,j1112,20110915,2174,2174,0,0,0,2174,2174,0,0,0,0,2
484,j1112,20110916,2174,2174,0,0,0,2174,2174,0,0,0,0,2
485,j1112,20110919,2174,2174,0,0,0,2174,2174,0,0,0,0,2
486,j1112,20110920,2174,2174,0,0,0,2174,2174,0,0,0,0,2
487,j1112,20110921,2174,2174,0,0,0,2174,2174,0,0,0,0,2
488,j1112,20110922,2174,2174,0,0,0,2174,2174,0,0,0,0,2
489,j1112,20110923,2174,2174,2135,2135,2133,2133,2133,-41,-41,6,1280200,6
490,j1112,20110926,2133,2133,2056,2056,2056,2056,2056,-77,-77,4,822400,2
491,j1112,20110927,2056,2056,0,0,0,2056,2056,0,0,0,0,2
492,j1112,20110928,2056,2056,0,0,0,2056,2056,0,0,0,0,2
493,j1112,20110929,2056,2056,0,0,0,2056,2056,0,0,0,0,2
494,j1112,20110930,2056,2056,0,0,0,2056,2056,0,0,0,0,2
495,j1112,20111010,2056,2056,0,0,0,2056,2056,0,0,0,0,2
496,j1112,20111011,2056,2056,0,0,0,2056,2056,0,0,0,0,2
497,j1112,20111012,2056,2056,0,0,0,2056,2056,0,0,0,0,2
498,j1112,20111013,2056,2056,2052,2052,2052,2052,2052,-4,-4,2,410400,4
499,j1112,20111014,2052,2052,2048,2048,2029,2029,2038,-23,-14,4,815400,4
500,j1112,20111017,2029,2038,0,0,0,2038,2038,0,0,0,0,4
501,j1112,20111018,2038,2038,0,0,0,2038,2038,0,0,0,0,4
502,j1112,20111019,2038,2038,2038,2038,1937,1937,1987,-101,-51,4,795000,4
503,j1112,20111020,1937,1987,1888,1888,1888,1888,1888,-99,-99,2,377600,2
504,j1112,20111021,1888,1888,1900,1901,1861,1861,1890,-27,2,16,3025400,0
505,j1112,20111024,1861,1890,0,0,0,1890,1890,0,0,0,0,0
506,j1112,20111025,1890,1890,1796,1964,1796,1964,1880,74,-10,4,752000,0
507,j1112,20111026,1964,1880,0,0,0,1880,1880,0,0,0,0,0
508,j1112,20111027,1880,1880,0,0,0,1880,1880,0,0,0,0,0
509,j1112,20111028,1880,1880,0,0,0,1880,1880,0,0,0,0,0
510,j1112,20111031,1880,1880,0,0,0,1880,1880,0,0,0,0,0
511,j1112,20111101,1880,1880,0,0,0,1880,1880,0,0,0,0,0
512,j1112,20111102,1880,1880,0,0,0,1880,1880,0,0,0,0,0
513,j1112,20111103,1880,1880,0,0,0,1880,1880,0,0,0,0,0
514,j1112,20111104,1880,1880,0,0,0,1880,1880,0,0,0,0,0
515,j1112,20111107,1880,1880,0,0,0,1880,1880,0,0,0,0,0
516,j1112,20111108,1880,1880,0,0,0,1880,1880,0,0,0,0,0
517,j1112,20111109,1880,1880,0,0,0,1880,1880,0,0,0,0,0
518,j1112,20111110,1880,1880,0,0,0,1880,1880,0,0,0,0,0
519,j1112,20111111,1880,1880,0,0,0,1880,1880,0,0,0,0,0
520,j1112,20111114,1880,1880,0,0,0,1880,1880,0,0,0,0,0
521,j1112,20111115,1880,1880,0,0,0,1880,1880,0,0,0,0,0
522,j1112,20111116,1880,1880,0,0,0,1880,1880,0,0,0,0,0
523,j1112,20111117,1880,1880,0,0,0,1880,1880,0,0,0,0,0
524,j1112,20111118,1880,1880,0,0,0,1880,1880,0,0,0,0,0
525,j1112,20111121,1880,1880,0,0,0,1880,1880,0,0,0,0,0
526,j1112,20111122,1880,1880,0,0,0,1880,1880,0,0,0,0,0
527,j1112,20111123,1880,1880,0,0,0,1880,1880,0,0,0,0,0
528,j1112,20111124,1880,1880,0,0,0,1880,1880,0,0,0,0,0
529,j1112,20111125,1880,1880,0,0,0,1880,1880,0,0,0,0,0
530,j1112,20111128,1880,1880,0,0,0,1880,1880,0,0,0,0,0
531,j1112,20111129,1880,1880,0,0,0,1880,1880,0,0,0,0,0
532,j1112,20111130,1880,1880,0,0,0,1880,1880,0,0,0,0,0
533,j1112,20111201,1880,1880,0,0,0,1880,1880,0,0,0,0,0
534,j1112,20111202,1880,1880,0,0,0,1880,1880,0,0,0,0,0
535,j1112,20111205,1880,1880,0,0,0,1880,1880,0,0,0,0,0
536,j1112,20111206,1880,1880,0,0,0,1880,1880,0,0,0,0,0
537,j1112,20111207,1880,1880,0,0,0,1880,1880,0,0,0,0,0
538,j1112,20111208,1880,1880,0,0,0,1880,1880,0,0,0,0,0
539,j1112,20111209,1880,1880,0,0,0,1880,1880,0,0,0,0,0
540,j1112,20111212,1880,1880,0,0,0,1880,1880,0,0,0,0,0
541,j1112,20111213,1880,1880,0,0,0,1880,1880,0,0,0,0,0
542,j1112,20111214,1880,1880,0,0,0,1880,1880,0,0,0,0,0
543,j1201,20110418,2316,2315,2326,2453,2325,2453,2429,138,114,786,190967000,334
544,j1201,20110419,2453,2429,2447,2453,2410,2422,2426,-7,-3,502,121786800,300
545,j1201,20110420,2422,2426,2432,2473,2417,2430,2442,4,16,398,97202000,288
546,j1201,20110421,2430,2442,2444,2453,2412,2422,2432,-20,-10,104,25293200,282
547,j1201,20110422,2422,2432,2422,2430,2391,2416,2409,-16,-23,104,25053600,290
548,j1201,20110425,2416,2409,2439,2450,2410,2416,2424,7,15,86,20854800,272
549,j1201,20110426,2416,2424,2399,2420,2399,2413,2410,-11,-14,108,26029000,252
550,j1201,20110427,2413,2410,2413,2426,2410,2413,2416,3,6,34,8214600,248
551,j1201,20110428,2413,2416,2422,2438,2420,2420,2429,4,13,30,7287000,248
552,j1201,20110429,2420,2429,2423,2426,2419,2419,2421,-10,-8,36,8718800,242
553,j1201,20110503,2419,2421,2427,2436,2427,2432,2430,11,9,44,10693800,242
554,j1201,20110504,2432,2430,2432,2432,2409,2414,2418,-16,-12,32,7738200,242
555,j1201,20110505,2414,2418,2403,2403,2392,2392,2396,-26,-22,106,25399600,250
556,j1201,20110506,2392,2396,2379,2379,2288,2358,2355,-38,-41,100,23552600,244
557,j1201,20110509,2358,2355,2360,2366,2360,2364,2361,9,6,20,4722400,228
558,j1201,20110510,2364,2361,2370,2370,2361,2361,2363,0,2,80,18906600,200
559,j1201,20110511,2361,2363,2373,2412,2368,2392,2397,29,34,86,20616600,202
560,j1201,20110512,2392,2397,2378,2416,2378,2405,2404,8,7,174,41838800,230
561,j1201,20110513,2405,2404,2416,2498,2416,2467,2468,63,64,244,60224400,304
562,j1201,20110516,2467,2468,2467,2479,2455,2468,2467,0,-1,220,54288000,368
563,j1201,20110517,2468,2467,2470,2475,2434,2455,2453,-12,-14,148,36308800,380
564,j1201,20110518,2455,2453,2482,2483,2432,2432,2453,-21,0,208,51026800,398
565,j1201,20110519,2432,2453,2428,2444,2428,2436,2435,-17,-18,94,22892000,404
566,j1201,20110520,2436,2435,2425,2447,2425,2436,2438,1,3,46,11219200,406
567,j1201,20110523,2436,2438,2430,2433,2417,2420,2427,-18,-11,36,8738000,398
568,j1201,20110524,2420,2427,2420,2446,2420,2442,2440,15,13,114,27816400,404
569,j1201,20110525,2442,2440,2434,2437,2432,2435,2433,-5,-7,18,4380800,396
570,j1201,20110526,2435,2433,2435,2451,2435,2442,2447,9,14,40,9789200,392
571,j1201,20110527,2442,2447,2432,2435,2420,2434,2429,-13,-18,44,10687600,390
572,j1201,20110530,2434,2429,2437,2437,2428,2429,2433,0,4,22,5353600,392
573,j1201,20110531,2429,2433,2432,2439,2432,2432,2433,-1,0,22,5353600,384
574,j1201,20110601,2432,2433,2428,2437,2422,2422,2426,-11,-7,60,14560600,372
575,j1201,20110602,2422,2426,2419,2429,2409,2422,2419,-4,-7,112,27095400,346
576,j1201,20110603,2422,2419,2412,2418,2405,2412,2413,-7,-6,172,41503600,334
577,j1201,20110607,2412,2413,2412,2425,2412,2418,2418,5,5,48,11610600,312
578,j1201,20110608,2418,2418,2410,2413,2408,2408,2410,-10,-8,54,13018200,312
579,j1201,20110609,2408,2410,2414,2415,2404,2404,2408,-6,-2,18,4335600,306
580,j1201,20110610,2404,2408,2406,2406,2394,2394,2400,-14,-8,30,7201800,298
581,j1201,20110613,2394,2400,2385,2394,2385,2392,2389,-8,-11,66,15771800,270
582,j1201,20110614,2392,2389,2397,2425,2397,2401,2414,12,25,60,14488600,276
583,j1201,20110615,2401,2414,2410,2411,2396,2396,2403,-18,-11,16,3845400,274
584,j1201,20110616,2396,2403,2388,2390,2380,2381,2384,-22,-19,52,12400800,254
585,j1201,20110617,2381,2384,2389,2389,2378,2378,2384,-6,0,8,1907800,256
586,j1201,20110620,2378,2384,2381,2381,2360,2360,2368,-24,-16,64,15161000,268
587,j1201,20110621,2360,2368,2366,2375,2354,2375,2361,7,-7,32,7557800,260
588,j1201,20110622,2375,2361,2378,2378,2362,2367,2365,6,4,48,11356000,234
589,j1201,20110623,2367,2365,2368,2394,2368,2394,2384,29,19,38,9060600,226
590,j1201,20110624,2394,2384,2394,2394,2377,2381,2383,-3,-1,24,5720000,230
591,j1201,20110627,2381,2383,2373,2392,2369,2380,2379,-3,-4,40,9519400,226
592,j1201,20110628,2380,2379,2399,2408,2376,2376,2394,-3,15,42,10056800,212
593,j1201,20110629,2376,2394,2394,2394,2369,2375,2375,-19,-19,52,12350600,230
594,j1201,20110630,2375,2375,2384,2384,2379,2383,2381,8,6,20,4763600,214
595,j1201,20110701,2383,2381,2378,2389,2374,2374,2380,-7,-1,22,5237000,220
596,j1201,20110704,2374,2380,2374,2396,2374,2392,2385,12,5,40,9541600,202
597,j1201,20110705,2392,2385,2385,2390,2385,2390,2386,5,1,10,2386400,200
598,j1201,20110706,2390,2386,2394,2425,2393,2425,2409,39,23,364,87717800,384
599,j1201,20110707,2425,2409,2360,2453,2360,2415,2433,6,24,808,196604200,792
600,j1201,20110708,2415,2433,2401,2438,2401,2427,2426,-6,-7,588,142683600,1066
601,j1201,20110711,2427,2426,2412,2432,2333,2370,2382,-56,-44,1312,312551600,460
602,j1201,20110712,2370,2382,2361,2379,2341,2357,2358,-25,-24,396,93380000,520
603,j1201,20110713,2357,2358,2368,2380,2360,2375,2368,17,10,186,44054600,452
604,j1201,20110714,2375,2368,2360,2375,2343,2363,2359,-5,-9,390,92034600,494
605,j1201,20110715,2363,2359,2360,2369,2360,2365,2365,6,6,114,26969600,468
606,j1201,20110718,2365,2365,2369,2377,2368,2369,2371,4,6,76,18020400,448
607,j1201,20110719,2369,2371,2375,2375,2371,2374,2373,3,2,116,27530800,400
608,j1201,20110720,2374,2373,2377,2384,2231,2350,2312,-23,-61,770,178046600,700
609,j1201,20110721,2350,2312,2349,2359,2336,2341,2344,29,32,190,44546800,746
610,j1201,20110722,2341,2344,2339,2344,2334,2344,2341,0,-3,104,24351000,732
611,j1201,20110725,2344,2341,2343,2355,2343,2344,2346,3,5,104,24401000,690
612,j1201,20110726,2344,2346,2347,2357,2346,2357,2353,11,7,70,16472600,686
613,j1201,20110727,2357,2353,2358,2358,2354,2357,2357,4,4,70,16500800,636
614,j1201,20110728,2357,2357,2357,2360,2352,2355,2357,-2,0,76,17917600,602
615,j1201,20110729,2355,2357,2346,2360,2346,2352,2355,-5,-2,82,19316200,600
616,j1201,20110801,2352,2355,2359,2370,2355,2370,2361,15,6,118,27862400,584
617,j1201,20110802,2370,2361,2370,2371,2362,2366,2364,5,3,26,6148000,582
618,j1201,20110803,2366,2364,2370,2375,2367,2375,2372,11,8,98,23249000,562
619,j1201,20110804,2375,2372,2373,2403,2362,2401,2384,29,12,330,78689000,652
620,j1201,20110805,2401,2384,2395,2405,2371,2380,2387,-4,3,758,180989200,646
621,j1201,20110808,2380,2387,2378,2380,2359,2361,2368,-26,-19,412,97590000,674
622,j1201,20110809,2361,2368,2340,2344,2276,2339,2318,-29,-50,788,182726000,740
623,j1201,20110810,2339,2318,2340,2358,2335,2344,2345,26,27,200,46914600,734
624,j1201,20110811,2344,2345,2331,2365,2330,2360,2352,15,7,376,88446800,732
625,j1201,20110812,2360,2352,2364,2375,2361,2365,2366,13,14,278,65794000,758
626,j1201,20110815,2365,2366,2370,2370,2351,2353,2358,-13,-8,450,106116800,880
627,j1201,20110816,2353,2358,2350,2350,2323,2324,2336,-34,-22,648,151432800,1064
628,j1201,20110817,2324,2336,2329,2335,2309,2310,2321,-26,-15,764,177332800,1434
629,j1201,20110818,2310,2321,2309,2314,2261,2282,2283,-39,-38,1816,414717200,1884
630,j1201,20110819,2282,2283,2260,2276,2241,2254,2259,-29,-24,2174,491107800,2616
631,j1201,20110822,2254,2259,2252,2279,2235,2242,2257,-17,-2,6394,1443627000,4158
632,j1201,20110823,2242,2257,2245,2250,2142,2155,2189,-102,-68,24152,5287474000,11378
633,j1201,20110824,2155,2189,2165,2191,2149,2187,2170,-2,-19,30332,6582509000,10750
634,j1201,20110825,2187,2170,2187,2217,2178,2215,2200,45,30,21664,4768084400,9314
635,j1201,20110826,2215,2200,2210,2226,2206,2213,2215,13,15,12904,2858286600,8954
636,j1201,20110829,2213,2215,2219,2220,2199,2209,2209,-6,-6,7416,1638528000,8862
637,j1201,20110830,2209,2209,2213,2221,2206,2213,2214,4,5,6076,1345613000,8814
638,j1201,20110831,2213,2214,2220,2252,2217,2242,2239,28,25,12854,2879243600,7968
639,j1201,20110901,2242,2239,2245,2249,2235,2238,2239,-1,0,4984,1116186400,7498
640,j1201,20110902,2238,2239,2238,2239,2205,2215,2218,-24,-21,6756,1498824600,7796
641,j1201,20110905,2215,2218,2210,2233,2206,2218,2221,0,3,5772,1282352600,7462
642,j1201,20110906,2218,2221,2212,2248,2212,2243,2235,22,14,11200,2503471800,7220
643,j1201,20110907,2243,2235,2243,2255,2238,2249,2245,14,10,6096,1368976200,6980
644,j1201,20110908,2249,2245,2250,2256,2237,2238,2242,-7,-3,3884,870841600,6780
645,j1201,20110909,2238,2242,2238,2244,2233,2243,2238,1,-4,2756,616919400,6382
646,j1201,20110913,2243,2238,2250,2251,2230,2232,2234,-6,-4,2136,477328000,6538
647,j1201,20110914,2232,2234,2236,2237,2213,2222,2221,-12,-13,3678,816962400,6292
648,j1201,20110915,2222,2221,2225,2238,2224,2230,2231,9,10,3602,803670800,6656
649,j1201,20110916,2230,2231,2237,2245,2226,2243,2236,12,5,5176,1157844000,7224
650,j1201,20110919,2243,2236,2240,2245,2217,2220,2227,-16,-9,6476,1442571600,7608
651,j1201,20110920,2220,2227,2211,2219,2195,2213,2206,-14,-21,7818,1724992600,8112
652,j1201,20110921,2213,2206,2211,2245,2211,2233,2230,27,24,17342,3868903600,10056
653,j1201,20110922,2233,2230,2221,2221,2165,2190,2198,-40,-32,12174,2676853400,9596
654,j1201,20110923,2190,2198,2150,2187,2130,2141,2158,-57,-40,17094,3689607400,8700
655,j1201,20110926,2141,2158,2145,2150,2072,2073,2110,-85,-48,10074,2126496000,8004
656,j1201,20110927,2073,2110,2088,2116,2088,2106,2106,-4,-4,9742,2051769800,7792
657,j1201,20110928,2106,2106,2110,2113,2074,2087,2092,-19,-14,6284,1315172400,7898
658,j1201,20110929,2087,2092,2050,2050,2002,2022,2029,-70,-63,8830,1792463600,6392
659,j1201,20110930,2022,2029,2030,2041,2026,2038,2033,9,4,6232,1267425000,5850
660,j1201,20111010,2038,2033,2056,2087,2040,2046,2051,13,18,3746,768646000,5858
661,j1201,20111011,2046,2051,2059,2075,2052,2054,2064,3,13,6444,1330267400,6324
662,j1201,20111012,2054,2064,2058,2066,2042,2063,2054,-1,-10,4508,926286800,6190
663,j1201,20111013,2063,2054,2063,2067,2053,2061,2058,7,4,2672,549947200,6102
664,j1201,20111014,2061,2058,2056,2064,2052,2057,2058,-1,0,2874,591495400,6204
665,j1201,20111017,2057,2058,2061,2066,2012,2016,2034,-42,-24,10130,2061108800,8686
666,j1201,20111018,2016,2034,2010,2010,1983,1987,1993,-47,-41,10466,2086799000,8454
667,j1201,20111019,1987,1993,2003,2005,1973,1982,1987,-11,-6,6074,1207395400,8558
668,j1201,20111020,1982,1987,1951,1960,1888,1890,1906,-97,-81,8622,1643841400,8088
669,j1201,20111021,1890,1906,1898,1924,1892,1919,1913,13,7,7960,1523353600,7714
670,j1201,20111024,1919,1913,1940,1986,1907,1961,1943,48,30,11968,2326387000,7386
671,j1201,20111025,1961,1943,1960,2006,1953,1968,1978,25,35,12442,2461653400,6984
672,j1201,20111026,1968,1978,1950,1979,1950,1968,1965,-10,-13,7842,1541087200,7186
673,j1201,20111027,1968,1965,1970,1978,1965,1972,1971,7,6,5800,1143436000,7150
674,j1201,20111028,1972,1971,2000,2016,1974,1980,1987,9,16,6532,1298074200,6550
675,j1201,20111031,1980,1987,1980,1981,1951,1960,1966,-27,-21,3488,685758400,6184
676,j1201,20111101,1960,1966,1955,1971,1946,1955,1959,-11,-7,3786,741872600,6052
677,j1201,20111102,1955,1959,1931,1951,1921,1947,1934,-12,-25,3430,663529800,5882
678,j1201,20111103,1947,1934,1936,1947,1933,1935,1938,1,4,2912,564623800,5836
679,j1201,20111104,1935,1938,1959,1970,1947,1967,1957,29,19,4140,810257600,5264
680,j1201,20111107,1967,1957,1961,1968,1956,1962,1960,5,3,2736,536383000,5222
681,j1201,20111108,1962,1960,1964,1983,1964,1978,1975,18,15,5784,1142575800,5340
682,j1201,20111109,1978,1975,1985,1990,1971,1979,1979,4,4,2834,560937000,5102
683,j1201,20111110,1979,1979,1888,1965,1888,1946,1942,-33,-37,5250,1020016000,4626
684,j1201,20111111,1946,1942,1950,2039,1950,2039,2014,97,72,20250,4078739800,8058
685,j1201,20111114,2039,2014,2050,2058,2021,2029,2034,15,20,24824,5051290800,8252
686,j1201,20111115,2029,2034,2018,2083,2010,2038,2060,4,26,54802,11290081400,11576
687,j1201,20111116,2038,2060,2030,2049,2011,2015,2030,-45,-30,30838,6261239600,10216
688,j1201,20111117,2015,2030,2025,2044,2012,2023,2026,-7,-4,22168,4492650200,9292
689,j1201,20111118,2023,2026,2006,2019,1994,2009,2008,-17,-18,12394,2489270400,8290
690,j1201,20111121,2009,2008,2002,2023,1987,1993,2004,-15,-4,13884,2783450200,8042
691,j1201,20111122,1993,2004,1987,1999,1983,1990,1988,-14,-16,6434,1279620600,6990
692,j1201,20111123,1990,1988,1986,1994,1972,1973,1982,-15,-6,4162,825190600,6260
693,j1201,20111124,1973,1982,1980,1980,1951,1972,1965,-10,-17,5382,1057634400,5848
694,j1201,20111125,1972,1965,1966,1978,1958,1963,1967,-2,2,3620,712299000,5568
695,j1201,20111128,1963,1967,1975,1978,1953,1963,1966,-4,-1,4712,926381400,5244
696,j1201,20111129,1963,1966,1964,1975,1955,1972,1963,6,-3,4096,804215000,5254
697,j1201,20111130,1972,1963,1974,2029,1971,1984,2000,21,37,29010,5802570600,6504
698,j1201,20111201,1984,2000,2030,2050,1994,2006,2010,6,10,13590,2731900400,5476
699,j1201,20111202,2006,2010,2005,2005,1991,1995,1998,-15,-12,4106,820553400,5114
700,j1201,20111205,1995,1998,1998,2002,1992,2000,1997,2,-1,3154,630101400,4542
701,j1201,20111206,2000,1997,1996,1996,1955,1974,1968,-23,-29,9070,1785824600,4646
702,j1201,20111207,1974,1968,1975,1979,1969,1979,1973,11,5,1914,377750600,3996
703,j1201,20111208,1979,1973,1970,1970,1955,1968,1964,-5,-9,1964,385829600,3338
704,j1201,20111209,1968,1964,1960,1976,1960,1962,1967,-2,3,920,181031800,2978
705,j1201,20111212,1962,1967,1961,1968,1933,1933,1946,-34,-21,966,188079000,2804
706,j1201,20111213,1933,1946,1910,1946,1910,1946,1933,0,-13,1436,277598000,2130
707,j1201,20111214,1946,1933,1955,1955,1924,1932,1935,-1,2,722,139751000,1834
708,j1201,20111215,1932,1935,1900,1920,1900,1909,1909,-26,-26,536,102361400,1466
709,j1201,20111216,1909,1909,1937,1937,1901,1928,1922,19,13,376,72280200,1312
710,j1201,20111219,1928,1922,1921,1927,1917,1922,1922,0,0,468,89973800,952
711,j1201,20111220,1922,1922,1921,1924,1912,1918,1918,-4,-4,164,31468800,846
712,j1201,20111221,1918,1918,1920,1922,1910,1914,1918,-4,0,178,34143800,702
713,j1201,20111222,1914,1918,1905,1908,1896,1896,1904,-22,-14,218,41519600,534
714,j1201,20111223,1896,1904,1874,1880,1828,1834,1851,-70,-53,196,36284400,480
715,j1201,20111226,1834,1851,1841,1860,1837,1860,1849,9,-2,150,27741800,482
716,j1201,20111227,1860,1849,1862,1866,1849,1862,1860,13,11,96,17856400,474
717,j1201,20111228,1862,1860,1849,1859,1841,1847,1850,-13,-10,44,8140400,462
718,j1201,20111229,1847,1850,1775,1868,1775,1821,1812,-29,-38,136,24647400,460
719,j1201,20111230,1821,1812,1820,1825,1781,1785,1806,-27,-6,92,16623400,460
720,j1202,20110418,2220,2220,0,0,0,2220,2220,0,0,0,0,0
721,j1202,20110419,2220,2220,2397,2397,2397,2397,2397,177,177,2,479400,2
722,j1202,20110420,2397,2397,0,0,0,2397,2397,0,0,0,0,2
723,j1202,20110421,2397,2397,0,0,0,2397,2397,0,0,0,0,2
724,j1202,20110422,2397,2397,2370,2370,2370,2370,2370,-27,-27,2,474000,2
725,j1202,20110425,2370,2370,0,0,0,2370,2370,0,0,0,0,2
726,j1202,20110426,2370,2370,2407,2407,2407,2407,2407,37,37,2,481400,2
727,j1202,20110427,2407,2407,0,0,0,2407,2407,0,0,0,0,2
728,j1202,20110428,2407,2407,0,0,0,2407,2407,0,0,0,0,2
729,j1202,20110429,2407,2407,0,0,0,2407,2407,0,0,0,0,2
730,j1202,20110503,2407,2407,0,0,0,2407,2407,0,0,0,0,2
731,j1202,20110504,2407,2407,0,0,0,2407,2407,0,0,0,0,2
732,j1202,20110505,2407,2407,0,0,0,2407,2407,0,0,0,0,2
733,j1202,20110506,2407,2407,0,0,0,2407,2407,0,0,0,0,2
734,j1202,20110509,2407,2407,0,0,0,2407,2407,0,0,0,0,2
735,j1202,20110510,2407,2407,0,0,0,2407,2407,0,0,0,0,2
736,j1202,20110511,2407,2407,0,0,0,2407,2407,0,0,0,0,2
737,j1202,20110512,2407,2407,0,0,0,2407,2407,0,0,0,0,2
738,j1202,20110513,2407,2407,0,0,0,2407,2407,0,0,0,0,2
739,j1202,20110516,2407,2407,2310,2458,2310,2458,2395,51,-12,70,16766000,0
740,j1202,20110517,2458,2395,0,0,0,2395,2395,0,0,0,0,0
741,j1202,20110518,2395,2395,0,0,0,2395,2395,0,0,0,0,0
742,j1202,20110519,2395,2395,0,0,0,2395,2395,0,0,0,0,0
743,j1202,20110520,2395,2395,0,0,0,2395,2395,0,0,0,0,0
744,j1202,20110523,2395,2395,0,0,0,2395,2395,0,0,0,0,0
745,j1202,20110524,2395,2395,0,0,0,2395,2395,0,0,0,0,0
746,j1202,20110525,2395,2395,0,0,0,2395,2395,0,0,0,0,0
747,j1202,20110526,2395,2395,0,0,0,2395,2395,0,0,0,0,0
748,j1202,20110527,2395,2395,0,0,0,2395,2395,0,0,0,0,0
749,j1202,20110530,2395,2395,0,0,0,2395,2395,0,0,0,0,0
750,j1202,20110531,2395,2395,0,0,0,2395,2395,0,0,0,0,0
751,j1202,20110601,2395,2395,0,0,0,2395,2395,0,0,0,0,0
752,j1202,20110602,2395,2395,0,0,0,2395,2395,0,0,0,0,0
753,j1202,20110603,2395,2395,0,0,0,2395,2395,0,0,0,0,0
754,j1202,20110607,2395,2395,0,0,0,2395,2395,0,0,0,0,0
755,j1202,20110608,2395,2395,0,0,0,2395,2395,0,0,0,0,0
756,j1202,20110609,2395,2395,0,0,0,2395,2395,0,0,0,0,0
757,j1202,20110610,2395,2395,0,0,0,2395,2395,0,0,0,0,0
758,j1202,20110613,2395,2395,0,0,0,2395,2395,0,0,0,0,0
759,j1202,20110614,2395,2395,0,0,0,2395,2395,0,0,0,0,0
760,j1202,20110615,2395,2395,0,0,0,2395,2395,0,0,0,0,0
761,j1202,20110616,2395,2395,0,0,0,2395,2395,0,0,0,0,0
762,j1202,20110617,2395,2395,0,0,0,2395,2395,0,0,0,0,0
763,j1202,20110620,2395,2395,0,0,0,2395,2395,0,0,0,0,0
764,j1202,20110621,2395,2395,0,0,0,2395,2395,0,0,0,0,0
765,j1202,20110622,2395,2395,0,0,0,2395,2395,0,0,0,0,0
766,j1202,20110623,2395,2395,0,0,0,2395,2395,0,0,0,0,0
767,j1202,20110624,2395,2395,0,0,0,2395,2395,0,0,0,0,0
768,j1202,20110627,2395,2395,0,0,0,2395,2395,0,0,0,0,0
769,j1202,20110628,2395,2395,0,0,0,2395,2395,0,0,0,0,0
770,j1202,20110629,2395,2395,0,0,0,2395,2395,0,0,0,0,0
771,j1202,20110630,2395,2395,0,0,0,2395,2395,0,0,0,0,0
772,j1202,20110701,2395,2395,0,0,0,2395,2395,0,0,0,0,0
773,j1202,20110704,2395,2395,0,0,0,2395,2395,0,0,0,0,0
774,j1202,20110705,2395,2395,0,0,0,2395,2395,0,0,0,0,0
775,j1202,20110706,2395,2395,0,0,0,2395,2395,0,0,0,0,0
776,j1202,20110707,2395,2395,0,0,0,2395,2395,0,0,0,0,0
777,j1202,20110708,2395,2395,2357,2430,2357,2430,2393,35,-2,4,957400,0
778,j1202,20110711,2430,2393,0,0,0,2393,2393,0,0,0,0,0
779,j1202,20110712,2393,2393,0,0,0,2393,2393,0,0,0,0,0
780,j1202,20110713,2393,2393,0,0,0,2393,2393,0,0,0,0,0
781,j1202,20110714,2393,2393,0,0,0,2393,2393,0,0,0,0,0
782,j1202,20110715,2393,2393,0,0,0,2393,2393,0,0,0,0,0
783,j1202,20110718,2393,2393,0,0,0,2393,2393,0,0,0,0,0
784,j1202,20110719,2393,2393,0,0,0,2393,2393,0,0,0,0,0
785,j1202,20110720,2393,2393,0,0,0,2393,2393,0,0,0,0,0
786,j1202,20110721,2393,2393,0,0,0,2393,2393,0,0,0,0,0
787,j1202,20110722,2393,2393,0,0,0,2393,2393,0,0,0,0,0
788,j1202,20110725,2393,2393,0,0,0,2393,2393,0,0,0,0,0
789,j1202,20110726,2393,2393,0,0,0,2393,2393,0,0,0,0,0
790,j1202,20110727,2393,2393,0,0,0,2393,2393,0,0,0,0,0
791,j1202,20110728,2393,2393,0,0,0,2393,2393,0,0,0,0,0
792,j1202,20110729,2393,2393,0,0,0,2393,2393,0,0,0,0,0
793,j1202,20110801,2393,2393,0,0,0,2393,2393,0,0,0,0,0
794,j1202,20110802,2393,2393,0,0,0,2393,2393,0,0,0,0,0
795,j1202,20110803,2393,2393,0,0,0,2393,2393,0,0,0,0,0
796,j1202,20110804,2393,2393,0,0,0,2393,2393,0,0,0,0,0
797,j1202,20110805,2393,2393,0,0,0,2393,2393,0,0,0,0,0
798,j1202,20110808,2393,2393,0,0,0,2393,2393,0,0,0,0,0
799,j1202,20110809,2393,2393,0,0,0,2393,2393,0,0,0,0,0
800,j1202,20110810,2393,2393,0,0,0,2393,2393,0,0,0,0,0
801,j1202,20110811,2393,2393,0,0,0,2393,2393,0,0,0,0,0
802,j1202,20110812,2393,2393,0,0,0,2393,2393,0,0,0,0,0
803,j1202,20110815,2393,2393,0,0,0,2393,2393,0,0,0,0,0
804,j1202,20110816,2393,2393,0,0,0,2393,2393,0,0,0,0,0
805,j1202,20110817,2393,2393,0,0,0,2393,2393,0,0,0,0,0
806,j1202,20110818,2393,2393,0,0,0,2393,2393,0,0,0,0,0
807,j1202,20110819,2393,2393,0,0,0,2393,2393,0,0,0,0,0
808,j1202,20110822,2393,2393,0,0,0,2393,2393,0,0,0,0,0
809,j1202,20110823,2393,2393,2291,2291,2291,2291,2291,-102,-102,4,916400,4
810,j1202,20110824,2291,2291,2185,2185,2185,2185,2185,-106,-106,2,437000,4
811,j1202,20110825,2185,2185,2197,2285,2197,2245,2242,60,57,10,2242200,4
812,j1202,20110826,2245,2242,2233,2233,2233,2233,2233,-9,-9,2,446600,4
813,j1202,20110829,2233,2233,0,0,0,2233,2233,0,0,0,0,4
814,j1202,20110830,2233,2233,0,0,0,2233,2233,0,0,0,0,4
815,j1202,20110831,2233,2233,2243,2307,2243,2279,2266,46,33,12,2720000,2
816,j1202,20110901,2279,2266,0,0,0,2266,2266,0,0,0,0,2
817,j1202,20110902,2266,2266,0,0,0,2266,2266,0,0,0,0,2
818,j1202,20110905,2266,2266,0,0,0,2266,2266,0,0,0,0,2
819,j1202,20110906,2266,2266,0,0,0,2266,2266,0,0,0,0,2
820,j1202,20110907,2266,2266,0,0,0,2266,2266,0,0,0,0,2
821,j1202,20110908,2266,2266,0,0,0,2266,2266,0,0,0,0,2
822,j1202,20110909,2266,2266,0,0,0,2266,2266,0,0,0,0,2
823,j1202,20110913,2266,2266,0,0,0,2266,2266,0,0,0,0,2
824,j1202,20110914,2266,2266,0,0,0,2266,2266,0,0,0,0,2
825,j1202,20110915,2266,2266,0,0,0,2266,2266,0,0,0,0,2
826,j1202,20110916,2266,2266,0,0,0,2266,2266,0,0,0,0,2
827,j1202,20110919,2266,2266,0,0,0,2266,2266,0,0,0,0,2
828,j1202,20110920,2266,2266,2198,2259,2198,2259,2209,-7,-57,34,7512600,30
829,j1202,20110921,2259,2209,2262,2262,2254,2254,2258,45,49,4,903200,32
830,j1202,20110922,2254,2258,2201,2223,2201,2223,2212,-35,-46,4,884800,28
831,j1202,20110923,2223,2212,2217,2217,2183,2183,2211,-29,-1,30,6634600,2
832,j1202,20110926,2183,2211,0,0,0,2211,2211,0,0,0,0,2
833,j1202,20110927,2211,2211,0,0,0,2211,2211,0,0,0,0,2
834,j1202,20110928,2211,2211,0,0,0,2211,2211,0,0,0,0,2
835,j1202,20110929,2211,2211,2101,2101,2101,2101,2101,-110,-110,2,420200,2
836,j1202,20110930,2101,2101,2085,2085,2085,2085,2085,-16,-16,2,417000,2
837,j1202,20111010,2085,2085,0,0,0,2085,2085,0,0,0,0,2
838,j1202,20111011,2085,2085,0,0,0,2085,2085,0,0,0,0,2
839,j1202,20111012,2085,2085,0,0,0,2085,2085,0,0,0,0,2
840,j1202,20111013,2085,2085,0,0,0,2085,2085,0,0,0,0,2
841,j1202,20111014,2085,2085,0,0,0,2085,2085,0,0,0,0,2
842,j1202,20111017,2085,2085,0,0,0,2085,2085,0,0,0,0,2
843,j1202,20111018,2085,2085,0,0,0,2085,2085,0,0,0,0,2
844,j1202,20111019,2085,2085,0,0,0,2085,2085,0,0,0,0,2
845,j1202,20111020,2085,2085,0,0,0,2085,2085,0,0,0,0,2
846,j1202,20111021,2085,2085,0,0,0,2085,2085,0,0,0,0,2
847,j1202,20111024,2085,2085,0,0,0,2085,2085,0,0,0,0,2
848,j1202,20111025,2085,2085,0,0,0,2085,2085,0,0,0,0,2
849,j1202,20111026,2085,2085,0,0,0,2085,2085,0,0,0,0,2
850,j1202,20111027,2085,2085,0,0,0,2085,2085,0,0,0,0,2
851,j1202,20111028,2085,2085,0,0,0,2085,2085,0,0,0,0,2
852,j1202,20111031,2085,2085,0,0,0,2085,2085,0,0,0,0,2
853,j1202,20111101,2085,2085,0,0,0,2085,2085,0,0,0,0,2
854,j1202,20111102,2085,2085,0,0,0,2085,2085,0,0,0,0,2
855,j1202,20111103,2085,2085,0,0,0,2085,2085,0,0,0,0,2
856,j1202,20111104,2085,2085,0,0,0,2085,2085,0,0,0,0,2
857,j1202,20111107,2085,2085,0,0,0,2085,2085,0,0,0,0,2
858,j1202,20111108,2085,2085,0,0,0,2085,2085,0,0,0,0,2
859,j1202,20111109,2085,2085,0,0,0,2085,2085,0,0,0,0,2
860,j1202,20111110,2085,2085,0,0,0,2085,2085,0,0,0,0,2
861,j1202,20111111,2085,2085,2049,2140,2049,2061,2070,-24,-15,12,2484200,4
862,j1202,20111114,2061,2070,0,0,0,2070,2070,0,0,0,0,4
863,j1202,20111115,2070,2070,0,0,0,2070,2070,0,0,0,0,4
864,j1202,20111116,2070,2070,0,0,0,2070,2070,0,0,0,0,4
865,j1202,20111117,2070,2070,0,0,0,2070,2070,0,0,0,0,4
866,j1202,20111118,2070,2070,0,0,0,2070,2070,0,0,0,0,4
867,j1202,20111121,2070,2070,0,0,0,2070,2070,0,0,0,0,4
868,j1202,20111122,2070,2070,0,0,0,2070,2070,0,0,0,0,4
869,j1202,20111123,2070,2070,2068,2068,1969,2010,2015,-60,-55,6,1209400,4
870,j1202,20111124,2010,2015,1915,2015,1915,2007,1988,-8,-27,16,3182000,6
871,j1202,20111125,2007,1988,0,0,0,1988,1988,0,0,0,0,6
872,j1202,20111128,1988,1988,0,0,0,1988,1988,0,0,0,0,6
873,j1202,20111129,1988,1988,0,0,0,1988,1988,0,0,0,0,6
874,j1202,20111130,1988,1988,0,0,0,1988,1988,0,0,0,0,6
875,j1202,20111201,1988,1988,0,0,0,1988,1988,0,0,0,0,6
876,j1202,20111202,1988,1988,0,0,0,1988,1988,0,0,0,0,6
877,j1202,20111205,1988,1988,0,0,0,1988,1988,0,0,0,0,6
878,j1202,20111206,1988,1988,1995,1995,1983,1983,1989,-5,1,4,795600,6
879,j1202,20111207,1983,1989,2009,2009,2009,2009,2009,20,20,2,401800,6
880,j1202,20111208,2009,2009,0,0,0,2009,2009,0,0,0,0,6
881,j1202,20111209,2009,2009,0,0,0,2009,2009,0,0,0,0,6
882,j1202,20111212,2009,2009,1909,1909,1909,1909,1909,-100,-100,2,381800,4
883,j1202,20111213,1909,1909,0,0,0,1909,1909,0,0,0,0,4
884,j1202,20111214,1909,1909,0,0,0,1909,1909,0,0,0,0,4
885,j1202,20111215,1909,1909,0,0,0,1909,1909,0,0,0,0,4
886,j1202,20111216,1909,1909,0,0,0,1909,1909,0,0,0,0,4
887,j1202,20111219,1909,1909,0,0,0,1909,1909,0,0,0,0,4
888,j1202,20111220,1909,1909,0,0,0,1909,1909,0,0,0,0,4
889,j1202,20111221,1909,1909,0,0,0,1909,1909,0,0,0,0,4
890,j1202,20111222,1909,1909,0,0,0,1909,1909,0,0,0,0,4
891,j1202,20111223,1909,1909,0,0,0,1909,1909,0,0,0,0,4
892,j1202,20111226,1909,1909,0,0,0,1909,1909,0,0,0,0,4
893,j1202,20111227,1909,1909,0,0,0,1909,1909,0,0,0,0,4
894,j1202,20111228,1909,1909,0,0,0,1909,1909,0,0,0,0,4
895,j1202,20111229,1909,1909,0,0,0,1909,1909,0,0,0,0,4
896,j1202,20111230,1909,1909,0,0,0,1909,1909,0,0,0,0,4
897,j1203,20110418,2337,2310,2367,2448,2367,2448,2407,138,97,74,17816000,48
898,j1203,20110419,2448,2407,2519,2519,2408,2416,2427,9,20,88,21362400,64
899,j1203,20110420,2416,2427,2460,2460,2417,2433,2442,6,15,8,1954000,70
900,j1203,20110421,2433,2442,2429,2429,2417,2417,2421,-25,-21,6,1452800,70
901,j1203,20110422,2417,2421,2453,2454,2398,2415,2423,-6,2,24,5816400,74
902,j1203,20110425,2415,2423,2425,2425,2406,2406,2415,-17,-8,4,966200,76
903,j1203,20110426,2406,2415,2382,2400,2382,2392,2390,-23,-25,42,10040600,76
904,j1203,20110427,2392,2390,2405,2405,2405,2405,2405,15,15,2,481000,74
905,j1203,20110428,2405,2405,2414,2414,2414,2414,2414,9,9,2,482800,72
906,j1203,20110429,2414,2414,0,0,0,2414,2414,0,0,0,0,72
907,j1203,20110503,2414,2414,2421,2421,2421,2421,2421,7,7,2,484200,72
908,j1203,20110504,2421,2421,2400,2400,2393,2393,2394,-28,-27,8,1915800,74
909,j1203,20110505,2393,2394,2390,2390,2390,2390,2390,-4,-4,4,956000,70
910,j1203,20110506,2390,2390,2350,2366,2350,2364,2361,-26,-29,16,3778800,54
911,j1203,20110509,2364,2361,0,0,0,2361,2361,0,0,0,0,54
912,j1203,20110510,2361,2361,2366,2366,2366,2366,2366,5,5,4,946400,54
913,j1203,20110511,2366,2366,2401,2401,2377,2377,2389,11,23,4,955600,56
914,j1203,20110512,2377,2389,2377,2409,2376,2403,2385,14,-4,18,4294600,54
915,j1203,20110513,2403,2385,2469,2492,2445,2445,2467,60,82,8,1974000,60
916,j1203,20110516,2445,2467,0,0,0,2467,2467,0,0,0,0,60
917,j1203,20110517,2467,2467,2409,2409,2409,2409,2409,-58,-58,2,481800,62
918,j1203,20110518,2409,2409,2468,2468,2401,2401,2424,-8,15,10,2424800,68
919,j1203,20110519,2401,2424,2413,2413,2401,2401,2407,-23,-17,4,962800,68
920,j1203,20110520,2401,2407,2396,2439,2396,2399,2411,-8,4,6,1446800,70
921,j1203,20110523,2399,2411,2406,2406,2403,2403,2403,-8,-8,10,2403800,64
922,j1203,20110524,2403,2403,0,0,0,2403,2403,0,0,0,0,64
923,j1203,20110525,2403,2403,0,0,0,2403,2403,0,0,0,0,64
924,j1203,20110526,2403,2403,2415,2416,2415,2416,2415,13,12,4,966200,60
925,j1203,20110527,2416,2415,2409,2409,2409,2409,2409,-6,-6,2,481800,58
926,j1203,20110530,2409,2409,2431,2431,2408,2408,2419,-1,10,6,1451800,56
927,j1203,20110531,2408,2419,2403,2403,2403,2403,2403,-16,-16,2,480600,56
928,j1203,20110601,2403,2403,2419,2419,2414,2416,2416,13,13,8,1933400,48
929,j1203,20110602,2416,2416,2416,2416,2411,2411,2415,-5,-1,10,2415000,42
930,j1203,20110603,2411,2415,2410,2411,2409,2409,2410,-6,-5,6,1446000,36
931,j1203,20110607,2409,2410,0,0,0,2410,2410,0,0,0,0,36
932,j1203,20110608,2410,2410,0,0,0,2410,2410,0,0,0,0,36
933,j1203,20110609,2410,2410,2392,2392,2392,2392,2392,-18,-18,2,478400,34
934,j1203,20110610,2392,2392,2382,2382,2382,2382,2382,-10,-10,2,476400,32
935,j1203,20110613,2382,2382,0,0,0,2382,2382,0,0,0,0,32
936,j1203,20110614,2382,2382,0,0,0,2382,2382,0,0,0,0,32
937,j1203,20110615,2382,2382,0,0,0,2382,2382,0,0,0,0,32
938,j1203,20110616,2382,2382,0,0,0,2382,2382,0,0,0,0,32
939,j1203,20110617,2382,2382,0,0,0,2382,2382,0,0,0,0,32
940,j1203,20110620,2382,2382,0,0,0,2382,2382,0,0,0,0,32
941,j1203,20110621,2382,2382,2374,2374,2347,2347,2363,-35,-19,10,2363200,34
942,j1203,20110622,2347,2363,0,0,0,2363,2363,0,0,0,0,34
943,j1203,20110623,2363,2363,2344,2384,2344,2384,2369,21,6,6,1421600,34
944,j1203,20110624,2384,2369,0,0,0,2369,2369,0,0,0,0,34
945,j1203,20110627,2369,2369,2372,2372,2372,2372,2372,3,3,4,948800,34
946,j1203,20110628,2372,2372,0,0,0,2372,2372,0,0,0,0,34
947,j1203,20110629,2372,2372,0,0,0,2372,2372,0,0,0,0,34
948,j1203,20110630,2372,2372,0,0,0,2372,2372,0,0,0,0,34
949,j1203,20110701,2372,2372,2366,2366,2366,2366,2366,-6,-6,6,1419600,30
950,j1203,20110704,2366,2366,0,0,0,2366,2366,0,0,0,0,30
951,j1203,20110705,2366,2366,0,0,0,2366,2366,0,0,0,0,30
952,j1203,20110706,2366,2366,2403,2403,2403,2403,2403,37,37,2,480600,30
953,j1203,20110707,2403,2403,0,0,0,2403,2403,0,0,0,0,30
954,j1203,20110708,2403,2403,0,0,0,2403,2403,0,0,0,0,30
955,j1203,20110711,2403,2403,0,0,0,2403,2403,0,0,0,0,30
956,j1203,20110712,2403,2403,0,0,0,2403,2403,0,0,0,0,30
957,j1203,20110713,2403,2403,0,0,0,2403,2403,0,0,0,0,30
958,j1203,20110714,2403,2403,0,0,0,2403,2403,0,0,0,0,30
959,j1203,20110715,2403,2403,0,0,0,2403,2403,0,0,0,0,30
960,j1203,20110718,2403,2403,2394,2394,2394,2394,2394,-9,-9,2,478800,32
961,j1203,20110719,2394,2394,0,0,0,2394,2394,0,0,0,0,32
962,j1203,20110720,2394,2394,0,0,0,2394,2394,0,0,0,0,32
963,j1203,20110721,2394,2394,2361,2361,2361,2361,2361,-33,-33,2,472200,32
964,j1203,20110722,2361,2361,2375,2375,2375,2375,2375,14,14,2,475000,30
965,j1203,20110725,2375,2375,0,0,0,2375,2375,0,0,0,0,30
966,j1203,20110726,2375,2375,0,0,0,2375,2375,0,0,0,0,30
967,j1203,20110727,2375,2375,2361,2361,2361,2361,2361,-14,-14,2,472200,28
968,j1203,20110728,2361,2361,2375,2380,2375,2380,2379,19,18,14,3331000,42
969,j1203,20110729,2380,2379,2397,2398,2385,2385,2390,6,11,12,2868200,40
970,j1203,20110801,2385,2390,0,0,0,2390,2390,0,0,0,0,40
971,j1203,20110802,2390,2390,2377,2377,2377,2377,2377,-13,-13,4,950800,40
972,j1203,20110803,2377,2377,2385,2385,2385,2385,2385,8,8,12,2862000,40
973,j1203,20110804,2385,2385,2384,2404,2384,2403,2397,18,12,6,1438200,44
974,j1203,20110805,2403,2397,0,0,0,2397,2397,0,0,0,0,44
975,j1203,20110808,2397,2397,2393,2393,2393,2393,2393,-4,-4,2,478600,44
976,j1203,20110809,2393,2393,2343,2360,2343,2360,2351,-33,-42,8,1881200,42
977,j1203,20110810,2360,2351,2367,2367,2367,2367,2367,16,16,6,1420200,42
978,j1203,20110811,2367,2367,2380,2380,2380,2380,2380,13,13,2,476000,42
979,j1203,20110812,2380,2380,2380,2380,2380,2380,2380,0,0,2,476000,40
980,j1203,20110815,2380,2380,2380,2380,2380,2380,2380,0,0,2,476000,40
981,j1203,20110816,2380,2380,0,0,0,2380,2380,0,0,0,0,40
982,j1203,20110817,2380,2380,0,0,0,2380,2380,0,0,0,0,40
983,j1203,20110818,2380,2380,2349,2349,2323,2323,2337,-57,-43,8,1869800,38
984,j1203,20110819,2323,2337,2306,2306,2306,2306,2306,-31,-31,2,461200,36
985,j1203,20110822,2306,2306,0,0,0,2306,2306,0,0,0,0,36
986,j1203,20110823,2306,2306,2251,2262,2201,2201,2235,-105,-71,10,2235400,36
987,j1203,20110824,2201,2235,2238,2238,2221,2221,2231,-14,-4,6,1338800,36
988,j1203,20110825,2221,2231,2239,2248,2239,2248,2243,17,12,4,897400,38
989,j1203,20110826,2248,2243,2300,2300,2264,2264,2288,21,45,6,1372800,40
990,j1203,20110829,2264,2288,0,0,0,2288,2288,0,0,0,0,40
991,j1203,20110830,2288,2288,0,0,0,2288,2288,0,0,0,0,40
992,j1203,20110831,2288,2288,0,0,0,2288,2288,0,0,0,0,40
993,j1203,20110901,2288,2288,0,0,0,2288,2288,0,0,0,0,40
994,j1203,20110902,2288,2288,2288,2288,2288,2288,2288,0,0,18,4118400,22
995,j1203,20110905,2288,2288,0,0,0,2288,2288,0,0,0,0,22
996,j1203,20110906,2288,2288,0,0,0,2288,2288,0,0,0,0,22
997,j1203,20110907,2288,2288,0,0,0,2288,2288,0,0,0,0,22
998,j1203,20110908,2288,2288,0,0,0,2288,2288,0,0,0,0,22
999,j1203,20110909,2288,2288,0,0,0,2288,2288,0,0,0,0,22
1000,j1203,20110913,2288,2288,0,0,0,2288,2288,0,0,0,0,22
1001,j1203,20110914,2288,2288,0,0,0,2288,2288,0,0,0,0,22
1002,j1203,20110915,2288,2288,0,0,0,2288,2288,0,0,0,0,22
1003,j1203,20110916,2288,2288,0,0,0,2288,2288,0,0,0,0,22
1004,j1203,20110919,2288,2288,0,0,0,2288,2288,0,0,0,0,22
1005,j1203,20110920,2288,2288,0,0,0,2288,2288,0,0,0,0,22
1006,j1203,20110921,2288,2288,0,0,0,2288,2288,0,0,0,0,22
1007,j1203,20110922,2288,2288,2247,2247,2239,2239,2242,-49,-46,8,1794200,22
1008,j1203,20110923,2239,2242,2205,2220,2196,2196,2209,-46,-33,10,2209800,26
1009,j1203,20110926,2196,2209,2149,2163,2099,2099,2142,-110,-67,26,5571400,38
1010,j1203,20110927,2099,2142,2126,2137,2126,2137,2131,-5,-11,4,852600,38
1011,j1203,20110928,2137,2131,2122,2122,2119,2119,2120,-12,-11,4,848200,38
1012,j1203,20110929,2119,2120,2039,2048,2018,2018,2037,-102,-83,10,2037200,46
1013,j1203,20110930,2018,2037,0,0,0,2037,2037,0,0,0,0,46
1014,j1203,20111010,2037,2037,2052,2052,2052,2052,2052,15,15,2,410400,46
1015,j1203,20111011,2052,2052,2050,2053,2050,2053,2051,1,-1,4,820600,46
1016,j1203,20111012,2053,2051,2050,2050,2050,2050,2050,-1,-1,2,410000,46
1017,j1203,20111013,2050,2050,0,0,0,2050,2050,0,0,0,0,46
1018,j1203,20111014,2050,2050,0,0,0,2050,2050,0,0,0,0,46
1019,j1203,20111017,2050,2050,2022,2022,2022,2022,2022,-28,-28,2,404400,46
1020,j1203,20111018,2022,2022,1982,1985,1968,1976,1978,-46,-44,10,1978600,42
1021,j1203,20111019,1976,1978,2001,2001,1954,1954,1976,-24,-2,10,1976200,44
1022,j1203,20111020,1954,1976,1930,1930,1878,1878,1903,-98,-73,8,1522800,44
1023,j1203,20111021,1878,1903,1894,1908,1894,1908,1900,5,-3,8,1520600,40
1024,j1203,20111024,1908,1900,1935,1936,1935,1936,1935,36,35,4,774200,40
1025,j1203,20111025,1936,1935,1932,1973,1932,1973,1947,38,12,18,3505400,30
1026,j1203,20111026,1973,1947,1944,1954,1944,1954,1947,7,0,6,1168400,30
1027,j1203,20111027,1954,1947,1958,1960,1947,1948,1952,1,5,14,2732800,36
1028,j1203,20111028,1948,1952,0,0,0,1952,1952,0,0,0,0,36
1029,j1203,20111031,1952,1952,1959,1959,1947,1947,1953,-5,1,4,781200,36
1030,j1203,20111101,1947,1953,0,0,0,1953,1953,0,0,0,0,36
1031,j1203,20111102,1953,1953,1929,1937,1927,1937,1931,-16,-22,6,1158600,36
1032,j1203,20111103,1937,1931,0,0,0,1931,1931,0,0,0,0,36
1033,j1203,20111104,1931,1931,1935,1935,1935,1935,1935,4,4,2,387000,34
1034,j1203,20111107,1935,1935,0,0,0,1935,1935,0,0,0,0,34
1035,j1203,20111108,1935,1935,1965,1967,1950,1952,1959,17,24,14,2743600,36
1036,j1203,20111109,1952,1959,1941,1961,1941,1961,1951,2,-8,4,780400,36
1037,j1203,20111110,1961,1951,1951,2046,1934,1946,1963,-5,12,26,5106200,40
1038,j1203,20111111,1946,1963,1978,2050,1975,2020,2016,57,53,56,11292800,42
1039,j1203,20111114,2020,2016,2050,2051,2025,2026,2037,10,21,36,7334200,30
1040,j1203,20111115,2026,2037,2040,2057,2029,2029,2042,-8,5,18,3675800,28
1041,j1203,20111116,2029,2042,2013,2025,2004,2004,2012,-38,-30,18,3622000,22
1042,j1203,20111117,2004,2012,2024,2024,2024,2024,2024,12,12,2,404800,22
1043,j1203,20111118,2024,2024,0,0,0,2024,2024,0,0,0,0,22
1044,j1203,20111121,2024,2024,0,0,0,2024,2024,0,0,0,0,22
1045,j1203,20111122,2024,2024,2009,2009,2009,2009,2009,-15,-15,2,401800,24
1046,j1203,20111123,2009,2009,0,0,0,2009,2009,0,0,0,0,24
1047,j1203,20111124,2009,2009,1998,1998,1998,1998,1998,-11,-11,2,399600,26
1048,j1203,20111125,1998,1998,0,0,0,1998,1998,0,0,0,0,26
1049,j1203,20111128,1998,1998,0,0,0,1998,1998,0,0,0,0,26
1050,j1203,20111129,1998,1998,1996,1996,1963,1963,1979,-35,-19,4,791800,26
1051,j1203,20111130,1963,1979,1984,1984,1984,1984,1984,5,5,2,396800,24
1052,j1203,20111201,1984,1984,2021,2031,2014,2028,2023,44,39,8,1618800,22
1053,j1203,20111202,2028,2023,0,0,0,2023,2023,0,0,0,0,22
1054,j1203,20111205,2023,2023,0,0,0,2023,2023,0,0,0,0,22
1055,j1203,20111206,2023,2023,1949,2005,1949,1998,1994,-25,-29,32,6382200,8
1056,j1203,20111207,1998,1994,2004,2005,2004,2005,1999,11,5,6,1199600,6
1057,j1203,20111208,2005,1999,0,0,0,1999,1999,0,0,0,0,6
1058,j1203,20111209,1999,1999,1982,1982,1982,1982,1982,-17,-17,2,396400,6
1059,j1203,20111212,1982,1982,0,0,0,1982,1982,0,0,0,0,6
1060,j1203,20111213,1982,1982,1935,1935,1935,1935,1935,-47,-47,2,387000,4
1061,j1203,20111214,1935,1935,0,0,0,1935,1935,0,0,0,0,4
1062,j1203,20111215,1935,1935,0,0,0,1935,1935,0,0,0,0,4
1063,j1203,20111216,1935,1935,0,0,0,1935,1935,0,0,0,0,4
1064,j1203,20111219,1935,1935,0,0,0,1935,1935,0,0,0,0,4
1065,j1203,20111220,1935,1935,1983,1983,1983,1983,1983,48,48,2,396600,4
1066,j1203,20111221,1983,1983,0,0,0,1983,1978,0,-5,4,791400,4
1067,j1203,20111222,1983,1978,1979,1979,1978,1978,1978,0,0,4,791400,0
1068,j1203,20111223,1978,1978,0,0,0,1978,1978,0,0,0,0,0
1069,j1203,20111226,1978,1978,2000,2000,2000,2000,2000,22,22,2,400000,2
1070,j1203,20111227,2000,2000,0,0,0,2000,2000,0,0,0,0,2
1071,j1203,20111228,2000,2000,0,0,0,2000,2000,0,0,0,0,2
1072,j1203,20111229,2000,2000,1960,1960,1960,1960,1960,-40,-40,2,392000,0
1073,j1203,20111230,1960,1960,0,0,0,1960,1960,0,0,0,0,0
1074,j1204,20110418,2303,2345,2469,2469,2469,2469,2469,124,124,2,493800,4
1075,j1204,20110419,2469,2469,2411,2460,2411,2450,2435,-19,-34,12,2922800,2
1076,j1204,20110420,2450,2435,0,0,0,2435,2435,0,0,0,0,2
1077,j1204,20110421,2435,2435,0,0,0,2435,2435,0,0,0,0,2
1078,j1204,20110422,2435,2435,0,0,0,2435,2435,0,0,0,0,2
1079,j1204,20110425,2435,2435,0,0,0,2435,2435,0,0,0,0,2
1080,j1204,20110426,2435,2435,0,0,0,2435,2435,0,0,0,0,2
1081,j1204,20110427,2435,2435,0,0,0,2435,2435,0,0,0,0,2
1082,j1204,20110428,2435,2435,0,0,0,2435,2435,0,0,0,0,2
1083,j1204,20110429,2435,2435,0,0,0,2435,2435,0,0,0,0,2
1084,j1204,20110503,2435,2435,0,0,0,2435,2435,0,0,0,0,2
1085,j1204,20110504,2435,2435,0,0,0,2435,2435,0,0,0,0,2
1086,j1204,20110505,2435,2435,2339,2510,2338,2338,2395,-97,-40,6,1437400,4
1087,j1204,20110506,2338,2395,0,0,0,2395,2395,0,0,0,0,4
1088,j1204,20110509,2395,2395,0,0,0,2395,2395,0,0,0,0,4
1089,j1204,20110510,2395,2395,0,0,0,2395,2395,0,0,0,0,4
1090,j1204,20110511,2395,2395,0,0,0,2395,2395,0,0,0,0,4
1091,j1204,20110512,2395,2395,0,0,0,2395,2395,0,0,0,0,4
1092,j1204,20110513,2395,2395,2468,2500,2468,2481,2484,86,89,18,4472400,12
1093,j1204,20110516,2481,2484,2401,2452,2401,2452,2428,-32,-56,12,2914600,10
1094,j1204,20110517,2452,2428,0,0,0,2428,2428,0,0,0,0,10
1095,j1204,20110518,2428,2428,2401,2401,2401,2401,2401,-27,-27,2,480200,10
1096,j1204,20110519,2401,2401,2427,2497,2406,2406,2456,5,55,8,1965400,4
1097,j1204,20110520,2406,2456,0,0,0,2456,2456,0,0,0,0,4
1098,j1204,20110523,2456,2456,0,0,0,2456,2456,0,0,0,0,4
1099,j1204,20110524,2456,2456,0,0,0,2456,2456,0,0,0,0,4
1100,j1204,20110525,2456,2456,0,0,0,2456,2456,0,0,0,0,4
1101,j1204,20110526,2456,2456,0,0,0,2456,2456,0,0,0,0,4
1102,j1204,20110527,2456,2456,0,0,0,2456,2456,0,0,0,0,4
1103,j1204,20110530,2456,2456,0,0,0,2456,2456,0,0,0,0,4
1104,j1204,20110531,2456,2456,0,0,0,2456,2456,0,0,0,0,4
1105,j1204,20110601,2456,2456,2330,2330,2330,2330,2330,-126,-126,2,466000,6
1106,j1204,20110602,2330,2330,0,0,0,2330,2330,0,0,0,0,6
1107,j1204,20110603,2330,2330,2369,2403,2369,2403,2386,73,56,4,954400,4
1108,j1204,20110607,2403,2386,0,0,0,2386,2386,0,0,0,0,4
1109,j1204,20110608,2386,2386,0,0,0,2386,2386,0,0,0,0,4
1110,j1204,20110609,2386,2386,0,0,0,2386,2386,0,0,0,0,4
1111,j1204,20110610,2386,2386,0,0,0,2386,2386,0,0,0,0,4
1112,j1204,20110613,2386,2386,0,0,0,2386,2386,0,0,0,0,4
1113,j1204,20110614,2386,2386,0,0,0,2386,2386,0,0,0,0,4
1114,j1204,20110615,2386,2386,0,0,0,2386,2386,0,0,0,0,4
1115,j1204,20110616,2386,2386,0,0,0,2386,2386,0,0,0,0,4
1116,j1204,20110617,2386,2386,2351,2397,2351,2397,2374,11,-12,4,949600,4
1117,j1204,20110620,2397,2374,0,0,0,2374,2374,0,0,0,0,4
1118,j1204,20110621,2374,2374,0,0,0,2374,2374,0,0,0,0,4
1119,j1204,20110622,2374,2374,0,0,0,2374,2374,0,0,0,0,4
1120,j1204,20110623,2374,2374,0,0,0,2374,2374,0,0,0,0,4
1121,j1204,20110624,2374,2374,0,0,0,2374,2374,0,0,0,0,4
1122,j1204,20110627,2374,2374,0,0,0,2374,2374,0,0,0,0,4
1123,j1204,20110628,2374,2374,0,0,0,2374,2374,0,0,0,0,4
1124,j1204,20110629,2374,2374,0,0,0,2374,2374,0,0,0,0,4
1125,j1204,20110630,2374,2374,0,0,0,2374,2374,0,0,0,0,4
1126,j1204,20110701,2374,2374,0,0,0,2374,2374,0,0,0,0,4
1127,j1204,20110704,2374,2374,0,0,0,2374,2374,0,0,0,0,4
1128,j1204,20110705,2374,2374,0,0,0,2374,2374,0,0,0,0,4
1129,j1204,20110706,2374,2374,0,0,0,2374,2374,0,0,0,0,4
1130,j1204,20110707,2374,2374,0,0,0,2374,2374,0,0,0,0,4
1131,j1204,20110708,2374,2374,0,0,0,2374,2374,0,0,0,0,4
1132,j1204,20110711,2374,2374,0,0,0,2374,2374,0,0,0,0,4
1133,j1204,20110712,2374,2374,0,0,0,2374,2374,0,0,0,0,4
1134,j1204,20110713,2374,2374,2377,2377,2377,2377,2377,3,3,2,475400,4
1135,j1204,20110714,2377,2377,0,0,0,2377,2377,0,0,0,0,4
1136,j1204,20110715,2377,2377,0,0,0,2377,2377,0,0,0,0,4
1137,j1204,20110718,2377,2377,0,0,0,2377,2377,0,0,0,0,4
1138,j1204,20110719,2377,2377,0,0,0,2377,2377,0,0,0,0,4
1139,j1204,20110720,2377,2377,0,0,0,2377,2377,0,0,0,0,4
1140,j1204,20110721,2377,2377,0,0,0,2377,2377,0,0,0,0,4
1141,j1204,20110722,2377,2377,0,0,0,2377,2377,0,0,0,0,4
1142,j1204,20110725,2377,2377,0,0,0,2377,2377,0,0,0,0,4
1143,j1204,20110726,2377,2377,0,0,0,2377,2377,0,0,0,0,4
1144,j1204,20110727,2377,2377,0,0,0,2377,2377,0,0,0,0,4
1145,j1204,20110728,2377,2377,0,0,0,2377,2377,0,0,0,0,4
1146,j1204,20110729,2377,2377,0,0,0,2377,2377,0,0,0,0,4
1147,j1204,20110801,2377,2377,0,0,0,2377,2377,0,0,0,0,4
1148,j1204,20110802,2377,2377,0,0,0,2377,2377,0,0,0,0,4
1149,j1204,20110803,2377,2377,0,0,0,2377,2377,0,0,0,0,4
1150,j1204,20110804,2377,2377,0,0,0,2377,2377,0,0,0,0,4
1151,j1204,20110805,2377,2377,0,0,0,2377,2377,0,0,0,0,4
1152,j1204,20110808,2377,2377,2471,2519,2471,2519,2495,142,118,4,998000,4
1153,j1204,20110809,2519,2495,0,0,0,2495,2495,0,0,0,0,4
1154,j1204,20110810,2495,2495,0,0,0,2495,2495,0,0,0,0,4
1155,j1204,20110811,2495,2495,0,0,0,2495,2495,0,0,0,0,4
1156,j1204,20110812,2495,2495,0,0,0,2495,2495,0,0,0,0,4
1157,j1204,20110815,2495,2495,0,0,0,2495,2495,0,0,0,0,4
1158,j1204,20110816,2495,2495,0,0,0,2495,2495,0,0,0,0,4
1159,j1204,20110817,2495,2495,0,0,0,2495,2495,0,0,0,0,4
1160,j1204,20110818,2495,2495,2400,2400,2400,2400,2400,-95,-95,2,480000,4
1161,j1204,20110819,2400,2400,0,0,0,2400,2400,0,0,0,0,4
1162,j1204,20110822,2400,2400,0,0,0,2400,2400,0,0,0,0,4
1163,j1204,20110823,2400,2400,0,0,0,2400,2400,0,0,0,0,4
1164,j1204,20110824,2400,2400,0,0,0,2400,2400,0,0,0,0,4
1165,j1204,20110825,2400,2400,2257,2338,2257,2277,2283,-123,-117,8,1827000,0
1166,j1204,20110826,2277,2283,0,0,0,2283,2283,0,0,0,0,0
1167,j1204,20110829,2283,2283,0,0,0,2283,2283,0,0,0,0,0
1168,j1204,20110830,2283,2283,0,0,0,2283,2283,0,0,0,0,0
1169,j1204,20110831,2283,2283,0,0,0,2283,2283,0,0,0,0,0
1170,j1204,20110901,2283,2283,0,0,0,2283,2283,0,0,0,0,0
1171,j1204,20110902,2283,2283,0,0,0,2283,2283,0,0,0,0,0
1172,j1204,20110905,2283,2283,0,0,0,2283,2283,0,0,0,0,0
1173,j1204,20110906,2283,2283,0,0,0,2283,2283,0,0,0,0,0
1174,j1204,20110907,2283,2283,0,0,0,2283,2283,0,0,0,0,0
1175,j1204,20110908,2283,2283,0,0,0,2283,2283,0,0,0,0,0
1176,j1204,20110909,2283,2283,0,0,0,2283,2283,0,0,0,0,0
1177,j1204,20110913,2283,2283,0,0,0,2283,2283,0,0,0,0,0
1178,j1204,20110914,2283,2283,0,0,0,2283,2283,0,0,0,0,0
1179,j1204,20110915,2283,2283,0,0,0,2283,2283,0,0,0,0,0
1180,j1204,20110916,2283,2283,0,0,0,2283,2283,0,0,0,0,0
1181,j1204,20110919,2283,2283,0,0,0,2283,2283,0,0,0,0,0
1182,j1204,20110920,2283,2283,0,0,0,2283,2283,0,0,0,0,0
1183,j1204,20110921,2283,2283,0,0,0,2283,2283,0,0,0,0,0
1184,j1204,20110922,2283,2283,0,0,0,2283,2283,0,0,0,0,0
1185,j1204,20110923,2283,2283,0,0,0,2283,2283,0,0,0,0,0
1186,j1204,20110926,2283,2283,0,0,0,2283,2283,0,0,0,0,0
1187,j1204,20110927,2283,2283,0,0,0,2283,2283,0,0,0,0,0
1188,j1204,20110928,2283,2283,0,0,0,2283,2283,0,0,0,0,0
1189,j1204,20110929,2283,2283,0,0,0,2283,2283,0,0,0,0,0
1190,j1204,20110930,2283,2283,0,0,0,2283,2283,0,0,0,0,0
1191,j1204,20111010,2283,2283,0,0,0,2283,2283,0,0,0,0,0
1192,j1204,20111011,2283,2283,0,0,0,2283,2283,0,0,0,0,0
1193,j1204,20111012,2283,2283,0,0,0,2283,2283,0,0,0,0,0
1194,j1204,20111013,2283,2283,0,0,0,2283,2283,0,0,0,0,0
1195,j1204,20111014,2283,2283,0,0,0,2283,2283,0,0,0,0,0
1196,j1204,20111017,2283,2283,0,0,0,2283,2283,0,0,0,0,0
1197,j1204,20111018,2283,2283,0,0,0,2283,2283,0,0,0,0,0
1198,j1204,20111019,2283,2283,0,0,0,2283,2283,0,0,0,0,0
1199,j1204,20111020,2283,2283,0,0,0,2283,2283,0,0,0,0,0
1200,j1204,20111021,2283,2283,0,0,0,2283,2283,0,0,0,0,0
1201,j1204,20111024,2283,2283,0,0,0,2283,2283,0,0,0,0,0
1202,j1204,20111025,2283,2283,0,0,0,2283,2283,0,0,0,0,0
1203,j1204,20111026,2283,2283,0,0,0,2283,2283,0,0,0,0,0
1204,j1204,20111027,2283,2283,0,0,0,2283,2283,0,0,0,0,0
1205,j1204,20111028,2283,2283,0,0,0,2283,2283,0,0,0,0,0
1206,j1204,20111031,2283,2283,0,0,0,2283,2283,0,0,0,0,0
1207,j1204,20111101,2283,2283,0,0,0,2283,2283,0,0,0,0,0
1208,j1204,20111102,2283,2283,0,0,0,2283,2283,0,0,0,0,0
1209,j1204,20111103,2283,2283,0,0,0,2283,2283,0,0,0,0,0
1210,j1204,20111104,2283,2283,0,0,0,2283,2283,0,0,0,0,0
1211,j1204,20111107,2283,2283,0,0,0,2283,2283,0,0,0,0,0
1212,j1204,20111108,2283,2283,0,0,0,2283,2283,0,0,0,0,0
1213,j1204,20111109,2283,2283,0,0,0,2283,2283,0,0,0,0,0
1214,j1204,20111110,2283,2283,0,0,0,2283,2283,0,0,0,0,0
1215,j1204,20111111,2283,2283,0,0,0,2283,2283,0,0,0,0,0
1216,j1204,20111114,2283,2283,0,0,0,2283,2283,0,0,0,0,0
1217,j1204,20111115,2283,2283,0,0,0,2283,2283,0,0,0,0,0
1218,j1204,20111116,2283,2283,0,0,0,2283,2283,0,0,0,0,0
1219,j1204,20111117,2283,2283,0,0,0,2283,2283,0,0,0,0,0
1220,j1204,20111118,2283,2283,0,0,0,2283,2283,0,0,0,0,0
1221,j1204,20111121,2283,2283,0,0,0,2283,2283,0,0,0,0,0
1222,j1204,20111122,2283,2283,0,0,0,2283,2283,0,0,0,0,0
1223,j1204,20111123,2283,2283,0,0,0,2283,2283,0,0,0,0,0
1224,j1204,20111124,2283,2283,0,0,0,2283,2283,0,0,0,0,0
1225,j1204,20111125,2283,2283,0,0,0,2283,2283,0,0,0,0,0
1226,j1204,20111128,2283,2283,0,0,0,2283,2283,0,0,0,0,0
1227,j1204,20111129,2283,2283,0,0,0,2283,2283,0,0,0,0,0
1228,j1204,20111130,2283,2283,0,0,0,2283,2283,0,0,0,0,0
1229,j1204,20111201,2283,2283,0,0,0,2283,2283,0,0,0,0,0
1230,j1204,20111202,2283,2283,0,0,0,2283,2283,0,0,0,0,0
1231,j1204,20111205,2283,2283,0,0,0,2283,2283,0,0,0,0,0
1232,j1204,20111206,2283,2283,0,0,0,2283,2283,0,0,0,0,0
1233,j1204,20111207,2283,2283,0,0,0,2283,2283,0,0,0,0,0
1234,j1204,20111208,2283,2283,0,0,0,2283,2283,0,0,0,0,0
1235,j1204,20111209,2283,2283,0,0,0,2283,2283,0,0,0,0,0
1236,j1204,20111212,2283,2283,0,0,0,2283,2283,0,0,0,0,0
1237,j1204,20111213,2283,2283,0,0,0,2283,2283,0,0,0,0,0
1238,j1204,20111214,2283,2283,0,0,0,2283,2283,0,0,0,0,0
1239,j1204,20111215,2283,2283,0,0,0,2283,2283,0,0,0,0,0
1240,j1204,20111216,2283,2283,0,0,0,2283,2283,0,0,0,0,0
1241,j1204,20111219,2283,2283,0,0,0,2283,2283,0,0,0,0,0
1242,j1204,20111220,2283,2283,0,0,0,2283,2283,0,0,0,0,0
1243,j1204,20111221,2283,2283,0,0,0,2283,2283,0,0,0,0,0
1244,j1204,20111222,2283,2283,0,0,0,2283,2283,0,0,0,0,0
1245,j1204,20111223,2283,2283,0,0,0,2283,2283,0,0,0,0,0
1246,j1204,20111226,2283,2283,0,0,0,2283,2283,0,0,0,0,0
1247,j1204,20111227,2283,2283,0,0,0,2283,2283,0,0,0,0,0
1248,j1204,20111228,2283,2283,0,0,0,2283,2283,0,0,0,0,0
1249,j1204,20111229,2283,2283,0,0,0,2283,2283,0,0,0,0,0
1250,j1204,20111230,2283,2283,0,0,0,2283,2283,0,0,0,0,0
1251,j1205,20110518,2475,2472,2473,2473,2473,2473,2473,1,1,2,494600,4
1252,j1205,20110519,2473,2473,0,0,0,2473,2473,0,0,0,0,4
1253,j1205,20110520,2473,2473,0,0,0,2473,2473,0,0,0,0,4
1254,j1205,20110523,2473,2473,0,0,0,2473,2473,0,0,0,0,4
1255,j1205,20110524,2473,2473,0,0,0,2473,2473,0,0,0,0,4
1256,j1205,20110525,2473,2473,0,0,0,2473,2473,0,0,0,0,4
1257,j1205,20110526,2473,2473,0,0,0,2473,2473,0,0,0,0,4
1258,j1205,20110527,2473,2473,0,0,0,2473,2473,0,0,0,0,4
1259,j1205,20110530,2473,2473,0,0,0,2473,2473,0,0,0,0,4
1260,j1205,20110531,2473,2473,0,0,0,2473,2473,0,0,0,0,4
1261,j1205,20110601,2473,2473,0,0,0,2473,2473,0,0,0,0,4
1262,j1205,20110602,2473,2473,0,0,0,2473,2473,0,0,0,0,4
1263,j1205,20110603,2473,2473,0,0,0,2473,2473,0,0,0,0,4
1264,j1205,20110607,2473,2473,0,0,0,2473,2473,0,0,0,0,4
1265,j1205,20110608,2473,2473,0,0,0,2473,2473,0,0,0,0,4
1266,j1205,20110609,2473,2473,0,0,0,2473,2473,0,0,0,0,4
1267,j1205,20110610,2473,2473,0,0,0,2473,2473,0,0,0,0,4
1268,j1205,20110613,2473,2473,0,0,0,2473,2473,0,0,0,0,4
1269,j1205,20110614,2473,2473,0,0,0,2473,2473,0,0,0,0,4
1270,j1205,20110615,2473,2473,0,0,0,2473,2473,0,0,0,0,4
1271,j1205,20110616,2473,2473,0,0,0,2473,2473,0,0,0,0,4
1272,j1205,20110617,2473,2473,0,0,0,2473,2473,0,0,0,0,4
1273,j1205,20110620,2473,2473,0,0,0,2473,2473,0,0,0,0,4
1274,j1205,20110621,2473,2473,0,0,0,2473,2473,0,0,0,0,4
1275,j1205,20110622,2473,2473,0,0,0,2473,2473,0,0,0,0,4
1276,j1205,20110623,2473,2473,0,0,0,2473,2473,0,0,0,0,4
1277,j1205,20110624,2473,2473,0,0,0,2473,2473,0,0,0,0,4
1278,j1205,20110627,2473,2473,0,0,0,2473,2473,0,0,0,0,4
1279,j1205,20110628,2473,2473,0,0,0,2473,2473,0,0,0,0,4
1280,j1205,20110629,2473,2473,0,0,0,2473,2473,0,0,0,0,4
1281,j1205,20110630,2473,2473,0,0,0,2473,2473,0,0,0,0,4
1282,j1205,20110701,2473,2473,0,0,0,2473,2473,0,0,0,0,4
1283,j1205,20110704,2473,2473,0,0,0,2473,2473,0,0,0,0,4
1284,j1205,20110705,2473,2473,0,0,0,2473,2473,0,0,0,0,4
1285,j1205,20110706,2473,2473,0,0,0,2473,2473,0,0,0,0,4
1286,j1205,20110707,2473,2473,0,0,0,2473,2473,0,0,0,0,4
1287,j1205,20110708,2473,2473,0,0,0,2473,2473,0,0,0,0,4
1288,j1205,20110711,2473,2473,0,0,0,2473,2473,0,0,0,0,4
1289,j1205,20110712,2473,2473,0,0,0,2473,2473,0,0,0,0,4
1290,j1205,20110713,2473,2473,2410,2410,2410,2410,2410,-63,-63,2,482000,2
1291,j1205,20110714,2410,2410,0,0,0,2410,2410,0,0,0,0,2
1292,j1205,20110715,2410,2410,0,0,0,2410,2410,0,0,0,0,2
1293,j1205,20110718,2410,2410,0,0,0,2410,2410,0,0,0,0,2
1294,j1205,20110719,2410,2410,0,0,0,2410,2410,0,0,0,0,2
1295,j1205,20110720,2410,2410,2335,2335,2335,2335,2335,-75,-75,2,467000,2
1296,j1205,20110721,2335,2335,0,0,0,2335,2335,0,0,0,0,2
1297,j1205,20110722,2335,2335,0,0,0,2335,2335,0,0,0,0,2
1298,j1205,20110725,2335,2335,0,0,0,2335,2335,0,0,0,0,2
1299,j1205,20110726,2335,2335,0,0,0,2335,2335,0,0,0,0,2
1300,j1205,20110727,2335,2335,2399,2399,2399,2399,2399,64,64,2,479800,2
1301,j1205,20110728,2399,2399,0,0,0,2399,2399,0,0,0,0,2
1302,j1205,20110729,2399,2399,0,0,0,2399,2399,0,0,0,0,2
1303,j1205,20110801,2399,2399,0,0,0,2399,2399,0,0,0,0,2
1304,j1205,20110802,2399,2399,0,0,0,2399,2399,0,0,0,0,2
1305,j1205,20110803,2399,2399,0,0,0,2399,2399,0,0,0,0,2
1306,j1205,20110804,2399,2399,2416,2416,2416,2416,2416,17,17,2,483200,2
1307,j1205,20110805,2416,2416,2417,2417,2417,2417,2417,1,1,2,483400,2
1308,j1205,20110808,2417,2417,0,0,0,2417,2417,0,0,0,0,2
1309,j1205,20110809,2417,2417,0,0,0,2417,2417,0,0,0,0,2
1310,j1205,20110810,2417,2417,0,0,0,2417,2417,0,0,0,0,2
1311,j1205,20110811,2417,2417,0,0,0,2417,2417,0,0,0,0,2
1312,j1205,20110812,2417,2417,2352,2430,2352,2430,2391,13,-26,4,956400,2
1313,j1205,20110815,2430,2391,0,0,0,2391,2391,0,0,0,0,2
1314,j1205,20110816,2391,2391,2432,2432,2359,2359,2395,-32,4,4,958200,2
1315,j1205,20110817,2359,2395,0,0,0,2395,2395,0,0,0,0,2
1316,j1205,20110818,2395,2395,0,0,0,2395,2395,0,0,0,0,2
1317,j1205,20110819,2395,2395,0,0,0,2395,2395,0,0,0,0,2
1318,j1205,20110822,2395,2395,0,0,0,2395,2395,0,0,0,0,2
1319,j1205,20110823,2395,2395,2300,2310,2300,2310,2305,-85,-90,4,922000,4
1320,j1205,20110824,2310,2305,2328,2328,2251,2251,2289,-54,-16,4,915800,6
1321,j1205,20110825,2251,2289,2251,2298,2205,2290,2260,1,-29,26,5876000,18
1322,j1205,20110826,2290,2260,0,0,0,2260,2260,0,0,0,0,18
1323,j1205,20110829,2260,2260,0,0,0,2260,2260,0,0,0,0,18
1324,j1205,20110830,2260,2260,0,0,0,2260,2260,0,0,0,0,18
1325,j1205,20110831,2260,2260,2310,2310,2310,2310,2310,50,50,2,462000,18
1326,j1205,20110901,2310,2310,0,0,0,2310,2310,0,0,0,0,18
1327,j1205,20110902,2310,2310,0,0,0,2310,2310,0,0,0,0,18
1328,j1205,20110905,2310,2310,0,0,0,2310,2310,0,0,0,0,18
1329,j1205,20110906,2310,2310,2335,2335,2332,2332,2333,22,23,4,933400,22
1330,j1205,20110907,2332,2333,2391,2391,2337,2337,2371,4,38,46,10908600,28
1331,j1205,20110908,2337,2371,0,0,0,2371,2371,0,0,0,0,28
1332,j1205,20110909,2371,2371,2368,2368,2345,2345,2353,-26,-18,8,1882800,32
1333,j1205,20110913,2345,2353,2349,2349,2318,2329,2329,-24,-24,24,5590600,48
1334,j1205,20110914,2329,2329,2329,2331,2315,2323,2323,-6,-6,30,6970000,66
1335,j1205,20110915,2323,2323,2335,2339,2328,2330,2332,7,9,66,15397000,124
1336,j1205,20110916,2330,2332,2340,2342,2328,2342,2335,10,3,74,17281200,180
1337,j1205,20110919,2342,2335,2333,2334,2323,2323,2328,-12,-7,32,7452000,196
1338,j1205,20110920,2323,2328,2316,2323,2308,2317,2311,-11,-17,90,20800600,216
1339,j1205,20110921,2317,2311,2312,2340,2312,2334,2330,23,19,242,56389800,406
1340,j1205,20110922,2334,2330,2316,2316,2282,2282,2303,-48,-27,296,68177600,536
1341,j1205,20110923,2282,2303,2256,2265,2229,2230,2251,-73,-52,202,45489400,624
1342,j1205,20110926,2230,2251,2237,2237,2152,2165,2195,-86,-56,110,24145600,620
1343,j1205,20110927,2165,2195,2192,2195,2185,2186,2191,-9,-4,48,10519600,640
1344,j1205,20110928,2186,2191,2186,2194,2155,2168,2168,-23,-23,150,32521400,696
1345,j1205,20110929,2168,2168,2064,2099,2064,2089,2089,-79,-79,100,20897200,654
1346,j1205,20110930,2089,2089,2222,2222,2091,2105,2115,16,26,166,35113600,618
1347,j1205,20111010,2105,2115,2130,2135,2115,2119,2127,4,12,44,9361200,622
1348,j1205,20111011,2119,2127,2128,2142,2116,2116,2128,-11,1,30,6384200,632
1349,j1205,20111012,2116,2128,2083,2128,2083,2119,2112,-9,-16,62,13100400,614
1350,j1205,20111013,2119,2112,0,0,0,2112,2112,0,0,0,0,614
1351,j1205,20111014,2112,2112,2118,2128,2115,2120,2120,8,8,52,11025200,610
1352,j1205,20111017,2120,2120,2135,2135,2067,2075,2103,-45,-17,254,53428200,526
1353,j1205,20111018,2075,2103,2061,2063,2021,2021,2036,-82,-67,222,45200000,450
1354,j1205,20111019,2021,2036,2030,2034,1997,2006,2012,-30,-24,84,16907600,456
1355,j1205,20111020,2006,2012,1998,1998,1912,1917,1929,-95,-83,190,36660800,438
1356,j1205,20111021,1917,1929,1919,1950,1919,1940,1936,11,7,82,15876600,456
1357,j1205,20111024,1940,1936,1956,2004,1930,1990,1969,54,33,74,14573200,460
1358,j1205,20111025,1990,1969,1991,2023,1977,1990,1998,21,29,154,30774800,456
1359,j1205,20111026,1990,1998,1988,1999,1980,1991,1991,-7,-7,64,12747200,472
1360,j1205,20111027,1991,1991,1994,2006,1990,2006,1998,15,7,32,6395400,482
1361,j1205,20111028,2006,1998,2097,2097,2003,2013,2016,15,18,126,25412000,508
1362,j1205,20111031,2013,2016,1993,2013,1993,2000,2002,-16,-14,78,15621200,504
1363,j1205,20111101,2000,2002,1992,2013,1988,1990,1998,-12,-4,128,25578400,530
1364,j1205,20111102,1990,1998,1973,1989,1961,1989,1975,-9,-23,270,53328200,570
1365,j1205,20111103,1989,1975,1984,1984,1970,1973,1977,-2,2,70,13842200,600
1366,j1205,20111104,1973,1977,1980,2000,1977,2000,1989,23,12,284,56493600,698
1367,j1205,20111107,2000,1989,1987,1999,1987,1992,1994,3,5,102,20347200,684
1368,j1205,20111108,1992,1994,2005,2011,1998,2010,2007,16,13,144,28905000,730
1369,j1205,20111109,2010,2007,2025,2025,2003,2005,2011,-2,4,234,47068600,810
1370,j1205,20111110,2005,2011,1970,1988,1939,1972,1975,-39,-36,414,81776400,848
1371,j1205,20111111,1972,1975,1982,2073,1981,2065,2052,90,77,3002,616064000,1578
1372,j1205,20111114,2065,2052,2040,2092,2040,2056,2058,4,6,1468,302225600,1540
1373,j1205,20111115,2056,2058,2040,2096,2033,2070,2082,12,24,2102,437732200,2032
1374,j1205,20111116,2070,2082,2072,2081,2050,2051,2066,-31,-16,1442,297952400,2314
1375,j1205,20111117,2051,2066,2052,2073,2047,2064,2062,-2,-4,694,143152200,2296
1376,j1205,20111118,2064,2062,2060,2060,2039,2052,2050,-10,-12,378,77519600,2270
1377,j1205,20111121,2052,2050,2052,2066,2019,2032,2039,-18,-11,950,193797800,2142
1378,j1205,20111122,2032,2039,2025,2034,2021,2033,2025,-6,-14,436,88295200,2074
1379,j1205,20111123,2033,2025,2028,2034,2014,2014,2025,-11,0,382,77388400,2002
1380,j1205,20111124,2014,2025,2005,2019,1989,2014,2002,-11,-23,636,127349400,1740
1381,j1205,20111125,2014,2002,2012,2015,2000,2004,2005,2,3,210,42121000,1668
1382,j1205,20111128,2004,2005,2006,2021,1984,1994,1999,-11,-6,988,197553000,1812
1383,j1205,20111129,1994,1999,1992,2009,1990,2009,1997,10,-2,506,101087200,1820
1384,j1205,20111130,2009,1997,2003,2049,1999,2008,2020,11,23,2612,527674800,2506
1385,j1205,20111201,2008,2020,2043,2073,2030,2051,2050,31,30,3728,764312200,2176
1386,j1205,20111202,2051,2050,2043,2047,2038,2041,2042,-9,-8,1122,229200200,2054
1387,j1205,20111205,2041,2042,2046,2049,2036,2044,2041,2,-1,948,193579200,2012
1388,j1205,20111206,2044,2041,2041,2041,1983,2000,1998,-41,-43,5952,1189431000,3284
1389,j1205,20111207,2000,1998,2000,2003,1993,1999,1997,1,-1,2898,578961200,3290
1390,j1205,20111208,1999,1997,1988,2000,1976,1990,1990,-7,-7,3860,768341400,3804
1391,j1205,20111209,1990,1990,1988,2004,1980,1992,1995,2,5,3454,689379200,3620
1392,j1205,20111212,1992,1995,1998,1998,1956,1958,1973,-37,-22,5450,1075764400,5218
1393,j1205,20111213,1958,1973,1959,1964,1943,1961,1956,-12,-17,3816,746482200,5398
1394,j1205,20111214,1961,1956,1958,1960,1941,1949,1950,-7,-6,3496,681931600,5662
1395,j1205,20111215,1949,1950,1920,1936,1911,1926,1927,-24,-23,3964,763897600,5434
1396,j1205,20111216,1926,1927,1938,1970,1929,1968,1954,41,27,6900,1348920000,4566
1397,j1205,20111219,1968,1954,1970,1974,1953,1968,1964,14,10,5412,1063259000,4624
1398,j1205,20111220,1968,1964,1970,1986,1965,1974,1975,10,11,6080,1200900600,4184
1399,j1205,20111221,1974,1975,1985,1988,1974,1977,1980,2,5,3410,675398400,4242
1400,j1205,20111222,1977,1980,1976,1978,1959,1977,1969,-3,-11,3992,786210400,4086
1401,j1205,20111223,1977,1969,1977,1978,1968,1969,1972,0,3,3238,638813000,4466
1402,j1205,20111226,1969,1972,1972,1980,1951,1956,1966,-16,-6,6248,1228848000,4746
1403,j1205,20111227,1956,1966,1956,1962,1951,1956,1958,-10,-8,2290,448391800,4556
1404,j1205,20111228,1956,1958,1961,1993,1959,1983,1980,25,22,9040,1790696800,4170
1405,j1205,20111229,1983,1980,1973,1987,1972,1984,1981,4,1,3214,636770600,3808
1406,j1205,20111230,1984,1981,1991,2007,1987,2000,1998,19,17,5146,1028458000,3886
1407,j1206,20110617,2391,2391,0,0,0,2391,2391,0,0,0,0,0
1408,j1206,20110620,2391,2391,0,0,0,2391,2391,0,0,0,0,0
1409,j1206,20110621,2391,2391,0,0,0,2391,2391,0,0,0,0,0
1410,j1206,20110622,2391,2391,0,0,0,2391,2391,0,0,0,0,0
1411,j1206,20110623,2391,2391,0,0,0,2391,2391,0,0,0,0,0
1412,j1206,20110624,2391,2391,0,0,0,2391,2391,0,0,0,0,0
1413,j1206,20110627,2391,2391,0,0,0,2391,2391,0,0,0,0,0
1414,j1206,20110628,2391,2391,0,0,0,2391,2391,0,0,0,0,0
1415,j1206,20110629,2391,2391,0,0,0,2391,2391,0,0,0,0,0
1416,j1206,20110630,2391,2391,0,0,0,2391,2391,0,0,0,0,0
1417,j1206,20110701,2391,2391,0,0,0,2391,2391,0,0,0,0,0
1418,j1206,20110704,2391,2391,0,0,0,2391,2391,0,0,0,0,0
1419,j1206,20110705,2391,2391,0,0,0,2391,2391,0,0,0,0,0
1420,j1206,20110706,2391,2391,0,0,0,2391,2391,0,0,0,0,0
1421,j1206,20110707,2391,2391,0,0,0,2391,2391,0,0,0,0,0
1422,j1206,20110708,2391,2391,0,0,0,2391,2391,0,0,0,0,0
1423,j1206,20110711,2391,2391,0,0,0,2391,2391,0,0,0,0,0
1424,j1206,20110712,2391,2391,0,0,0,2391,2391,0,0,0,0,0
1425,j1206,20110713,2391,2391,0,0,0,2391,2391,0,0,0,0,0
1426,j1206,20110714,2391,2391,0,0,0,2391,2391,0,0,0,0,0
1427,j1206,20110715,2391,2391,0,0,0,2391,2391,0,0,0,0,0
1428,j1206,20110718,2391,2391,0,0,0,2391,2391,0,0,0,0,0
1429,j1206,20110719,2391,2391,0,0,0,2391,2391,0,0,0,0,0
1430,j1206,20110720,2391,2391,0,0,0,2391,2391,0,0,0,0,0
1431,j1206,20110721,2391,2391,0,0,0,2391,2391,0,0,0,0,0
1432,j1206,20110722,2391,2391,0,0,0,2391,2391,0,0,0,0,0
1433,j1206,20110725,2391,2391,0,0,0,2391,2391,0,0,0,0,0
1434,j1206,20110726,2391,2391,0,0,0,2391,2391,0,0,0,0,0
1435,j1206,20110727,2391,2391,0,0,0,2391,2391,0,0,0,0,0
1436,j1206,20110728,2391,2391,0,0,0,2391,2391,0,0,0,0,0
1437,j1206,20110729,2391,2391,0,0,0,2391,2391,0,0,0,0,0
1438,j1206,20110801,2391,2391,0,0,0,2391,2391,0,0,0,0,0
1439,j1206,20110802,2391,2391,0,0,0,2391,2391,0,0,0,0,0
1440,j1206,20110803,2391,2391,0,0,0,2391,2391,0,0,0,0,0
1441,j1206,20110804,2391,2391,0,0,0,2391,2391,0,0,0,0,0
1442,j1206,20110805,2391,2391,0,0,0,2391,2391,0,0,0,0,0
1443,j1206,20110808,2391,2391,0,0,0,2391,2391,0,0,0,0,0
1444,j1206,20110809,2391,2391,0,0,0,2391,2391,0,0,0,0,0
1445,j1206,20110810,2391,2391,0,0,0,2391,2391,0,0,0,0,0
1446,j1206,20110811,2391,2391,0,0,0,2391,2391,0,0,0,0,0
1447,j1206,20110812,2391,2391,0,0,0,2391,2391,0,0,0,0,0
1448,j1206,20110815,2391,2391,0,0,0,2391,2391,0,0,0,0,0
1449,j1206,20110816,2391,2391,0,0,0,2391,2391,0,0,0,0,0
1450,j1206,20110817,2391,2391,0,0,0,2391,2391,0,0,0,0,0
1451,j1206,20110818,2391,2391,0,0,0,2391,2391,0,0,0,0,0
1452,j1206,20110819,2391,2391,2257,2307,2257,2307,2282,-84,-109,4,912800,0
1453,j1206,20110822,2307,2282,2386,2392,2291,2376,2359,94,77,24,5661600,6
1454,j1206,20110823,2376,2359,2303,2303,2303,2303,2303,-56,-56,4,921200,6
1455,j1206,20110824,2303,2303,0,0,0,2303,2303,0,0,0,0,6
1456,j1206,20110825,2303,2303,0,0,0,2303,2303,0,0,0,0,6
1457,j1206,20110826,2303,2303,0,0,0,2303,2303,0,0,0,0,6
1458,j1206,20110829,2303,2303,0,0,0,2303,2303,0,0,0,0,6
1459,j1206,20110830,2303,2303,0,0,0,2303,2303,0,0,0,0,6
1460,j1206,20110831,2303,2303,0,0,0,2303,2303,0,0,0,0,6
1461,j1206,20110901,2303,2303,0,0,0,2303,2303,0,0,0,0,6
1462,j1206,20110902,2303,2303,0,0,0,2303,2303,0,0,0,0,6
1463,j1206,20110905,2303,2303,0,0,0,2303,2303,0,0,0,0,6
1464,j1206,20110906,2303,2303,0,0,0,2303,2303,0,0,0,0,6
1465,j1206,20110907,2303,2303,0,0,0,2303,2303,0,0,0,0,6
1466,j1206,20110908,2303,2303,0,0,0,2303,2303,0,0,0,0,6
1467,j1206,20110909,2303,2303,0,0,0,2303,2303,0,0,0,0,6
1468,j1206,20110913,2303,2303,0,0,0,2303,2303,0,0,0,0,6
1469,j1206,20110914,2303,2303,0,0,0,2303,2303,0,0,0,0,6
1470,j1206,20110915,2303,2303,0,0,0,2303,2303,0,0,0,0,6
1471,j1206,20110916,2303,2303,0,0,0,2303,2303,0,0,0,0,6
1472,j1206,20110919,2303,2303,0,0,0,2303,2303,0,0,0,0,6
1473,j1206,20110920,2303,2303,0,0,0,2303,2303,0,0,0,0,6
1474,j1206,20110921,2303,2303,0,0,0,2303,2303,0,0,0,0,6
1475,j1206,20110922,2303,2303,2384,2384,2276,2276,2330,-27,27,8,1864000,6
1476,j1206,20110923,2276,2330,0,0,0,2330,2330,0,0,0,0,6
1477,j1206,20110926,2330,2330,2299,2299,2288,2288,2293,-42,-37,4,917400,6
1478,j1206,20110927,2288,2293,0,0,0,2293,2293,0,0,0,0,6
1479,j1206,20110928,2293,2293,0,0,0,2293,2293,0,0,0,0,6
1480,j1206,20110929,2293,2293,2179,2179,2179,2179,2179,-114,-114,2,435800,6
1481,j1206,20110930,2179,2179,0,0,0,2179,2179,0,0,0,0,6
1482,j1206,20111010,2179,2179,0,0,0,2179,2179,0,0,0,0,6
1483,j1206,20111011,2179,2179,0,0,0,2179,2179,0,0,0,0,6
1484,j1206,20111012,2179,2179,0,0,0,2179,2179,0,0,0,0,6
1485,j1206,20111013,2179,2179,0,0,0,2179,2179,0,0,0,0,6
1486,j1206,20111014,2179,2179,0,0,0,2179,2179,0,0,0,0,6
1487,j1206,20111017,2179,2179,0,0,0,2179,2179,0,0,0,0,6
1488,j1206,20111018,2179,2179,2071,2071,2071,2071,2071,-108,-108,4,828400,10
1489,j1206,20111019,2071,2071,0,0,0,2071,2071,0,0,0,0,10
1490,j1206,20111020,2071,2071,1968,1968,1968,1968,1968,-103,-103,2,393600,10
1491,j1206,20111021,1968,1968,0,0,0,1968,1968,0,0,0,0,10
1492,j1206,20111024,1968,1968,0,0,0,1968,1968,0,0,0,0,10
1493,j1206,20111025,1968,1968,0,0,0,1968,1968,0,0,0,0,10
1494,j1206,20111026,1968,1968,0,0,0,1968,1968,0,0,0,0,10
1495,j1206,20111027,1968,1968,0,0,0,1968,1968,0,0,0,0,10
1496,j1206,20111028,1968,1968,0,0,0,1968,1968,0,0,0,0,10
1497,j1206,20111031,1968,1968,0,0,0,1968,1968,0,0,0,0,10
1498,j1206,20111101,1968,1968,0,0,0,1968,1968,0,0,0,0,10
1499,j1206,20111102,1968,1968,0,0,0,1968,1968,0,0,0,0,10
1500,j1206,20111103,1968,1968,0,0,0,1968,1968,0,0,0,0,10
1501,j1206,20111104,1968,1968,0,0,0,1968,1968,0,0,0,0,10
1502,j1206,20111107,1968,1968,0,0,0,1968,1968,0,0,0,0,10
1503,j1206,20111108,1968,1968,0,0,0,1968,1968,0,0,0,0,10
1504,j1206,20111109,1968,1968,2054,2054,1999,1999,2042,31,74,16,3267200,8
1505,j1206,20111110,1999,2042,0,0,0,2042,2042,0,0,0,0,8
1506,j1206,20111111,2042,2042,2050,2065,2050,2065,2057,23,15,10,2057000,14
1507,j1206,20111114,2065,2057,1997,2041,1997,2041,2019,-16,-38,4,807600,14
1508,j1206,20111115,2041,2019,0,0,0,2019,2019,0,0,0,0,14
1509,j1206,20111116,2019,2019,0,0,0,2019,2019,0,0,0,0,14
1510,j1206,20111117,2019,2019,0,0,0,2019,2019,0,0,0,0,14
1511,j1206,20111118,2019,2019,0,0,0,2019,2019,0,0,0,0,14
1512,j1206,20111121,2019,2019,0,0,0,2019,2019,0,0,0,0,14
1513,j1206,20111122,2019,2019,0,0,0,2019,2019,0,0,0,0,14
1514,j1206,20111123,2019,2019,0,0,0,2019,2019,0,0,0,0,14
1515,j1206,20111124,2019,2019,0,0,0,2019,2019,0,0,0,0,14
1516,j1206,20111125,2019,2019,0,0,0,2019,2019,0,0,0,0,14
1517,j1206,20111128,2019,2019,1949,1949,1949,1949,1949,-70,-70,2,389800,12
1518,j1206,20111129,1949,1949,0,0,0,1949,1949,0,0,0,0,12
1519,j1206,20111130,1949,1949,0,0,0,1949,1949,0,0,0,0,12
1520,j1206,20111201,1949,1949,0,0,0,1949,1949,0,0,0,0,12
1521,j1206,20111202,1949,1949,0,0,0,1949,1949,0,0,0,0,12
1522,j1206,20111205,1949,1949,0,0,0,1949,1949,0,0,0,0,12
1523,j1206,20111206,1949,1949,2000,2000,1993,1993,1996,44,47,4,798600,12
1524,j1206,20111207,1993,1996,0,0,0,1996,1996,0,0,0,0,12
1525,j1206,20111208,1996,1996,2009,2009,2009,2009,2009,13,13,2,401800,10
1526,j1206,20111209,2009,2009,2008,2008,2008,2008,2008,-1,-1,2,401600,8
1527,j1206,20111212,2008,2008,2005,2005,1981,1981,1998,-27,-10,10,1998600,8
1528,j1206,20111213,1981,1998,0,0,0,1998,1998,0,0,0,0,8
1529,j1206,20111214,1998,1998,0,0,0,1998,1998,0,0,0,0,8
1530,j1206,20111215,1998,1998,0,0,0,1998,1998,0,0,0,0,8
1531,j1206,20111216,1998,1998,1980,1980,1980,1980,1980,-18,-18,2,396000,8
1532,j1206,20111219,1980,1980,0,0,0,1980,1980,0,0,0,0,8
1533,j1206,20111220,1980,1980,0,0,0,1980,1980,0,0,0,0,8
1534,j1206,20111221,1980,1980,0,0,0,1980,1980,0,0,0,0,8
1535,j1206,20111222,1980,1980,0,0,0,1980,1980,0,0,0,0,8
1536,j1206,20111223,1980,1980,0,0,0,1980,1980,0,0,0,0,8
1537,j1206,20111226,1980,1980,0,0,0,1980,1980,0,0,0,0,8
1538,j1206,20111227,1980,1980,0,0,0,1980,1980,0,0,0,0,8
1539,j1206,20111228,1980,1980,2030,2030,2030,2030,2030,50,50,2,406000,6
1540,j1206,20111229,2030,2030,2033,2033,2033,2033,2033,3,3,6,1219800,12
1541,j1206,20111230,2033,2033,2043,2043,2030,2030,2035,-3,2,10,2035800,6
1542,j1207,20110718,2393,2393,0,0,0,2393,2393,0,0,0,0,0
1543,j1207,20110719,2393,2393,0,0,0,2393,2393,0,0,0,0,0
1544,j1207,20110720,2393,2393,0,0,0,2393,2393,0,0,0,0,0
1545,j1207,20110721,2393,2393,0,0,0,2393,2393,0,0,0,0,0
1546,j1207,20110722,2393,2393,0,0,0,2393,2393,0,0,0,0,0
1547,j1207,20110725,2393,2393,0,0,0,2393,2393,0,0,0,0,0
1548,j1207,20110726,2393,2393,0,0,0,2393,2393,0,0,0,0,0
1549,j1207,20110727,2393,2393,0,0,0,2393,2393,0,0,0,0,0
1550,j1207,20110728,2393,2393,0,0,0,2393,2393,0,0,0,0,0
1551,j1207,20110729,2393,2393,0,0,0,2393,2393,0,0,0,0,0
1552,j1207,20110801,2393,2393,0,0,0,2393,2393,0,0,0,0,0
1553,j1207,20110802,2393,2393,0,0,0,2393,2393,0,0,0,0,0
1554,j1207,20110803,2393,2393,0,0,0,2393,2393,0,0,0,0,0
1555,j1207,20110804,2393,2393,0,0,0,2393,2393,0,0,0,0,0
1556,j1207,20110805,2393,2393,0,0,0,2393,2393,0,0,0,0,0
1557,j1207,20110808,2393,2393,0,0,0,2393,2393,0,0,0,0,0
1558,j1207,20110809,2393,2393,0,0,0,2393,2393,0,0,0,0,0
1559,j1207,20110810,2393,2393,0,0,0,2393,2393,0,0,0,0,0
1560,j1207,20110811,2393,2393,0,0,0,2393,2393,0,0,0,0,0
1561,j1207,20110812,2393,2393,0,0,0,2393,2393,0,0,0,0,0
1562,j1207,20110815,2393,2393,0,0,0,2393,2393,0,0,0,0,0
1563,j1207,20110816,2393,2393,0,0,0,2393,2393,0,0,0,0,0
1564,j1207,20110817,2393,2393,0,0,0,2393,2393,0,0,0,0,0
1565,j1207,20110818,2393,2393,0,0,0,2393,2393,0,0,0,0,0
1566,j1207,20110819,2393,2393,2425,2425,2263,2263,2344,-130,-49,4,937600,0
1567,j1207,20110822,2263,2344,0,0,0,2344,2344,0,0,0,0,0
1568,j1207,20110823,2344,2344,0,0,0,2344,2344,0,0,0,0,0
1569,j1207,20110824,2344,2344,2250,2355,2250,2355,2308,11,-36,8,1847000,0
1570,j1207,20110825,2355,2308,0,0,0,2308,2308,0,0,0,0,0
1571,j1207,20110826,2308,2308,0,0,0,2308,2308,0,0,0,0,0
1572,j1207,20110829,2308,2308,0,0,0,2308,2308,0,0,0,0,0
1573,j1207,20110830,2308,2308,0,0,0,2308,2308,0,0,0,0,0
1574,j1207,20110831,2308,2308,0,0,0,2308,2308,0,0,0,0,0
1575,j1207,20110901,2308,2308,0,0,0,2308,2308,0,0,0,0,0
1576,j1207,20110902,2308,2308,0,0,0,2308,2308,0,0,0,0,0
1577,j1207,20110905,2308,2308,0,0,0,2308,2308,0,0,0,0,0
1578,j1207,20110906,2308,2308,0,0,0,2308,2308,0,0,0,0,0
1579,j1207,20110907,2308,2308,0,0,0,2308,2308,0,0,0,0,0
1580,j1207,20110908,2308,2308,0,0,0,2308,2308,0,0,0,0,0
1581,j1207,20110909,2308,2308,0,0,0,2308,2308,0,0,0,0,0
1582,j1207,20110913,2308,2308,0,0,0,2308,2308,0,0,0,0,0
1583,j1207,20110914,2308,2308,0,0,0,2308,2308,0,0,0,0,0
1584,j1207,20110915,2308,2308,0,0,0,2308,2308,0,0,0,0,0
1585,j1207,20110916,2308,2308,0,0,0,2308,2308,0,0,0,0,0
1586,j1207,20110919,2308,2308,0,0,0,2308,2308,0,0,0,0,0
1587,j1207,20110920,2308,2308,0,0,0,2308,2308,0,0,0,0,0
1588,j1207,20110921,2308,2308,0,0,0,2308,2308,0,0,0,0,0
1589,j1207,20110922,2308,2308,0,0,0,2308,2308,0,0,0,0,0
1590,j1207,20110923,2308,2308,0,0,0,2308,2308,0,0,0,0,0
1591,j1207,20110926,2308,2308,0,0,0,2308,2308,0,0,0,0,0
1592,j1207,20110927,2308,2308,2193,2263,2193,2263,2228,-45,-80,4,891200,0
1593,j1207,20110928,2263,2228,0,0,0,2228,2228,0,0,0,0,0
1594,j1207,20110929,2228,2228,0,0,0,2228,2228,0,0,0,0,0
1595,j1207,20110930,2228,2228,0,0,0,2228,2228,0,0,0,0,0
1596,j1207,20111010,2228,2228,0,0,0,2228,2228,0,0,0,0,0
1597,j1207,20111011,2228,2228,0,0,0,2228,2228,0,0,0,0,0
1598,j1207,20111012,2228,2228,0,0,0,2228,2228,0,0,0,0,0
1599,j1207,20111013,2228,2228,0,0,0,2228,2228,0,0,0,0,0
1600,j1207,20111014,2228,2228,0,0,0,2228,2228,0,0,0,0,0
1601,j1207,20111017,2228,2228,0,0,0,2228,2228,0,0,0,0,0
1602,j1207,20111018,2228,2228,2187,2187,2187,2187,2187,-41,-41,74,16183800,74
1603,j1207,20111019,2187,2187,2075,2075,2056,2056,2074,-131,-113,76,15766200,2
1604,j1207,20111020,2056,2074,1973,1973,1973,1973,1973,-101,-101,2,394600,2
1605,j1207,20111021,1973,1973,0,0,0,1973,1973,0,0,0,0,2
1606,j1207,20111024,1973,1973,2022,2068,2022,2045,2046,72,73,10,2046000,0
1607,j1207,20111025,2045,2046,0,0,0,2046,2046,0,0,0,0,0
1608,j1207,20111026,2046,2046,0,0,0,2046,2046,0,0,0,0,0
1609,j1207,20111027,2046,2046,0,0,0,2046,2046,0,0,0,0,0
1610,j1207,20111028,2046,2046,0,0,0,2046,2046,0,0,0,0,0
1611,j1207,20111031,2046,2046,0,0,0,2046,2046,0,0,0,0,0
1612,j1207,20111101,2046,2046,0,0,0,2046,2046,0,0,0,0,0
1613,j1207,20111102,2046,2046,0,0,0,2046,2046,0,0,0,0,0
1614,j1207,20111103,2046,2046,0,0,0,2046,2046,0,0,0,0,0
1615,j1207,20111104,2046,2046,0,0,0,2046,2046,0,0,0,0,0
1616,j1207,20111107,2046,2046,0,0,0,2046,2046,0,0,0,0,0
1617,j1207,20111108,2046,2046,0,0,0,2046,2046,0,0,0,0,0
1618,j1207,20111109,2046,2046,0,0,0,2046,2046,0,0,0,0,0
1619,j1207,20111110,2046,2046,0,0,0,2046,2046,0,0,0,0,0
1620,j1207,20111111,2046,2046,0,0,0,2046,2046,0,0,0,0,0
1621,j1207,20111114,2046,2046,0,0,0,2046,2046,0,0,0,0,0
1622,j1207,20111115,2046,2046,0,0,0,2046,2046,0,0,0,0,0
1623,j1207,20111116,2046,2046,0,0,0,2046,2046,0,0,0,0,0
1624,j1207,20111117,2046,2046,0,0,0,2046,2046,0,0,0,0,0
1625,j1207,20111118,2046,2046,0,0,0,2046,2046,0,0,0,0,0
1626,j1207,20111121,2046,2046,0,0,0,2046,2046,0,0,0,0,0
1627,j1207,20111122,2046,2046,0,0,0,2046,2046,0,0,0,0,0
1628,j1207,20111123,2046,2046,0,0,0,2046,2046,0,0,0,0,0
1629,j1207,20111124,2046,2046,0,0,0,2046,2046,0,0,0,0,0
1630,j1207,20111125,2046,2046,0,0,0,2046,2046,0,0,0,0,0
1631,j1207,20111128,2046,2046,0,0,0,2046,2046,0,0,0,0,0
1632,j1207,20111129,2046,2046,0,0,0,2046,2046,0,0,0,0,0
1633,j1207,20111130,2046,2046,1989,2053,1986,1991,2004,-55,-42,8,1603800,0
1634,j1207,20111201,1991,2004,0,0,0,2004,2004,0,0,0,0,0
1635,j1207,20111202,2004,2004,0,0,0,2004,2004,0,0,0,0,0
1636,j1207,20111205,2004,2004,0,0,0,2004,2004,0,0,0,0,0
1637,j1207,20111206,2004,2004,0,0,0,2004,2004,0,0,0,0,0
1638,j1207,20111207,2004,2004,0,0,0,2004,2004,0,0,0,0,0
1639,j1207,20111208,2004,2004,0,0,0,2004,2004,0,0,0,0,0
1640,j1207,20111209,2004,2004,0,0,0,2004,2004,0,0,0,0,0
1641,j1207,20111212,2004,2004,0,0,0,2004,2004,0,0,0,0,0
1642,j1207,20111213,2004,2004,0,0,0,2004,2004,0,0,0,0,0
1643,j1207,20111214,2004,2004,0,0,0,2004,2004,0,0,0,0,0
1644,j1207,20111215,2004,2004,1983,1983,1906,1943,1944,-61,-60,6,1166400,0
1645,j1207,20111216,1943,1944,0,0,0,1944,1944,0,0,0,0,0
1646,j1207,20111219,1944,1944,0,0,0,1944,1944,0,0,0,0,0
1647,j1207,20111220,1944,1944,0,0,0,1944,1944,0,0,0,0,0
1648,j1207,20111221,1944,1944,0,0,0,1944,1944,0,0,0,0,0
1649,j1207,20111222,1944,1944,0,0,0,1944,1944,0,0,0,0,0
1650,j1207,20111223,1944,1944,0,0,0,1944,1944,0,0,0,0,0
1651,j1207,20111226,1944,1944,1985,1985,1974,1974,1979,30,35,4,791800,0
1652,j1207,20111227,1974,1979,0,0,0,1979,1979,0,0,0,0,0
1653,j1207,20111228,1979,1979,0,0,0,1979,1979,0,0,0,0,0
1654,j1207,20111229,1979,1979,0,0,0,1979,1979,0,0,0,0,0
1655,j1207,20111230,1979,1979,0,0,0,1979,1979,0,0,0,0,0
1656,j1208,20110816,2380,2380,0,0,0,2380,2380,0,0,0,0,0
1657,j1208,20110817,2380,2380,0,0,0,2380,2380,0,0,0,0,0
1658,j1208,20110818,2380,2380,0,0,0,2380,2380,0,0,0,0,0
1659,j1208,20110819,2380,2380,0,0,0,2380,2380,0,0,0,0,0
1660,j1208,20110822,2380,2380,0,0,0,2380,2380,0,0,0,0,0
1661,j1208,20110823,2380,2380,0,0,0,2380,2380,0,0,0,0,0
1662,j1208,20110824,2380,2380,2240,2320,2240,2320,2281,-60,-99,8,1825000,0
1663,j1208,20110825,2320,2281,0,0,0,2281,2281,0,0,0,0,0
1664,j1208,20110826,2281,2281,0,0,0,2281,2281,0,0,0,0,0
1665,j1208,20110829,2281,2281,0,0,0,2281,2281,0,0,0,0,0
1666,j1208,20110830,2281,2281,0,0,0,2281,2281,0,0,0,0,0
1667,j1208,20110831,2281,2281,0,0,0,2281,2281,0,0,0,0,0
1668,j1208,20110901,2281,2281,0,0,0,2281,2281,0,0,0,0,0
1669,j1208,20110902,2281,2281,0,0,0,2281,2281,0,0,0,0,0
1670,j1208,20110905,2281,2281,0,0,0,2281,2281,0,0,0,0,0
1671,j1208,20110906,2281,2281,0,0,0,2281,2281,0,0,0,0,0
1672,j1208,20110907,2281,2281,0,0,0,2281,2281,0,0,0,0,0
1673,j1208,20110908,2281,2281,0,0,0,2281,2281,0,0,0,0,0
1674,j1208,20110909,2281,2281,0,0,0,2281,2281,0,0,0,0,0
1675,j1208,20110913,2281,2281,0,0,0,2281,2281,0,0,0,0,0
1676,j1208,20110914,2281,2281,0,0,0,2281,2281,0,0,0,0,0
1677,j1208,20110915,2281,2281,0,0,0,2281,2281,0,0,0,0,0
1678,j1208,20110916,2281,2281,0,0,0,2281,2281,0,0,0,0,0
1679,j1208,20110919,2281,2281,0,0,0,2281,2281,0,0,0,0,0
1680,j1208,20110920,2281,2281,0,0,0,2281,2281,0,0,0,0,0
1681,j1208,20110921,2281,2281,0,0,0,2281,2281,0,0,0,0,0
1682,j1208,20110922,2281,2281,2264,2395,2264,2395,2329,114,48,8,1863600,4
1683,j1208,20110923,2395,2329,0,0,0,2329,2329,0,0,0,0,4
1684,j1208,20110926,2329,2329,2213,2318,2213,2266,2252,-63,-77,86,19374600,6
1685,j1208,20110927,2266,2252,2240,2240,2240,2240,2240,-12,-12,2,448000,4
1686,j1208,20110928,2240,2240,0,0,0,2240,2240,0,0,0,0,4
1687,j1208,20110929,2240,2240,2128,2128,2128,2128,2128,-112,-112,4,851200,0
1688,j1208,20110930,2128,2128,0,0,0,2128,2128,0,0,0,0,0
1689,j1208,20111010,2128,2128,0,0,0,2128,2128,0,0,0,0,0
1690,j1208,20111011,2128,2128,0,0,0,2128,2128,0,0,0,0,0
1691,j1208,20111012,2128,2128,2119,2220,2119,2220,2169,92,41,4,867800,0
1692,j1208,20111013,2220,2169,2127,2170,2127,2154,2148,-15,-21,18,3867600,0
1693,j1208,20111014,2154,2148,0,0,0,2148,2148,0,0,0,0,0
1694,j1208,20111017,2148,2148,0,0,0,2148,2148,0,0,0,0,0
1695,j1208,20111018,2148,2148,0,0,0,2148,2148,0,0,0,0,0
1696,j1208,20111019,2148,2148,0,0,0,2148,2148,0,0,0,0,0
1697,j1208,20111020,2148,2148,2071,2071,2041,2041,2051,-107,-97,14,2871800,2
1698,j1208,20111021,2041,2051,2061,2061,2061,2061,2061,10,10,2,412200,2
1699,j1208,20111024,2061,2061,2071,2085,2004,2085,2040,24,-21,14,2857000,2
1700,j1208,20111025,2085,2040,0,0,0,2040,2040,0,0,0,0,2
1701,j1208,20111026,2040,2040,2083,2083,2070,2070,2076,30,36,4,830600,2
1702,j1208,20111027,2070,2076,2096,2096,2077,2091,2088,15,12,6,1252800,4
1703,j1208,20111028,2091,2088,0,0,0,2088,2088,0,0,0,0,4
1704,j1208,20111031,2088,2088,2103,2103,2090,2090,2096,2,8,4,838600,4
1705,j1208,20111101,2090,2096,2078,2078,2069,2069,2073,-27,-23,4,829400,4
1706,j1208,20111102,2069,2073,2063,2072,1977,2062,2045,-11,-28,22,4499000,4
1707,j1208,20111103,2062,2045,0,0,0,2045,2045,0,0,0,0,4
1708,j1208,20111104,2045,2045,2050,2050,2050,2050,2050,5,5,2,410000,4
1709,j1208,20111107,2050,2050,0,0,0,2050,2050,0,0,0,0,4
1710,j1208,20111108,2050,2050,0,0,0,2050,2050,0,0,0,0,4
1711,j1208,20111109,2050,2050,2022,2022,2022,2022,2022,-28,-28,2,404400,4
1712,j1208,20111110,2022,2022,0,0,0,2022,2022,0,0,0,0,4
1713,j1208,20111111,2022,2022,2049,2050,2049,2050,2049,28,27,6,1229600,10
1714,j1208,20111114,2050,2049,0,0,0,2049,2049,0,0,0,0,10
1715,j1208,20111115,2049,2049,0,0,0,2049,2049,0,0,0,0,10
1716,j1208,20111116,2049,2049,0,0,0,2049,2049,0,0,0,0,10
1717,j1208,20111117,2049,2049,0,0,0,2049,2049,0,0,0,0,10
1718,j1208,20111118,2049,2049,0,0,0,2049,2049,0,0,0,0,10
1719,j1208,20111121,2049,2049,0,0,0,2049,2049,0,0,0,0,10
1720,j1208,20111122,2049,2049,1960,1999,1960,1999,1973,-50,-76,6,1183800,10
1721,j1208,20111123,1999,1973,1974,1985,1974,1985,1981,12,8,6,1188800,8
1722,j1208,20111124,1985,1981,0,0,0,1981,1981,0,0,0,0,8
1723,j1208,20111125,1981,1981,0,0,0,1981,1981,0,0,0,0,8
1724,j1208,20111128,1981,1981,0,0,0,1981,1981,0,0,0,0,8
1725,j1208,20111129,1981,1981,1969,1969,1968,1968,1968,-13,-13,4,787400,8
1726,j1208,20111130,1968,1968,1989,1989,1989,1989,1989,21,21,2,397800,8
1727,j1208,20111201,1989,1989,0,0,0,1989,1989,0,0,0,0,8
1728,j1208,20111202,1989,1989,0,0,0,1989,1989,0,0,0,0,8
1729,j1208,20111205,1989,1989,0,0,0,1989,1989,0,0,0,0,8
1730,j1208,20111206,1989,1989,1985,1985,1985,1985,1985,-4,-4,2,397000,6
1731,j1208,20111207,1985,1985,0,0,0,1985,1985,0,0,0,0,6
1732,j1208,20111208,1985,1985,1968,1986,1968,1981,1978,-4,-7,6,1187000,2
1733,j1208,20111209,1981,1978,0,0,0,1978,1978,0,0,0,0,2
1734,j1208,20111212,1978,1978,1992,1992,1992,1992,1992,14,14,2,398400,2
1735,j1208,20111213,1992,1992,0,0,0,1992,1992,0,0,0,0,2
1736,j1208,20111214,1992,1992,0,0,0,1992,1992,0,0,0,0,2
1737,j1208,20111215,1992,1992,0,0,0,1992,1992,0,0,0,0,2
1738,j1208,20111216,1992,1992,0,0,0,1992,1992,0,0,0,0,2
1739,j1208,20111219,1992,1992,0,0,0,1992,1992,0,0,0,0,2
1740,j1208,20111220,1992,1992,0,0,0,1992,1992,0,0,0,0,2
1741,j1208,20111221,1992,1992,0,0,0,1992,1992,0,0,0,0,2
1742,j1208,20111222,1992,1992,0,0,0,1992,1992,0,0,0,0,2
1743,j1208,20111223,1992,1992,0,0,0,1992,1992,0,0,0,0,2
1744,j1208,20111226,1992,1992,0,0,0,1992,1992,0,0,0,0,2
1745,j1208,20111227,1992,1992,0,0,0,1992,1992,0,0,0,0,2
1746,j1208,20111228,1992,1992,2005,2057,1954,2057,2005,65,13,6,1203200,0
1747,j1208,20111229,2057,2005,0,0,0,2005,2005,0,0,0,0,0
1748,j1208,20111230,2005,2005,0,0,0,2005,2005,0,0,0,0,0
1749,j1209,20110919,2358,2358,2443,2443,2443,2443,2443,85,85,2,488600,4
1750,j1209,20110920,2443,2443,2330,2341,2325,2338,2334,-105,-109,16,3735000,14
1751,j1209,20110921,2338,2334,2347,2352,2345,2345,2347,11,13,10,2347400,20
1752,j1209,20110922,2345,2347,2338,2339,2318,2326,2334,-21,-13,28,6536800,8
1753,j1209,20110923,2326,2334,2326,2326,2282,2282,2304,-52,-30,4,921600,8
1754,j1209,20110926,2282,2304,2265,2269,2264,2269,2266,-35,-38,6,1359600,8
1755,j1209,20110927,2269,2266,2254,2254,2237,2237,2243,-29,-23,6,1346200,6
1756,j1209,20110928,2237,2243,2212,2212,2212,2212,2212,-31,-31,2,442400,8
1757,j1209,20110929,2212,2212,0,0,0,2212,2212,0,0,0,0,8
1758,j1209,20110930,2212,2212,0,0,0,2212,2212,0,0,0,0,8
1759,j1209,20111010,2212,2212,2197,2197,2186,2186,2193,-26,-19,6,1316000,6
1760,j1209,20111011,2186,2193,2201,2201,2201,2201,2201,8,8,2,440200,6
1761,j1209,20111012,2201,2201,0,0,0,2201,2201,0,0,0,0,6
1762,j1209,20111013,2201,2201,2246,2246,2177,2205,2208,4,7,42,9277400,8
1763,j1209,20111014,2205,2208,2200,2200,2187,2187,2193,-21,-15,4,877400,8
1764,j1209,20111017,2187,2193,2183,2183,2183,2183,2183,-10,-10,2,436600,8
1765,j1209,20111018,2183,2183,2111,2113,2107,2113,2109,-70,-74,10,2109800,10
1766,j1209,20111019,2113,2109,0,0,0,2109,2109,0,0,0,0,10
1767,j1209,20111020,2109,2109,2004,2022,2004,2004,2012,-105,-97,16,3220200,10
1768,j1209,20111021,2004,2012,2011,2023,2011,2023,2017,11,5,4,806800,10
1769,j1209,20111024,2023,2017,1996,1996,1992,1992,1994,-25,-23,6,1196800,14
1770,j1209,20111025,1992,1994,0,0,0,1994,1994,0,0,0,0,14
1771,j1209,20111026,1994,1994,0,0,0,1994,1994,0,0,0,0,14
1772,j1209,20111027,1994,1994,0,0,0,1994,1994,0,0,0,0,14
1773,j1209,20111028,1994,1994,2042,2065,2042,2060,2053,66,59,8,1642600,14
1774,j1209,20111031,2060,2053,2030,2030,2030,2030,2030,-23,-23,2,406000,14
1775,j1209,20111101,2030,2030,0,0,0,2030,2030,0,0,0,0,14
1776,j1209,20111102,2030,2030,2029,2029,2005,2015,2016,-15,-14,6,1209800,12
1777,j1209,20111103,2015,2016,0,0,0,2016,2016,0,0,0,0,12
1778,j1209,20111104,2016,2016,2001,2005,2000,2005,2000,-11,-16,40,8003400,36
1779,j1209,20111107,2005,2000,2003,2006,2000,2006,2003,6,3,18,3606600,46
1780,j1209,20111108,2006,2003,2007,2012,2006,2006,2009,3,6,8,1607400,50
1781,j1209,20111109,2006,2009,2020,2025,2007,2007,2015,-2,6,18,3627000,62
1782,j1209,20111110,2007,2015,1959,1994,1959,1973,1982,-42,-33,86,17047600,118
1783,j1209,20111111,1973,1982,1988,2057,1979,2055,2005,73,23,260,52143400,226
1784,j1209,20111114,2055,2005,2057,2057,2025,2038,2036,33,31,116,23619200,272
1785,j1209,20111115,2038,2036,2034,2063,2033,2039,2048,3,12,90,18439200,302
1786,j1209,20111116,2039,2048,2048,2048,2023,2027,2036,-21,-12,64,13033000,328
1787,j1209,20111117,2027,2036,2030,2041,2025,2040,2036,4,0,26,5293800,326
1788,j1209,20111118,2040,2036,2017,2029,2013,2025,2027,-11,-9,34,6893200,326
1789,j1209,20111121,2025,2027,2036,2036,2004,2012,2014,-15,-13,36,7251400,326
1790,j1209,20111122,2012,2014,2011,2015,2001,2002,2007,-12,-7,34,6825600,328
1791,j1209,20111123,2002,2007,2003,2010,2002,2002,2005,-5,-2,34,6820200,328
1792,j1209,20111124,2002,2005,1990,2006,1977,2000,1994,-5,-11,104,20741600,300
1793,j1209,20111125,2000,1994,1999,2000,1982,1993,1994,-1,0,50,9970000,282
1794,j1209,20111128,1993,1994,1986,2006,1975,1981,1990,-13,-4,68,13536000,278
1795,j1209,20111129,1981,1990,1985,1997,1985,1996,1994,6,4,30,5982400,258
1796,j1209,20111130,1996,1994,1987,2030,1986,1999,2007,5,13,78,15659200,256
1797,j1209,20111201,1999,2007,2035,2052,2028,2033,2038,26,31,84,17121600,262
1798,j1209,20111202,2033,2038,2025,2030,2025,2028,2027,-10,-11,20,4054200,258
1799,j1209,20111205,2028,2027,2035,2035,2023,2028,2026,1,-1,100,20263400,270
1800,j1209,20111206,2028,2026,2022,2022,1978,1996,1993,-30,-33,124,24714000,260
1801,j1209,20111207,1996,1993,1993,1996,1993,1993,1994,0,1,14,2791600,260
1802,j1209,20111208,1993,1994,1982,1997,1982,1997,1991,3,-3,70,13939000,208
1803,j1209,20111209,1997,1991,1997,2000,1995,2000,1997,9,6,36,7191200,202
1804,j1209,20111212,2000,1997,1996,1998,1983,1987,1991,-10,-6,52,10353400,180
1805,j1209,20111213,1987,1991,1988,2006,1983,2002,1999,11,8,42,8396200,162
1806,j1209,20111214,2002,1999,1995,1999,1994,1998,1996,-1,-3,30,5989400,154
1807,j1209,20111215,1998,1996,1983,1991,1978,1990,1984,-6,-12,90,17861000,110
1808,j1209,20111216,1990,1984,1990,2016,1990,2016,2004,32,20,30,6013600,102
1809,j1209,20111219,2016,2004,2018,2019,2006,2019,2014,15,10,40,8057600,110
1810,j1209,20111220,2019,2014,2027,2027,2010,2015,2016,1,2,10,2016800,106
1811,j1209,20111221,2015,2016,2023,2028,2017,2018,2020,2,4,18,3636000,102
1812,j1209,20111222,2018,2020,2003,2009,2003,2009,2005,-11,-15,16,3209400,98
1813,j1209,20111223,2009,2005,2016,2017,2011,2015,2014,10,9,12,2417400,100
1814,j1209,20111226,2015,2014,1995,2006,1995,2006,2000,-8,-14,44,8804200,98
1815,j1209,20111227,2006,2000,2001,2011,2001,2006,2003,6,3,12,2404200,100
1816,j1209,20111228,2006,2003,2010,2025,2010,2025,2020,22,17,32,6464800,104
1817,j1209,20111229,2025,2020,2020,2020,2018,2018,2018,-2,-2,10,2018400,100
1818,j1209,20111230,2018,2018,2030,2039,2030,2039,2034,21,16,28,5696200,102
1819,j1210,20111025,2026,2026,0,0,0,2026,2026,0,0,0,0,0
1820,j1210,20111026,2026,2026,0,0,0,2026,2026,0,0,0,0,0
1821,j1210,20111027,2026,2026,0,0,0,2026,2026,0,0,0,0,0
1822,j1210,20111028,2026,2026,0,0,0,2026,2026,0,0,0,0,0
1823,j1210,20111031,2026,2026,0,0,0,2026,2026,0,0,0,0,0
1824,j1210,20111101,2026,2026,0,0,0,2026,2026,0,0,0,0,0
1825,j1210,20111102,2026,2026,0,0,0,2026,2026,0,0,0,0,0
1826,j1210,20111103,2026,2026,0,0,0,2026,2026,0,0,0,0,0
1827,j1210,20111104,2026,2026,0,0,0,2026,2026,0,0,0,0,0
1828,j1210,20111107,2026,2026,0,0,0,2026,2026,0,0,0,0,0
1829,j1210,20111108,2026,2026,0,0,0,2026,2026,0,0,0,0,0
1830,j1210,20111109,2026,2026,0,0,0,2026,2026,0,0,0,0,0
1831,j1210,20111110,2026,2026,0,0,0,2026,2026,0,0,0,0,0
1832,j1210,20111111,2026,2026,0,0,0,2026,2026,0,0,0,0,0
1833,j1210,20111114,2026,2026,0,0,0,2026,2026,0,0,0,0,0
1834,j1210,20111115,2026,2026,0,0,0,2026,2026,0,0,0,0,0
1835,j1210,20111116,2026,2026,0,0,0,2026,2026,0,0,0,0,0
1836,j1210,20111117,2026,2026,0,0,0,2026,2026,0,0,0,0,0
1837,j1210,20111118,2026,2026,0,0,0,2026,2026,0,0,0,0,0
1838,j1210,20111121,2026,2026,0,0,0,2026,2026,0,0,0,0,0
1839,j1210,20111122,2026,2026,0,0,0,2026,2026,0,0,0,0,0
1840,j1210,20111123,2026,2026,0,0,0,2026,2026,0,0,0,0,0
1841,j1210,20111124,2026,2026,0,0,0,2026,2026,0,0,0,0,0
1842,j1210,20111125,2026,2026,0,0,0,2026,2026,0,0,0,0,0
1843,j1210,20111128,2026,2026,0,0,0,2026,2026,0,0,0,0,0
1844,j1210,20111129,2026,2026,1956,2020,1955,2019,1990,-7,-36,28,5574600,0
1845,j1210,20111130,2019,1990,0,0,0,1990,1990,0,0,0,0,0
1846,j1210,20111201,1990,1990,0,0,0,1990,1990,0,0,0,0,0
1847,j1210,20111202,1990,1990,0,0,0,1990,1990,0,0,0,0,0
1848,j1210,20111205,1990,1990,0,0,0,1990,1990,0,0,0,0,0
1849,j1210,20111206,1990,1990,0,0,0,1990,1990,0,0,0,0,0
1850,j1210,20111207,1990,1990,0,0,0,1990,1990,0,0,0,0,0
1851,j1210,20111208,1990,1990,0,0,0,1990,1990,0,0,0,0,0
1852,j1210,20111209,1990,1990,0,0,0,1990,1990,0,0,0,0,0
1853,j1210,20111212,1990,1990,0,0,0,1990,1990,0,0,0,0,0
1854,j1210,20111213,1990,1990,0,0,0,1990,1990,0,0,0,0,0
1855,j1210,20111214,1990,1990,0,0,0,1990,1990,0,0,0,0,0
1856,j1210,20111215,1990,1990,0,0,0,1990,1990,0,0,0,0,0
1857,j1210,20111216,1990,1990,0,0,0,1990,1990,0,0,0,0,0
1858,j1210,20111219,1990,1990,0,0,0,1990,1990,0,0,0,0,0
1859,j1210,20111220,1990,1990,0,0,0,1990,1990,0,0,0,0,0
1860,j1210,20111221,1990,1990,0,0,0,1990,1990,0,0,0,0,0
1861,j1210,20111222,1990,1990,0,0,0,1990,1990,0,0,0,0,0
1862,j1210,20111223,1990,1990,0,0,0,1990,1990,0,0,0,0,0
1863,j1210,20111226,1990,1990,0,0,0,1990,1990,0,0,0,0,0
1864,j1210,20111227,1990,1990,0,0,0,1990,1990,0,0,0,0,0
1865,j1210,20111228,1990,1990,0,0,0,1990,1990,0,0,0,0,0
1866,j1210,20111229,1990,1990,2048,2048,1979,1996,2007,6,17,6,1204600,2
1867,j1210,20111230,1996,2007,0,0,0,2007,2007,0,0,0,0,2
1868,j1211,20111116,2007,2007,0,0,0,2007,2007,0,0,0,0,0
1869,j1211,20111117,2007,2007,0,0,0,2007,2007,0,0,0,0,0
1870,j1211,20111118,2007,2007,0,0,0,2007,2007,0,0,0,0,0
1871,j1211,20111121,2007,2007,0,0,0,2007,2007,0,0,0,0,0
1872,j1211,20111122,2007,2007,0,0,0,2007,2007,0,0,0,0,0
1873,j1211,20111123,2007,2007,0,0,0,2007,2007,0,0,0,0,0
1874,j1211,20111124,2007,2007,0,0,0,2007,2007,0,0,0,0,0
1875,j1211,20111125,2007,2007,0,0,0,2007,2007,0,0,0,0,0
1876,j1211,20111128,2007,2007,0,0,0,2007,2007,0,0,0,0,0
1877,j1211,20111129,2007,2007,0,0,0,2007,2007,0,0,0,0,0
1878,j1211,20111130,2007,2007,0,0,0,2007,2007,0,0,0,0,0
1879,j1211,20111201,2007,2007,0,0,0,2007,2007,0,0,0,0,0
1880,j1211,20111202,2007,2007,0,0,0,2007,2007,0,0,0,0,0
1881,j1211,20111205,2007,2007,0,0,0,2007,2007,0,0,0,0,0
1882,j1211,20111206,2007,2007,0,0,0,2007,2007,0,0,0,0,0
1883,j1211,20111207,2007,2007,0,0,0,2007,2007,0,0,0,0,0
1884,j1211,20111208,2007,2007,0,0,0,2007,2007,0,0,0,0,0
1885,j1211,20111209,2007,2007,0,0,0,2007,2007,0,0,0,0,0
1886,j1211,20111212,2007,2007,0,0,0,2007,2007,0,0,0,0,0
1887,j1211,20111213,2007,2007,0,0,0,2007,2007,0,0,0,0,0
1888,j1211,20111214,2007,2007,0,0,0,2007,2007,0,0,0,0,0
1889,j1211,20111215,2007,2007,0,0,0,2007,2007,0,0,0,0,0
1890,j1211,20111216,2007,2007,0,0,0,2007,2007,0,0,0,0,0
1891,j1211,20111219,2007,2007,0,0,0,2007,2007,0,0,0,0,0
1892,j1211,20111220,2007,2007,0,0,0,2007,2007,0,0,0,0,0
1893,j1211,20111221,2007,2007,0,0,0,2007,2007,0,0,0,0,0
1894,j1211,20111222,2007,2007,0,0,0,2007,2007,0,0,0,0,0
1895,j1211,20111223,2007,2007,0,0,0,2007,2007,0,0,0,0,0
1896,j1211,20111226,2007,2007,2069,2069,2069,2069,2069,62,62,2,413800,2
1897,j1211,20111227,2069,2069,0,0,0,2069,2069,0,0,0,0,2
1898,j1211,20111228,2069,2069,0,0,0,2069,2069,0,0,0,0,2
1899,j1211,20111229,2069,2069,1980,1980,1980,1980,1980,-89,-89,2,396000,0
1900,j1211,20111230,1980,1980,0,0,0,1980,1980,0,0,0,0,0
1901,j1212,20111216,1999,1999,0,0,0,1999,1999,0,0,0,0,0
1902,j1212,20111219,1999,1999,0,0,0,1999,1999,0,0,0,0,0
1903,j1212,20111220,1999,1999,0,0,0,1999,1999,0,0,0,0,0
1904,j1212,20111221,1999,1999,0,0,0,1999,1999,0,0,0,0,0
1905,j1212,20111222,1999,1999,0,0,0,1999,1999,0,0,0,0,0
1906,j1212,20111223,1999,1999,0,0,0,1999,1999,0,0,0,0,0
1907,j1212,20111226,1999,1999,0,0,0,1999,1999,0,0,0,0,0
1908,j1212,20111227,1999,1999,0,0,0,1999,1999,0,0,0,0,0
1909,j1212,20111228,1999,1999,0,0,0,1999,1999,0,0,0,0,0
1910,j1212,20111229,1999,1999,0,0,0,1999,1999,0,0,0,0,0
1911,j1212,20111230,1999,1999,0,0,0,1999,1999,0,0,0,0,0
