ROWNUM,合约,日期,前收盘价,前结算价,开盘价,最高价,最低价,收盘价,结算价,涨跌1,涨跌2,成交量,成交金额,持仓量
1,cs1701,20170103,1762,1756,1794,1803,1743,1796,1791,40,35,794,14222060,5236
2,cs1701,20170104,1796,1791,1790,1828,1790,1823,1818,32,27,1546,28121080,4218
3,cs1701,20170105,1823,1818,1820,1821,1807,1811,1813,-7,-5,920,16683920,3658
4,cs1701,20170106,1811,1813,1751,1751,1746,1746,1746,-67,-67,240,4192400,3418
5,cs1701,20170109,1746,1746,0,0,0,1750,1750,4,4,0,0,3418
6,cs1701,20170110,1750,1750,0,0,0,1750,1750,0,0,0,0,3418
7,cs1701,20170111,1750,1750,1750,1750,1750,1750,1750,0,0,324,5670000,3154
8,cs1701,20170112,1750,1750,0,0,0,1750,1750,0,0,0,0,3154
9,cs1701,20170113,1750,1750,0,0,0,1757,1757,7,7,0,0,3154
10,cs1701,20170116,1757,1757,1855,1859,1855,1859,1802,102,45,56,1039900,0
11,cs1703,20170103,1818,1818,1788,1788,1788,1788,1788,-30,-30,2,35760,102
12,cs1703,20170104,1788,1788,1809,1810,1809,1810,1809,22,21,4,72380,102
13,cs1703,20170105,1810,1809,1828,1828,1828,1828,1828,19,19,2,36560,104
14,cs1703,20170106,1828,1828,1818,1818,1818,1818,1818,-10,-10,2,36360,102
15,cs1703,20170109,1818,1818,0,0,0,1818,1818,0,0,0,0,102
16,cs1703,20170110,1818,1818,0,0,0,1818,1818,0,0,0,0,102
17,cs1703,20170111,1818,1818,0,0,0,1818,1818,0,0,0,0,102
18,cs1703,20170112,1818,1818,1816,1816,1777,1780,1779,-38,-39,122,2170900,102
19,cs1703,20170113,1780,1779,1810,1810,1810,1810,1810,31,31,2,36200,104
20,cs1703,20170116,1810,1810,1822,1899,1822,1845,1845,35,35,42,775180,88
21,cs1703,20170117,1845,1845,1851,1851,1840,1840,1845,-5,0,18,332140,80
22,cs1703,20170118,1840,1845,1850,1850,1850,1850,1850,5,5,20,370000,80
23,cs1703,20170119,1850,1850,1860,1860,1823,1823,1851,-27,1,32,592380,88
24,cs1703,20170120,1823,1851,1829,1830,1769,1804,1801,-47,-50,106,1910100,84
25,cs1703,20170123,1804,1801,1801,1801,1799,1799,1800,-2,-1,4,72000,82
26,cs1703,20170124,1799,1800,0,0,0,1800,1800,0,0,0,0,82
27,cs1703,20170125,1800,1800,1800,1800,1800,1800,1800,0,0,2,36000,82
28,cs1703,20170126,1800,1800,1676,1818,1676,1818,1773,18,-27,22,390120,78
29,cs1703,20170203,1818,1773,1802,1802,1802,1802,1802,29,29,8,144160,80
30,cs1703,20170206,1802,1802,1803,1820,1800,1815,1808,13,6,14,253180,88
31,cs1703,20170207,1815,1808,1809,1809,1770,1798,1789,-10,-19,8,143120,86
32,cs1703,20170208,1798,1789,1790,1790,1790,1790,1790,1,1,2,35800,86
33,cs1703,20170209,1790,1790,1773,1789,1773,1789,1780,-1,-10,6,106820,82
34,cs1703,20170210,1789,1780,1754,1755,1753,1754,1754,-26,-26,30,526240,70
35,cs1703,20170213,1754,1754,1765,1780,1750,1765,1765,11,11,24,423700,66
36,cs1703,20170214,1765,1765,1720,1767,1720,1767,1744,2,-21,24,418760,64
37,cs1703,20170215,1767,1744,1726,1732,1726,1730,1726,-14,-18,22,379920,60
38,cs1703,20170216,1730,1726,0,0,0,1726,1726,0,0,0,0,60
39,cs1703,20170217,1726,1726,1721,1760,1720,1722,1733,-4,7,34,589540,56
40,cs1703,20170220,1722,1733,1726,1780,1726,1747,1749,14,16,18,314980,56
41,cs1703,20170221,1747,1749,1743,1751,1743,1751,1746,2,-3,6,104780,50
42,cs1703,20170222,1751,1746,1776,1780,1676,1777,1767,31,21,80,1413660,56
43,cs1703,20170223,1777,1767,1767,1818,1723,1755,1765,-12,-2,14,247160,50
44,cs1703,20170224,1755,1765,1713,1713,1713,1713,1713,-52,-52,2,34260,50
45,cs1703,20170227,1713,1713,1718,1750,1718,1750,1744,37,31,14,244240,50
46,cs1703,20170228,1750,1744,1750,1825,1750,1750,1764,6,20,32,564620,50
47,cs1703,20170301,1750,1764,0,0,0,1764,1764,0,0,0,0,50
48,cs1703,20170302,1764,1764,0,0,0,1764,1764,0,0,0,0,50
49,cs1703,20170303,1764,1764,0,0,0,1764,1764,0,0,0,0,34
50,cs1703,20170306,1764,1764,0,0,0,1764,1764,0,0,0,0,34
51,cs1703,20170307,1764,1764,0,0,0,1764,1764,0,0,0,0,34
52,cs1703,20170308,1764,1764,1800,1800,1800,1800,1800,36,36,16,288000,34
53,cs1703,20170309,1800,1800,1800,1800,1800,1800,1800,0,0,16,288000,34
54,cs1703,20170310,1800,1800,0,0,0,1800,1800,0,0,0,0,34
55,cs1703,20170313,1800,1800,0,0,0,1800,1800,0,0,0,0,34
56,cs1703,20170314,1800,1800,0,0,0,1800,1800,0,0,0,0,0
57,cs1705,20170103,1786,1792,1792,1807,1786,1787,1794,-5,2,410250,7363821460,928016
58,cs1705,20170104,1787,1794,1791,1820,1783,1809,1806,15,12,615022,11108894580,955736
59,cs1705,20170105,1809,1806,1820,1820,1795,1796,1805,-10,-1,356650,6440936840,948400
60,cs1705,20170106,1796,1805,1797,1806,1765,1772,1782,-33,-23,670658,11956801240,988630
61,cs1705,20170109,1772,1782,1770,1777,1758,1772,1766,-10,-16,528748,9342525740,1001732
62,cs1705,20170110,1772,1766,1772,1779,1759,1764,1767,-2,1,407348,7198791300,1018526
63,cs1705,20170111,1764,1767,1774,1786,1765,1767,1773,0,6,653968,11596828060,1070534
64,cs1705,20170112,1767,1773,1766,1777,1754,1769,1765,-4,-8,566408,10000498200,1091714
65,cs1705,20170113,1769,1765,1780,1805,1773,1786,1789,21,24,758766,13577289420,1113636
66,cs1705,20170116,1786,1789,1793,1824,1786,1817,1811,28,22,714944,12948171660,1080816
67,cs1705,20170117,1817,1811,1820,1834,1802,1812,1818,1,7,489240,8895517880,1046472
68,cs1705,20170118,1812,1818,1822,1841,1813,1837,1827,19,9,566600,10352205160,1091112
69,cs1705,20170119,1837,1827,1840,1848,1823,1829,1832,2,5,617754,11318921960,1140512
70,cs1705,20170120,1829,1832,1828,1830,1809,1817,1817,-15,-15,528488,9603784640,1152356
71,cs1705,20170123,1817,1817,1820,1845,1820,1838,1833,21,16,444362,8145910140,1141908
72,cs1705,20170124,1838,1833,1839,1850,1815,1820,1831,-13,-2,495314,9072536140,1112070
73,cs1705,20170125,1820,1831,1815,1817,1799,1804,1804,-27,-27,407814,7358891540,1098664
74,cs1705,20170126,1804,1804,1812,1814,1799,1801,1804,-3,0,185246,3342298320,1076382
75,cs1705,20170203,1801,1804,1801,1831,1801,1825,1820,21,16,417846,7608823700,1066050
76,cs1705,20170206,1825,1820,1830,1875,1826,1859,1851,39,31,896806,16607561200,1159790
77,cs1705,20170207,1859,1851,1860,1863,1845,1846,1853,-5,2,426008,7896947200,1192018
78,cs1705,20170208,1846,1853,1855,1863,1850,1855,1856,2,3,356562,6618348820,1206324
79,cs1705,20170209,1855,1856,1860,1874,1834,1835,1855,-21,-1,659802,12241586720,1251528
80,cs1705,20170210,1835,1855,1835,1851,1826,1844,1840,-11,-15,457054,8410933580,1237274
81,cs1705,20170213,1844,1840,1854,1863,1841,1846,1853,6,13,515722,9559736560,1252342
82,cs1705,20170214,1846,1853,1850,1852,1817,1817,1829,-36,-24,605210,11073901500,1277736
83,cs1705,20170215,1817,1829,1812,1826,1802,1804,1814,-25,-15,425546,7721982500,1250702
84,cs1705,20170216,1804,1814,1811,1827,1807,1812,1817,-2,3,435244,7908385140,1212272
85,cs1705,20170217,1812,1817,1810,1816,1787,1796,1799,-21,-18,541362,9740867080,1176284
86,cs1705,20170220,1796,1799,1797,1825,1796,1823,1814,24,15,508098,9216938420,1151146
87,cs1705,20170221,1823,1814,1827,1851,1825,1834,1839,20,25,563132,10359848680,1060258
88,cs1705,20170222,1834,1839,1834,1859,1830,1857,1846,18,7,534710,9875587440,1039750
89,cs1705,20170223,1857,1846,1855,1870,1842,1854,1856,8,10,529260,9823792240,973502
90,cs1705,20170224,1854,1856,1848,1886,1840,1885,1870,29,14,792442,14825468760,1010124
91,cs1705,20170227,1885,1870,1892,1922,1892,1914,1910,44,40,663696,12682756600,952646
92,cs1705,20170228,1914,1910,1915,1932,1904,1919,1915,9,5,487228,9334656320,917616
93,cs1705,20170301,1919,1915,1926,1930,1907,1917,1916,2,1,369660,7084448820,895854
94,cs1705,20170302,1917,1916,1931,1942,1913,1919,1927,3,11,377594,7278038240,869806
95,cs1705,20170303,1919,1927,1911,1921,1893,1920,1908,-7,-19,391460,7469193640,839912
96,cs1705,20170306,1920,1908,1926,1952,1926,1933,1938,25,30,485696,9413677920,839024
97,cs1705,20170307,1933,1938,1932,1935,1917,1926,1926,-12,-12,323164,6226949020,822230
98,cs1705,20170308,1926,1926,1916,1920,1872,1904,1896,-22,-30,651134,12347705000,707432
99,cs1705,20170309,1904,1896,1895,1907,1882,1901,1898,5,2,421028,7992585000,695384
100,cs1705,20170310,1901,1898,1906,1906,1873,1879,1885,-19,-13,415884,7840113520,670830
101,cs1705,20170313,1879,1885,1877,1899,1861,1898,1882,13,-3,279412,5260392880,646234
102,cs1705,20170314,1898,1882,1892,1921,1875,1880,1904,-2,22,466692,8888138420,606792
103,cs1705,20170315,1880,1904,1891,1903,1878,1900,1892,-4,-12,293444,5553310800,597706
104,cs1705,20170316,1900,1892,1905,1925,1876,1880,1901,-12,9,478094,9090916640,589666
105,cs1705,20170317,1880,1901,1880,1887,1864,1865,1873,-36,-28,337990,6331123460,564110
106,cs1705,20170320,1865,1873,1883,1894,1873,1885,1884,12,11,287032,5409466540,537814
107,cs1705,20170321,1885,1884,1881,1907,1881,1900,1895,16,11,297536,5638572460,514824
108,cs1705,20170322,1900,1895,1905,1916,1890,1911,1904,16,9,306938,5845639940,487824
109,cs1705,20170323,1911,1904,1901,1913,1871,1885,1889,-19,-15,250014,4722857260,441456
110,cs1705,20170324,1885,1889,1888,1918,1888,1910,1902,21,13,179538,3415894820,390936
111,cs1705,20170327,1910,1902,1918,1927,1892,1903,1907,1,5,184026,3509515120,319962
112,cs1705,20170328,1903,1907,1904,1912,1892,1905,1900,-2,-7,95496,1815328320,291712
113,cs1705,20170329,1905,1900,1903,1911,1875,1886,1892,-14,-8,124660,2359599040,250762
114,cs1705,20170330,1886,1892,1891,1897,1886,1891,1892,-1,0,52836,999704980,228258
115,cs1705,20170331,1891,1892,1892,1916,1889,1909,1905,17,13,69224,1318794180,204980
116,cs1705,20170405,1909,1905,1916,1925,1902,1923,1914,18,9,51338,982671020,190242
117,cs1705,20170406,1923,1914,1926,1932,1887,1907,1905,-7,-9,79100,1507296540,169634
118,cs1705,20170407,1907,1905,1898,1914,1886,1886,1899,-19,-6,50478,958932080,147936
119,cs1705,20170410,1886,1899,1895,1899,1885,1892,1893,-7,-6,31850,603196640,142240
120,cs1705,20170411,1892,1893,1891,1901,1875,1886,1889,-7,-4,54096,1021957720,120250
121,cs1705,20170412,1886,1889,1880,1899,1874,1894,1889,5,0,29890,564864860,110284
122,cs1705,20170413,1894,1889,1894,1899,1888,1892,1893,3,4,19800,374928380,102128
123,cs1705,20170414,1892,1893,1894,1899,1889,1893,1894,0,1,18622,352736740,89038
124,cs1705,20170417,1893,1894,1895,1898,1889,1893,1892,-1,-2,23258,440151420,71654
125,cs1705,20170418,1893,1892,1893,1894,1890,1891,1892,-1,0,11208,212094500,62686
126,cs1705,20170419,1891,1892,1893,1894,1874,1878,1884,-14,-8,14008,264046960,54852
127,cs1705,20170420,1878,1884,1879,1896,1879,1895,1887,11,3,11426,215674660,46238
128,cs1705,20170421,1895,1887,1894,1910,1894,1909,1904,22,17,12336,234878240,38558
129,cs1705,20170424,1909,1904,1900,1902,1883,1888,1891,-16,-13,10744,203261600,35086
130,cs1705,20170425,1888,1891,1900,1900,1862,1864,1869,-27,-22,10504,196329560,28218
131,cs1705,20170426,1864,1869,1867,1872,1861,1866,1867,-3,-2,7104,132680020,22634
132,cs1705,20170427,1866,1867,1867,1869,1847,1848,1855,-19,-12,5420,100584460,18904
133,cs1705,20170428,1848,1855,1854,1858,1796,1805,1817,-50,-38,14266,259320540,7874
134,cs1705,20170502,1805,1817,1878,1878,1800,1835,1822,18,5,700,12755700,6796
135,cs1705,20170503,1835,1822,1837,1858,1815,1818,1852,-4,30,1118,20716480,6574
136,cs1705,20170504,1818,1852,1846,1846,1842,1842,1843,-10,-9,322,5936920,5854
137,cs1705,20170505,1842,1843,1850,1855,1840,1848,1851,5,8,1340,24804900,5988
138,cs1705,20170508,1848,1851,1853,1853,1828,1850,1848,-1,-3,1988,36750660,5898
139,cs1705,20170509,1850,1848,1850,1850,1829,1840,1845,-8,-3,624,11518020,5274
140,cs1705,20170510,1840,1845,1847,1852,1820,1820,1846,-25,1,1620,29918320,3954
141,cs1705,20170511,1820,1846,1840,1849,1840,1848,1845,2,-1,354,6531620,2000
142,cs1705,20170512,1848,1845,1847,1847,1845,1846,1846,1,1,46,849200,2000
143,cs1705,20170515,1846,1846,0,0,0,1846,1846,0,0,0,0,0
144,cs1707,20170103,1838,1838,0,0,0,1838,1838,0,0,0,0,58
145,cs1707,20170104,1838,1838,0,0,0,1838,1838,0,0,0,0,58
146,cs1707,20170105,1838,1838,0,0,0,1838,1838,0,0,0,0,58
147,cs1707,20170106,1838,1838,0,0,0,1838,1838,0,0,0,0,58
148,cs1707,20170109,1838,1838,0,0,0,1838,1838,0,0,0,0,58
149,cs1707,20170110,1838,1838,0,0,0,1839,1839,1,1,0,0,58
150,cs1707,20170111,1839,1839,1809,1809,1785,1785,1794,-54,-45,20,358900,62
151,cs1707,20170112,1785,1794,0,0,0,1794,1794,0,0,0,0,62
152,cs1707,20170113,1794,1794,1805,1805,1805,1805,1805,11,11,2,36100,62
153,cs1707,20170116,1805,1805,1830,1864,1830,1837,1859,32,54,26,483400,56
154,cs1707,20170117,1837,1859,1885,1885,1855,1860,1866,1,7,6,112000,56
155,cs1707,20170118,1860,1866,0,0,0,1866,1866,0,0,0,0,56
156,cs1707,20170119,1866,1866,1872,1883,1869,1883,1876,17,10,20,375220,56
157,cs1707,20170120,1883,1876,0,0,0,1876,1876,0,0,0,0,56
158,cs1707,20170123,1876,1876,0,0,0,1876,1876,0,0,0,0,56
159,cs1707,20170124,1876,1876,1879,1879,1879,1879,1879,3,3,2,37580,56
160,cs1707,20170125,1879,1879,0,0,0,1865,1865,-14,-14,0,0,56
161,cs1707,20170126,1865,1865,1855,1855,1855,1855,1855,-10,-10,4,74200,56
162,cs1707,20170203,1855,1855,0,0,0,1855,1855,0,0,0,0,56
163,cs1707,20170206,1855,1855,1904,1930,1901,1911,1910,56,55,36,687620,68
164,cs1707,20170207,1911,1910,1905,1937,1893,1897,1911,-13,1,94,1796960,92
165,cs1707,20170208,1897,1911,0,0,0,1911,1911,0,0,0,0,92
166,cs1707,20170209,1911,1911,0,0,0,1911,1911,0,0,0,0,92
167,cs1707,20170210,1911,1911,1890,1904,1890,1904,1901,-7,-10,14,266220,98
168,cs1707,20170213,1904,1901,1909,1909,1897,1897,1905,-4,4,8,152400,94
169,cs1707,20170214,1897,1905,1916,1916,1890,1890,1906,-15,1,26,495720,118
170,cs1707,20170215,1890,1906,1916,1916,1883,1883,1893,-23,-13,136,2574900,174
171,cs1707,20170216,1883,1893,1902,1902,1892,1892,1899,-1,6,8,151960,178
172,cs1707,20170217,1892,1899,1903,1903,1878,1878,1896,-21,-3,8,151740,182
173,cs1707,20170220,1878,1896,0,0,0,1896,1896,0,0,0,0,182
174,cs1707,20170221,1896,1896,1873,1904,1870,1885,1879,-11,-17,98,1841920,166
175,cs1707,20170222,1885,1879,0,0,0,1879,1879,0,0,0,0,166
176,cs1707,20170223,1879,1879,1902,1911,1854,1854,1883,-25,4,34,640220,166
177,cs1707,20170224,1854,1883,1890,1904,1884,1903,1895,20,12,18,341220,166
178,cs1707,20170227,1903,1895,1986,1987,1925,1938,1940,43,45,46,892700,166
179,cs1707,20170228,1938,1940,1945,1945,1932,1933,1935,-7,-5,30,580640,166
180,cs1707,20170301,1933,1935,1936,1942,1936,1942,1939,7,4,14,271540,166
181,cs1707,20170302,1942,1939,1948,1964,1945,1945,1951,6,12,12,234120,166
182,cs1707,20170303,1945,1951,0,0,0,1951,1951,0,0,0,0,166
183,cs1707,20170306,1951,1951,1947,1998,1947,1998,1985,47,34,230,4567000,352
184,cs1707,20170307,1998,1985,1990,2000,1933,1988,1980,3,-5,26,514920,344
185,cs1707,20170308,1988,1980,1971,1974,1941,1966,1962,-14,-18,14,274720,354
186,cs1707,20170309,1966,1962,1970,1979,1951,1959,1959,-3,-3,32,627080,338
187,cs1707,20170310,1959,1959,1962,1966,1942,1961,1960,2,1,34,666480,358
188,cs1707,20170313,1961,1960,1937,1970,1911,1970,1951,10,-9,50,975580,382
189,cs1707,20170314,1970,1951,1974,1986,1969,1969,1977,18,26,54,1067720,346
190,cs1707,20170315,1969,1977,1962,1970,1962,1970,1968,-7,-9,30,590480,340
191,cs1707,20170316,1970,1968,1980,1982,1980,1982,1981,14,13,6,118860,334
192,cs1707,20170317,1982,1981,1968,1968,1947,1947,1950,-34,-31,28,546180,354
193,cs1707,20170320,1947,1950,1982,1986,1923,1969,1974,19,24,338,6675140,458
194,cs1707,20170321,1969,1974,1968,1976,1968,1976,1971,2,-3,12,236520,458
195,cs1707,20170322,1976,1971,1979,1995,1922,1988,1983,17,12,872,17298980,1194
196,cs1707,20170323,1988,1983,1989,1997,1952,1960,1964,-23,-19,372,7306840,1430
197,cs1707,20170324,1960,1964,1963,1992,1963,1986,1981,22,17,22,435860,1432
198,cs1707,20170327,1986,1981,1979,1989,1960,1960,1975,-21,-6,62,1225020,1442
199,cs1707,20170328,1960,1975,1965,1985,1965,1985,1968,10,-7,24,472320,1444
200,cs1707,20170329,1985,1968,1961,1970,1930,1942,1946,-26,-22,160,3114600,1306
201,cs1707,20170330,1942,1946,1949,1950,1945,1945,1945,-1,-1,132,2568620,1184
202,cs1707,20170331,1945,1945,1955,1959,1955,1959,1957,14,12,4,78280,1180
203,cs1707,20170405,1959,1957,1971,1972,1971,1972,1971,15,14,4,78860,1178
204,cs1707,20170406,1972,1971,1982,1983,1945,1972,1955,1,-16,596,11652720,614
205,cs1707,20170407,1972,1955,1937,1987,1937,1960,1960,5,5,26,509740,610
206,cs1707,20170410,1960,1960,1978,1978,1938,1960,1951,0,-9,46,897820,610
207,cs1707,20170411,1960,1951,1936,1936,1915,1915,1929,-36,-22,40,771740,578
208,cs1707,20170412,1915,1929,0,0,0,1929,1929,0,0,0,0,578
209,cs1707,20170413,1929,1929,0,0,0,1929,1929,0,0,0,0,578
210,cs1707,20170414,1929,1929,1981,1981,1931,1942,1949,13,20,72,1403380,580
211,cs1707,20170417,1942,1949,1922,1943,1922,1931,1927,-18,-22,32,616840,570
212,cs1707,20170418,1931,1927,0,0,0,1928,1928,1,1,0,0,570
213,cs1707,20170419,1928,1928,1938,1938,1937,1937,1937,9,9,8,155020,568
214,cs1707,20170420,1937,1937,1965,1998,1948,1949,1967,12,30,74,1455960,554
215,cs1707,20170421,1949,1967,1961,1979,1961,1973,1971,6,4,6,118260,550
216,cs1707,20170424,1973,1971,1954,1954,1952,1952,1952,-19,-19,12,234280,552
217,cs1707,20170425,1952,1952,1930,1968,1902,1920,1932,-32,-20,40,773020,554
218,cs1707,20170426,1920,1932,1914,1932,1911,1911,1917,-21,-15,24,460240,550
219,cs1707,20170427,1911,1917,1912,1913,1908,1912,1911,-5,-6,30,573400,550
220,cs1707,20170428,1912,1911,1896,1912,1855,1866,1881,-45,-30,72,1354500,604
221,cs1707,20170502,1866,1881,1867,1895,1867,1885,1883,4,2,36,677960,598
222,cs1707,20170503,1885,1883,1888,1902,1879,1879,1892,-4,9,30,567620,584
223,cs1707,20170504,1879,1892,1883,1883,1883,1883,1883,-9,-9,2,37660,582
224,cs1707,20170505,1883,1883,0,0,0,1883,1883,0,0,0,0,582
225,cs1707,20170508,1883,1883,1883,1911,1883,1911,1889,28,6,28,529180,590
226,cs1707,20170509,1911,1889,1881,1891,1871,1891,1881,2,-8,30,564300,572
227,cs1707,20170510,1891,1881,0,0,0,1881,1881,0,0,0,0,572
228,cs1707,20170511,1881,1881,0,0,0,1881,1881,0,0,0,0,572
229,cs1707,20170512,1881,1881,1888,1888,1887,1888,1887,7,6,24,453100,552
230,cs1707,20170515,1888,1887,0,0,0,1887,1887,0,0,0,0,552
231,cs1707,20170516,1887,1887,1898,1898,1898,1898,1898,11,11,4,75920,556
232,cs1707,20170517,1898,1898,0,0,0,1898,1898,0,0,0,0,556
233,cs1707,20170518,1898,1898,0,0,0,1898,1898,0,0,0,0,556
234,cs1707,20170519,1898,1898,0,0,0,1898,1898,0,0,0,0,556
235,cs1707,20170522,1898,1898,1890,1890,1850,1879,1874,-19,-24,30,562280,564
236,cs1707,20170523,1879,1874,0,0,0,1874,1874,0,0,0,0,564
237,cs1707,20170524,1874,1874,1894,1894,1894,1894,1894,20,20,2,37880,564
238,cs1707,20170525,1894,1894,1915,1915,1871,1871,1899,-23,5,28,531960,556
239,cs1707,20170526,1871,1899,1848,1848,1848,1848,1848,-51,-51,2,36960,556
240,cs1707,20170531,1848,1848,1861,1861,1850,1850,1853,2,5,6,111220,554
241,cs1707,20170601,1850,1853,1867,1869,1867,1869,1867,16,14,6,112060,550
242,cs1707,20170602,1869,1867,1894,1908,1878,1908,1900,41,33,36,684200,546
243,cs1707,20170605,1908,1900,1920,1920,1866,1885,1895,-15,-5,112,2122780,554
244,cs1707,20170606,1885,1895,0,0,0,1892,1892,-3,-3,0,0,554
245,cs1707,20170607,1892,1892,1936,1936,1879,1895,1903,3,11,6,114200,552
246,cs1707,20170608,1895,1903,1858,1889,1858,1889,1881,-14,-22,8,150480,548
247,cs1707,20170609,1889,1881,0,0,0,1897,1897,16,16,0,0,548
248,cs1707,20170612,1897,1897,1905,1905,1905,1905,1905,8,8,20,381000,548
249,cs1707,20170613,1905,1905,1900,1901,1900,1901,1900,-4,-5,4,76020,546
250,cs1707,20170614,1901,1900,0,0,0,1900,1900,0,0,0,0,546
251,cs1707,20170615,1900,1900,0,0,0,1900,1900,0,0,0,0,546
252,cs1707,20170616,1900,1900,1955,1955,1854,1918,1895,18,-5,8,151640,546
253,cs1707,20170619,1918,1895,0,0,0,1895,1895,0,0,0,0,546
254,cs1707,20170620,1895,1895,1852,1892,1851,1892,1872,-3,-23,12,224660,546
255,cs1707,20170621,1892,1872,1899,1906,1887,1903,1893,31,21,36,681760,524
256,cs1707,20170622,1903,1893,1894,1904,1890,1896,1896,3,3,30,568800,502
257,cs1707,20170623,1896,1896,0,0,0,1896,1896,0,0,0,0,502
258,cs1707,20170626,1896,1896,1959,1967,1841,1954,1917,58,21,84,1610840,480
259,cs1707,20170627,1954,1917,1975,1975,1960,1960,1966,43,49,6,117960,478
260,cs1707,20170628,1960,1966,2017,2017,2017,2017,2017,51,51,2,40340,478
261,cs1707,20170629,2017,2017,2015,2015,1921,1921,1958,-96,-59,10,195840,472
262,cs1707,20170630,1921,1958,1922,1922,1922,1922,1922,-36,-36,36,691920,472
263,cs1707,20170703,1922,1922,2024,2024,2024,2024,2024,102,102,2,40480,452
264,cs1707,20170704,2024,2024,0,0,0,2024,2024,0,0,0,0,452
265,cs1707,20170705,2024,2024,2142,2142,2142,2142,2142,118,118,2,42840,452
266,cs1707,20170706,2142,2142,0,0,0,2142,2142,0,0,0,0,446
267,cs1707,20170707,2142,2142,0,0,0,2014,2014,-128,-128,0,0,446
268,cs1707,20170710,2014,2014,0,0,0,2014,2014,0,0,0,0,446
269,cs1707,20170711,2014,2014,1998,2133,1950,1950,1993,-64,-21,72,1435480,518
270,cs1707,20170712,1950,1993,1920,1920,1920,1920,1920,-73,-73,86,1651200,604
271,cs1707,20170713,1920,1920,1950,1950,1920,1925,1924,5,4,144,2770820,350
272,cs1707,20170714,1925,1924,0,0,0,1941,1941,17,17,0,0,0
273,cs1709,20170103,1878,1878,1884,1897,1875,1881,1886,3,8,30460,574525740,99094
274,cs1709,20170104,1881,1886,1888,1909,1878,1900,1897,14,11,34814,660632800,102942
275,cs1709,20170105,1900,1897,1909,1909,1890,1891,1897,-6,0,15602,296054360,103676
276,cs1709,20170106,1891,1897,1896,1898,1865,1870,1877,-27,-20,35290,662491600,107662
277,cs1709,20170109,1870,1877,1862,1874,1860,1872,1865,-5,-12,38492,718237340,107474
278,cs1709,20170110,1872,1865,1874,1880,1863,1867,1869,2,4,19930,372648500,109556
279,cs1709,20170111,1867,1869,1874,1886,1868,1869,1874,0,5,38350,718931960,121722
280,cs1709,20170112,1869,1874,1870,1878,1859,1870,1868,-4,-6,29114,544014600,124342
281,cs1709,20170113,1870,1868,1879,1901,1874,1887,1888,19,20,37770,713321460,123854
282,cs1709,20170116,1887,1888,1900,1922,1890,1918,1908,30,20,47828,912598040,124866
283,cs1709,20170117,1918,1908,1913,1933,1906,1917,1919,9,11,40396,775390980,129086
284,cs1709,20170118,1917,1919,1920,1948,1918,1946,1932,27,13,57942,1119979940,144646
285,cs1709,20170119,1946,1932,1943,1967,1937,1961,1953,29,21,103242,2017178360,172250
286,cs1709,20170120,1961,1953,1958,1961,1943,1951,1951,-2,-2,59094,1152930580,179908
287,cs1709,20170123,1951,1951,1955,1972,1954,1966,1963,15,12,42870,841718860,179410
288,cs1709,20170124,1966,1963,1966,1976,1954,1956,1966,-7,3,45440,893613000,186856
289,cs1709,20170125,1956,1966,1954,1955,1934,1943,1942,-23,-24,33046,642017020,187210
290,cs1709,20170126,1943,1942,1946,1952,1940,1943,1943,1,1,14698,285674020,187096
291,cs1709,20170203,1943,1943,1953,1974,1943,1973,1963,30,20,37482,736074800,192748
292,cs1709,20170206,1973,1963,1982,2039,1976,2015,2008,52,45,116960,2348965820,215420
293,cs1709,20170207,2015,2008,2010,2018,1997,2000,2006,-8,-2,72612,1457199960,227096
294,cs1709,20170208,2000,2006,2006,2018,2005,2014,2012,8,6,51630,1039148300,235152
295,cs1709,20170209,2014,2012,2018,2031,2000,2000,2017,-12,5,72808,1468560680,244218
296,cs1709,20170210,2000,2017,1997,2014,1991,2008,2004,-9,-13,73800,1479396700,258954
297,cs1709,20170213,2008,2004,2013,2020,1998,2005,2011,1,7,74592,1500193520,257982
298,cs1709,20170214,2005,2011,2005,2009,1977,1979,1988,-32,-23,94736,1883380600,266412
299,cs1709,20170215,1979,1988,1975,1988,1959,1961,1974,-27,-14,85734,1693014980,269786
300,cs1709,20170216,1961,1974,1966,1986,1962,1968,1976,-6,2,74902,1480076800,270604
301,cs1709,20170217,1968,1976,1966,1973,1944,1957,1957,-19,-19,72330,1416075040,266748
302,cs1709,20170220,1957,1957,1957,1980,1956,1980,1971,23,14,51516,1015447560,262022
303,cs1709,20170221,1980,1971,1984,2003,1983,1986,1993,15,22,80674,1607901300,257916
304,cs1709,20170222,1986,1993,1980,2000,1980,1999,1992,6,-1,61108,1217299880,262258
305,cs1709,20170223,1999,1992,2000,2014,1986,1996,1999,4,7,96870,1937112380,275532
306,cs1709,20170224,1996,1999,1987,2025,1982,2025,2008,26,9,123700,2485016660,293078
307,cs1709,20170227,2025,2008,2031,2062,2030,2054,2050,46,42,202690,4157106500,342482
308,cs1709,20170228,2054,2050,2052,2074,2046,2056,2055,6,5,117450,2414644240,350174
309,cs1709,20170301,2056,2055,2065,2066,2046,2055,2055,0,0,100470,2064740840,348228
310,cs1709,20170302,2055,2055,2070,2073,2050,2056,2060,1,5,102604,2114131580,351090
311,cs1709,20170303,2056,2060,2047,2062,2030,2062,2048,2,-12,111950,2293334280,358406
312,cs1709,20170306,2062,2048,2066,2090,2065,2075,2076,27,28,130106,2701238260,370898
313,cs1709,20170307,2075,2076,2071,2083,2066,2074,2073,-2,-3,89726,1860287920,381004
314,cs1709,20170308,2074,2073,2066,2066,2026,2045,2047,-28,-26,165156,3380902140,379542
315,cs1709,20170309,2045,2047,2040,2049,2023,2039,2037,-8,-10,153686,3131596040,361600
316,cs1709,20170310,2039,2037,2031,2042,2005,2010,2020,-27,-17,150564,3042285040,357582
317,cs1709,20170313,2010,2020,2010,2042,1994,2039,2023,19,3,135720,2746343440,382768
318,cs1709,20170314,2039,2023,2039,2061,2013,2016,2041,-7,18,174096,3554414720,384170
319,cs1709,20170315,2016,2041,2022,2049,2022,2049,2036,8,-5,132136,2690426800,392974
320,cs1709,20170316,2049,2036,2051,2068,2028,2035,2047,-1,11,272034,5569656880,420130
321,cs1709,20170317,2035,2047,2039,2041,2024,2034,2033,-13,-14,144570,2940249980,428914
322,cs1709,20170320,2034,2033,2042,2076,2042,2065,2061,32,28,243242,5013339020,462108
323,cs1709,20170321,2065,2061,2061,2087,2054,2084,2070,23,9,254742,5273730000,514938
324,cs1709,20170322,2084,2070,2082,2120,2075,2120,2098,50,28,459446,9643215460,646608
325,cs1709,20170323,2120,2098,2125,2137,2086,2097,2106,-1,8,542484,11425458900,696726
326,cs1709,20170324,2097,2106,2092,2133,2087,2116,2107,10,1,496530,10464872000,760610
327,cs1709,20170327,2116,2107,2126,2143,2106,2122,2123,15,16,587092,12464273980,838178
328,cs1709,20170328,2122,2123,2127,2127,2092,2116,2109,-7,-14,516028,10887445620,844778
329,cs1709,20170329,2116,2109,2110,2119,2037,2051,2070,-58,-39,966548,20015003800,784726
330,cs1709,20170330,2051,2070,2052,2059,2037,2041,2048,-29,-22,329216,6744791820,767572
331,cs1709,20170331,2041,2048,2045,2066,2034,2056,2054,8,6,458948,9428735380,760996
332,cs1709,20170405,2056,2054,2064,2081,2048,2070,2066,16,12,425912,8801360980,778232
333,cs1709,20170406,2070,2066,2073,2075,2013,2066,2042,0,-24,944264,19287214240,797110
334,cs1709,20170407,2066,2042,2054,2071,2023,2028,2046,-14,4,592618,12126353520,802158
335,cs1709,20170410,2028,2046,2030,2036,2013,2022,2024,-24,-22,491510,9951321240,811650
336,cs1709,20170411,2022,2024,2030,2037,1974,1983,2002,-41,-22,790900,15841469940,854850
337,cs1709,20170412,1983,2002,1983,1994,1974,1978,1984,-24,-18,320782,6365741980,826306
338,cs1709,20170413,1978,1984,1981,2003,1980,1999,1993,15,9,370748,7389685380,843912
339,cs1709,20170414,1999,1993,2000,2025,1998,2014,2013,21,20,414660,8348284100,813776
340,cs1709,20170417,2014,2013,2017,2024,1995,2018,2010,5,-3,444848,8944841400,790376
341,cs1709,20170418,2018,2010,2017,2020,1994,1997,2007,-13,-3,323116,6487000180,810518
342,cs1709,20170419,1997,2007,1993,1996,1973,1993,1986,-14,-21,444524,8828515780,814996
343,cs1709,20170420,1993,1986,1990,2012,1989,2010,2002,24,16,340376,6816864880,791380
344,cs1709,20170421,2010,2002,2007,2038,1995,2035,2019,33,17,592918,11974226300,797570
345,cs1709,20170424,2035,2019,2025,2034,2006,2011,2017,-8,-2,485900,9803367500,785368
346,cs1709,20170425,2011,2017,2008,2010,1970,1984,1986,-33,-31,634634,12606904700,784822
347,cs1709,20170426,1984,1986,1984,1995,1973,1978,1983,-8,-3,388568,7706914280,774404
348,cs1709,20170427,1978,1983,1970,1973,1946,1957,1956,-26,-27,516418,10105670600,804410
349,cs1709,20170428,1957,1956,1961,1967,1946,1946,1955,-10,-1,295686,5780723180,801132
350,cs1709,20170502,1946,1955,1951,1973,1949,1964,1961,9,6,539208,10578366180,795976
351,cs1709,20170503,1964,1961,1961,1962,1942,1949,1950,-12,-11,423590,8262810940,793996
352,cs1709,20170504,1949,1950,1942,1972,1933,1959,1956,9,6,558538,10928120580,794666
353,cs1709,20170505,1959,1956,1955,1987,1950,1969,1970,13,14,508796,10026525140,744836
354,cs1709,20170508,1969,1970,1972,1981,1963,1975,1972,5,2,340646,6720834240,765150
355,cs1709,20170509,1975,1972,1977,1977,1943,1948,1953,-24,-19,485968,9493747880,742662
356,cs1709,20170510,1948,1953,1951,1960,1944,1947,1951,-6,-2,263168,5136326360,725154
357,cs1709,20170511,1947,1951,1950,1970,1937,1970,1953,19,2,428224,8366057020,714254
358,cs1709,20170512,1970,1953,1965,1972,1956,1963,1964,10,11,304174,5976673660,704456
359,cs1709,20170515,1963,1964,1964,1978,1925,1934,1945,-30,-19,780476,15182532280,810332
360,cs1709,20170516,1934,1945,1931,1942,1920,1937,1933,-8,-12,307732,5950808420,779506
361,cs1709,20170517,1937,1933,1941,1947,1931,1939,1939,6,6,310068,6012881740,798246
362,cs1709,20170518,1939,1939,1931,1937,1920,1927,1927,-12,-12,360804,6954191780,786756
363,cs1709,20170519,1927,1927,1927,1944,1923,1925,1930,-2,3,253730,4898801220,758202
364,cs1709,20170522,1925,1930,1927,1935,1884,1897,1898,-33,-32,515858,9794776380,824438
365,cs1709,20170523,1897,1898,1899,1908,1894,1900,1901,2,3,249810,4749817760,784332
366,cs1709,20170524,1900,1901,1896,1930,1896,1923,1919,22,18,518664,9955596860,722852
367,cs1709,20170525,1923,1919,1923,1925,1912,1916,1917,-3,-2,195180,3742812560,695384
368,cs1709,20170526,1916,1917,1913,1932,1913,1924,1922,7,5,302780,5820868820,678416
369,cs1709,20170531,1924,1922,1919,1932,1915,1924,1921,2,-1,376358,7232207440,649746
370,cs1709,20170601,1924,1921,1921,1956,1921,1949,1939,28,18,701976,13617717880,657138
371,cs1709,20170602,1949,1939,1944,1970,1941,1969,1957,30,18,495050,9690588220,678744
372,cs1709,20170605,1969,1957,1972,1983,1961,1970,1972,13,15,458524,9043221520,743162
373,cs1709,20170606,1970,1972,1970,1972,1961,1971,1966,-1,-6,199374,3920663840,729672
374,cs1709,20170607,1971,1966,1977,1981,1969,1973,1975,7,9,285384,5638388520,757404
375,cs1709,20170608,1973,1975,1978,1979,1948,1957,1960,-18,-15,448126,8785283680,695974
376,cs1709,20170609,1957,1960,1957,2000,1954,1999,1981,39,21,538988,10680876280,728930
377,cs1709,20170612,1999,1981,2004,2011,1983,2005,1997,24,16,386990,7728551600,707810
378,cs1709,20170613,2005,1997,2000,2000,1980,1981,1991,-16,-6,255440,5087335780,662984
379,cs1709,20170614,1981,1991,1983,1993,1977,1992,1984,1,-7,207710,4122344300,666692
380,cs1709,20170615,1992,1984,1985,2013,1978,1997,1997,13,13,363488,7260854900,713678
381,cs1709,20170616,1997,1997,2000,2011,1985,1992,1995,-5,-2,348194,6949390060,669794
382,cs1709,20170619,1992,1995,1992,2016,1982,1984,1998,-11,3,474646,9484457180,661856
383,cs1709,20170620,1984,1998,1980,1986,1967,1980,1975,-18,-23,319198,6306967700,620946
384,cs1709,20170621,1980,1975,1975,1999,1974,1995,1991,20,16,287112,5716920420,645768
385,cs1709,20170622,1995,1991,1991,1999,1985,1986,1992,-5,1,185394,3693853400,623092
386,cs1709,20170623,1986,1992,1986,2030,1983,2018,2013,26,21,596326,12006080180,728558
387,cs1709,20170626,2018,2013,2021,2052,2021,2044,2044,31,31,398196,8139594500,719680
388,cs1709,20170627,2044,2044,2043,2050,2031,2046,2041,2,-3,325090,6635273060,720096
389,cs1709,20170628,2046,2041,2038,2059,2024,2026,2041,-15,0,381518,7787026280,663038
390,cs1709,20170629,2026,2041,2030,2036,2020,2025,2027,-16,-14,269882,5473056460,643750
391,cs1709,20170630,2025,2027,2028,2040,2015,2026,2024,-1,-3,295880,5989608400,639814
392,cs1709,20170703,2026,2024,2044,2048,2010,2015,2019,-9,-5,353990,7150017320,617516
393,cs1709,20170704,2015,2019,2011,2019,1986,1991,2000,-28,-19,384824,7699164380,574334
394,cs1709,20170705,1991,2000,1991,2008,1990,2002,2000,2,0,243304,4867687100,563386
395,cs1709,20170706,2002,2000,2004,2014,1991,1997,1999,-3,-1,267746,5353746000,581252
396,cs1709,20170707,1997,1999,1997,2027,1997,2026,2013,27,14,415988,8377679220,581696
397,cs1709,20170710,2026,2013,2035,2044,2011,2015,2031,2,18,328204,6666261040,558390
398,cs1709,20170711,2015,2031,2019,2032,2014,2020,2022,-11,-9,271086,5483168280,573740
399,cs1709,20170712,2020,2022,2025,2035,2015,2022,2025,0,3,298130,6038892360,573500
400,cs1709,20170713,2022,2025,2018,2023,1994,2008,2006,-17,-19,414774,8322010940,550156
401,cs1709,20170714,2008,2006,2005,2012,1996,2005,2006,-1,0,204898,4110535680,540486
402,cs1709,20170717,2005,2006,2006,2014,1976,2014,1997,8,-9,408412,8156207640,515146
403,cs1709,20170718,2014,1997,2015,2030,2008,2023,2019,26,22,376750,7610270500,523210
404,cs1709,20170719,2023,2019,2023,2030,1999,1999,2013,-20,-6,343814,6921021640,487264
405,cs1709,20170720,1999,2013,2000,2018,1998,2013,2007,0,-6,251608,5050695100,494712
406,cs1709,20170721,2013,2007,2017,2022,1987,1988,1998,-19,-9,399324,7981181360,510522
407,cs1709,20170724,1988,1998,1985,1985,1960,1960,1967,-38,-31,308454,6067557300,489980
408,cs1709,20170725,1960,1967,1962,1972,1959,1968,1965,1,-2,231836,4557498360,488604
409,cs1709,20170726,1968,1965,1963,1971,1946,1949,1955,-16,-10,244800,4787022060,458514
410,cs1709,20170727,1949,1955,1955,1961,1952,1955,1956,0,1,153548,3004704520,457072
411,cs1709,20170728,1955,1956,1959,1966,1943,1952,1953,-4,-3,259402,5067699220,446876
412,cs1709,20170731,1952,1953,1949,1955,1934,1939,1940,-14,-13,183436,3559446580,431868
413,cs1709,20170801,1939,1940,1936,1963,1936,1942,1949,2,9,236460,4610354800,414026
414,cs1709,20170802,1942,1949,1935,1951,1935,1948,1941,-1,-8,170476,3310437340,399410
415,cs1709,20170803,1948,1941,1955,1965,1947,1953,1955,12,14,152754,2987365300,374360
416,cs1709,20170804,1953,1955,1951,1964,1951,1958,1960,3,5,108746,2131644280,349472
417,cs1709,20170807,1958,1960,1965,1968,1923,1953,1948,-7,-12,188092,3664640680,313422
418,cs1709,20170808,1953,1948,1972,1972,1959,1971,1967,23,19,117736,2316122760,255214
419,cs1709,20170809,1971,1967,1976,1998,1973,1991,1988,24,21,143222,2847696540,193844
420,cs1709,20170810,1991,1988,2000,2000,1962,1972,1979,-16,-9,96618,1912818920,150992
421,cs1709,20170811,1972,1979,1959,1985,1950,1980,1973,1,-6,55126,1087660360,130182
422,cs1709,20170814,1980,1973,1986,1992,1975,1981,1982,8,9,35610,705919840,110810
423,cs1709,20170815,1981,1982,1986,1987,1976,1986,1983,4,1,39950,792534180,89206
424,cs1709,20170816,1986,1983,1981,1993,1979,1989,1988,6,5,29072,578047240,79776
425,cs1709,20170817,1989,1988,1991,2000,1990,1997,1995,9,7,16640,332062800,71584
426,cs1709,20170818,1997,1995,1980,1998,1980,1995,1995,0,0,11762,234691860,65912
427,cs1709,20170821,1995,1995,2001,2003,1986,1996,1996,1,1,21972,438747260,52820
428,cs1709,20170822,1996,1996,1993,2013,1989,2009,1998,13,2,11816,236134360,46858
429,cs1709,20170823,2009,1998,2005,2014,2003,2005,2009,7,11,6800,136655140,42596
430,cs1709,20170824,2005,2009,2003,2012,2001,2010,2007,1,-2,6788,136262640,38524
431,cs1709,20170825,2010,2007,2001,2018,2001,2011,2012,4,5,8894,178980000,34506
432,cs1709,20170828,2011,2012,2003,2011,1994,1996,2001,-16,-11,6450,129087740,30662
433,cs1709,20170829,1996,2001,1994,1996,1971,1972,1981,-29,-20,6472,128256500,28048
434,cs1709,20170830,1972,1981,1970,1973,1949,1951,1954,-30,-27,10664,208463480,20060
435,cs1709,20170831,1951,1954,1948,1953,1901,1911,1935,-43,-19,18550,359052440,8216
436,cs1709,20170901,1911,1935,1933,1950,1910,1913,1935,-22,0,2534,49040380,6674
437,cs1709,20170904,1913,1935,1939,1975,1939,1940,1954,5,19,500,9771280,5362
438,cs1709,20170905,1940,1954,1940,1940,1940,1940,1940,-14,-14,126,2444400,5362
439,cs1709,20170906,1940,1940,1978,1985,1978,1985,1979,45,39,2500,49499540,2994
440,cs1709,20170907,1985,1979,0,0,0,1979,1979,0,0,0,0,2994
441,cs1709,20170908,1979,1979,1950,1957,1945,1957,1953,-22,-26,132,2578900,2862
442,cs1709,20170911,1957,1953,1957,1965,1957,1965,1961,12,8,300,5884000,2562
443,cs1709,20170912,1965,1961,1989,1989,1989,1989,1989,28,28,54,1074060,2562
444,cs1709,20170913,1989,1989,1987,1987,1940,1940,1941,-49,-48,204,3960880,2562
445,cs1709,20170914,1940,1941,1940,2007,1940,1952,1957,11,16,168,3326440,0
446,cs1711,20170103,1925,1927,1936,1936,1936,1936,1936,9,9,2,38720,14
447,cs1711,20170104,1936,1936,1929,1929,1929,1929,1929,-7,-7,8,154320,10
448,cs1711,20170105,1929,1929,0,0,0,1929,1929,0,0,0,0,10
449,cs1711,20170106,1929,1929,0,0,0,1929,1929,0,0,0,0,10
450,cs1711,20170109,1929,1929,1916,1916,1916,1916,1916,-13,-13,2,38320,12
451,cs1711,20170110,1916,1916,1899,1935,1899,1935,1917,19,1,4,76680,12
452,cs1711,20170111,1935,1917,1923,1923,1923,1923,1923,6,6,2,38460,12
453,cs1711,20170112,1923,1923,1915,1915,1915,1915,1915,-8,-8,2,38300,14
454,cs1711,20170113,1915,1915,0,0,0,1924,1924,9,9,0,0,14
455,cs1711,20170116,1924,1924,0,0,0,1947,1947,23,23,0,0,14
456,cs1711,20170117,1947,1947,0,0,0,1947,1947,0,0,0,0,14
457,cs1711,20170118,1947,1947,1957,1984,1936,1958,1957,11,10,22,430600,8
458,cs1711,20170119,1958,1957,1965,1995,1965,1995,1980,38,23,4,79200,12
459,cs1711,20170120,1995,1980,1970,1970,1970,1970,1970,-10,-10,2,39400,10
460,cs1711,20170123,1970,1970,0,0,0,1972,1972,2,2,0,0,10
461,cs1711,20170124,1972,1972,0,0,0,1973,1973,1,1,0,0,10
462,cs1711,20170125,1973,1973,0,0,0,1973,1973,0,0,0,0,10
463,cs1711,20170126,1973,1973,0,0,0,1974,1974,1,1,0,0,10
464,cs1711,20170203,1974,1974,0,0,0,1974,1974,0,0,0,0,10
465,cs1711,20170206,1974,1974,0,0,0,2019,2019,45,45,0,0,10
466,cs1711,20170207,2019,2019,0,0,0,2019,2019,0,0,0,0,10
467,cs1711,20170208,2019,2019,2046,2047,2020,2027,2035,8,16,52,1058260,14
468,cs1711,20170209,2027,2035,2034,2034,2020,2029,2026,-6,-9,16,324160,6
469,cs1711,20170210,2029,2026,2032,2032,2032,2032,2032,6,6,2,40640,8
470,cs1711,20170213,2032,2032,0,0,0,2032,2032,0,0,0,0,8
471,cs1711,20170214,2032,2032,0,0,0,2032,2032,0,0,0,0,8
472,cs1711,20170215,2032,2032,2003,2012,2002,2008,2006,-24,-26,12,240780,18
473,cs1711,20170216,2008,2006,2052,2052,1996,1996,2024,-10,18,4,80960,16
474,cs1711,20170217,1996,2024,0,0,0,2024,2024,0,0,0,0,16
475,cs1711,20170220,2024,2024,0,0,0,2024,2024,0,0,0,0,16
476,cs1711,20170221,2024,2024,0,0,0,2024,2024,0,0,0,0,16
477,cs1711,20170222,2024,2024,0,0,0,2024,2024,0,0,0,0,16
478,cs1711,20170223,2024,2024,2024,2024,2021,2021,2022,-3,-2,12,242680,20
479,cs1711,20170224,2021,2022,0,0,0,2022,2022,0,0,0,0,20
480,cs1711,20170227,2022,2022,2038,2038,2036,2036,2037,14,15,12,244480,28
481,cs1711,20170228,2036,2037,2050,2069,2043,2069,2053,32,16,10,205320,28
482,cs1711,20170301,2069,2053,0,0,0,2053,2053,0,0,0,0,28
483,cs1711,20170302,2053,2053,0,0,0,2053,2053,0,0,0,0,28
484,cs1711,20170303,2053,2053,2052,2052,2052,2052,2052,-1,-1,2,41040,28
485,cs1711,20170306,2052,2052,2050,2079,2050,2079,2054,27,2,14,287580,38
486,cs1711,20170307,2079,2054,2079,2079,2055,2055,2067,1,13,4,82680,38
487,cs1711,20170308,2055,2067,0,0,0,2056,2056,-11,-11,0,0,38
488,cs1711,20170309,2056,2056,0,0,0,2045,2045,-11,-11,0,0,38
489,cs1711,20170310,2045,2045,0,0,0,2026,2026,-19,-19,0,0,38
490,cs1711,20170313,2026,2026,0,0,0,2026,2026,0,0,0,0,38
491,cs1711,20170314,2026,2026,0,0,0,2026,2026,0,0,0,0,38
492,cs1711,20170315,2026,2026,0,0,0,2026,2026,0,0,0,0,38
493,cs1711,20170316,2026,2026,0,0,0,2026,2026,0,0,0,0,38
494,cs1711,20170317,2026,2026,2108,2108,2108,2108,2108,82,82,2,42160,40
495,cs1711,20170320,2108,2108,2068,2070,2064,2064,2066,-44,-42,14,289320,48
496,cs1711,20170321,2064,2066,2070,2070,2058,2058,2064,-8,-2,4,82560,50
497,cs1711,20170322,2058,2064,2068,2094,2068,2090,2085,26,21,32,667460,70
498,cs1711,20170323,2090,2085,2080,2080,2070,2070,2076,-15,-9,6,124600,70
499,cs1711,20170324,2070,2076,2100,2100,2093,2093,2096,17,20,4,83860,70
500,cs1711,20170327,2093,2096,2080,2080,2079,2079,2079,-17,-17,8,166340,76
501,cs1711,20170328,2079,2079,2045,2089,2045,2078,2070,-1,-9,22,455560,80
502,cs1711,20170329,2078,2070,2066,2067,2020,2030,2045,-40,-25,44,899840,78
503,cs1711,20170330,2030,2045,2061,2061,2042,2043,2046,-2,1,10,204600,72
504,cs1711,20170331,2043,2046,2026,2049,2026,2049,2037,3,-9,4,81500,72
505,cs1711,20170405,2049,2037,2066,2066,2042,2042,2054,5,17,4,82160,72
506,cs1711,20170406,2042,2054,0,0,0,2054,2054,0,0,0,0,72
507,cs1711,20170407,2054,2054,0,0,0,2058,2058,4,4,0,0,72
508,cs1711,20170410,2058,2058,2048,2048,2001,2030,2029,-28,-29,80,1623800,52
509,cs1711,20170411,2030,2029,1990,1990,1990,1990,1990,-39,-39,4,79600,52
510,cs1711,20170412,1990,1990,1990,1990,1990,1990,1990,0,0,2,39800,52
511,cs1711,20170413,1990,1990,1990,1997,1990,1996,1994,6,4,6,119660,48
512,cs1711,20170414,1996,1994,0,0,0,1995,1995,1,1,0,0,48
513,cs1711,20170417,1995,1995,2000,2000,1999,1999,1999,4,4,8,159980,50
514,cs1711,20170418,1999,1999,2000,2000,2000,2000,2000,1,1,4,80000,48
515,cs1711,20170419,2000,2000,0,0,0,2000,2000,0,0,0,0,48
516,cs1711,20170420,2000,2000,2004,2004,2002,2003,2002,3,2,10,200260,48
517,cs1711,20170421,2003,2002,0,0,0,2008,2008,6,6,0,0,48
518,cs1711,20170424,2008,2008,0,0,0,2008,2008,0,0,0,0,48
519,cs1711,20170425,2008,2008,1990,1990,1983,1984,1984,-24,-24,18,357240,46
520,cs1711,20170426,1984,1984,1996,2004,1994,2003,1999,19,15,22,439860,56
521,cs1711,20170427,2003,1999,1989,1989,1974,1974,1981,-25,-18,4,79260,56
522,cs1711,20170428,1974,1981,0,0,0,1981,1981,0,0,0,0,56
523,cs1711,20170502,1981,1981,1980,1999,1979,1992,1984,11,3,14,277800,54
524,cs1711,20170503,1992,1984,1976,1976,1975,1975,1975,-9,-9,6,118540,54
525,cs1711,20170504,1975,1975,1970,1970,1970,1970,1970,-5,-5,2,39400,54
526,cs1711,20170505,1970,1970,0,0,0,1970,1970,0,0,0,0,54
527,cs1711,20170508,1970,1970,0,0,0,1970,1970,0,0,0,0,54
528,cs1711,20170509,1970,1970,0,0,0,1970,1970,0,0,0,0,54
529,cs1711,20170510,1970,1970,1977,1982,1968,1972,1974,2,4,10,197420,52
530,cs1711,20170511,1972,1974,0,0,0,1976,1976,2,2,0,0,52
531,cs1711,20170512,1976,1976,1987,1987,1987,1987,1987,11,11,2,39740,52
532,cs1711,20170515,1987,1987,1965,1965,1957,1957,1959,-30,-28,12,235120,52
533,cs1711,20170516,1957,1959,0,0,0,1959,1959,0,0,0,0,52
534,cs1711,20170517,1959,1959,0,0,0,1959,1959,0,0,0,0,52
535,cs1711,20170518,1959,1959,0,0,0,1959,1959,0,0,0,0,52
536,cs1711,20170519,1959,1959,1919,1964,1919,1964,1941,5,-18,4,77660,52
537,cs1711,20170522,1964,1941,1940,1940,1927,1929,1930,-12,-11,16,308880,56
538,cs1711,20170523,1929,1930,0,0,0,1930,1930,0,0,0,0,56
539,cs1711,20170524,1930,1930,1943,1950,1943,1950,1947,20,17,6,116860,54
540,cs1711,20170525,1950,1947,0,0,0,1947,1947,0,0,0,0,54
541,cs1711,20170526,1947,1947,0,0,0,1947,1947,0,0,0,0,54
542,cs1711,20170531,1947,1947,1935,1935,1935,1935,1935,-12,-12,2,38700,52
543,cs1711,20170601,1935,1935,0,0,0,1945,1945,10,10,0,0,52
544,cs1711,20170602,1945,1945,1967,1976,1967,1976,1973,31,28,6,118380,46
545,cs1711,20170605,1976,1973,0,0,0,1979,1979,6,6,0,0,46
546,cs1711,20170606,1979,1979,0,0,0,1979,1979,0,0,0,0,46
547,cs1711,20170607,1979,1979,2005,2005,2005,2005,2005,26,26,8,160400,50
548,cs1711,20170608,2005,2005,2005,2005,2005,2005,2005,0,0,2,40100,48
549,cs1711,20170609,2005,2005,0,0,0,2005,2005,0,0,0,0,48
550,cs1711,20170612,2005,2005,2020,2020,2020,2020,2020,15,15,2,40400,48
551,cs1711,20170613,2020,2020,2026,2027,2009,2009,2013,-11,-7,16,322140,36
552,cs1711,20170614,2009,2013,0,0,0,2013,2013,0,0,0,0,36
553,cs1711,20170615,2013,2013,2004,2026,2004,2026,2015,13,2,4,80600,36
554,cs1711,20170616,2026,2015,0,0,0,2015,2015,0,0,0,0,36
555,cs1711,20170619,2015,2015,2036,2036,2036,2036,2036,21,21,2,40720,36
556,cs1711,20170620,2036,2036,2002,2002,2002,2002,2002,-34,-34,2,40040,36
557,cs1711,20170621,2002,2002,0,0,0,2018,2018,16,16,0,0,36
558,cs1711,20170622,2018,2018,2020,2020,2020,2020,2020,2,2,2,40400,34
559,cs1711,20170623,2020,2020,2030,2030,2030,2030,2030,10,10,2,40600,32
560,cs1711,20170626,2030,2030,2050,2050,2050,2050,2050,20,20,4,82000,28
561,cs1711,20170627,2050,2050,0,0,0,2050,2050,0,0,0,0,28
562,cs1711,20170628,2050,2050,2076,2076,2066,2066,2071,16,21,4,82840,28
563,cs1711,20170629,2066,2071,2040,2040,2040,2040,2040,-31,-31,2,40800,28
564,cs1711,20170630,2040,2040,0,0,0,2040,2040,0,0,0,0,28
565,cs1711,20170703,2040,2040,0,0,0,2040,2040,0,0,0,0,28
566,cs1711,20170704,2040,2040,0,0,0,2040,2040,0,0,0,0,28
567,cs1711,20170705,2040,2040,0,0,0,2032,2032,-8,-8,0,0,28
568,cs1711,20170706,2032,2032,0,0,0,2032,2032,0,0,0,0,28
569,cs1711,20170707,2032,2032,2031,2036,2031,2036,2033,4,1,4,81340,28
570,cs1711,20170710,2036,2033,0,0,0,2033,2033,0,0,0,0,28
571,cs1711,20170711,2033,2033,0,0,0,2033,2033,0,0,0,0,28
572,cs1711,20170712,2033,2033,0,0,0,2034,2034,1,1,0,0,28
573,cs1711,20170713,2034,2034,0,0,0,2031,2031,-3,-3,0,0,28
574,cs1711,20170714,2031,2031,0,0,0,2028,2028,-3,-3,0,0,28
575,cs1711,20170717,2028,2028,2027,2027,2027,2027,2027,-1,-1,2,40540,28
576,cs1711,20170718,2027,2027,2038,2038,2034,2034,2036,7,9,4,81440,24
577,cs1711,20170719,2034,2036,0,0,0,2031,2031,-5,-5,0,0,24
578,cs1711,20170720,2031,2031,2032,2032,2012,2012,2022,-19,-9,4,80880,24
579,cs1711,20170721,2012,2022,0,0,0,2022,2022,0,0,0,0,24
580,cs1711,20170724,2022,2022,0,0,0,2022,2022,0,0,0,0,24
581,cs1711,20170725,2022,2022,0,0,0,2022,2022,0,0,0,0,24
582,cs1711,20170726,2022,2022,0,0,0,2022,2022,0,0,0,0,24
583,cs1711,20170727,2022,2022,0,0,0,2022,2022,0,0,0,0,24
584,cs1711,20170728,2022,2022,1976,1995,1976,1995,1990,-27,-32,8,159220,30
585,cs1711,20170731,1995,1990,1966,1979,1961,1961,1966,-29,-24,10,196600,32
586,cs1711,20170801,1961,1966,1962,1973,1960,1960,1963,-6,-3,8,157100,32
587,cs1711,20170802,1960,1963,1965,1965,1946,1946,1955,-17,-8,4,78220,34
588,cs1711,20170803,1946,1955,0,0,0,1965,1965,10,10,0,0,34
589,cs1711,20170804,1965,1965,1974,1974,1974,1974,1974,9,9,2,39480,32
590,cs1711,20170807,1974,1974,0,0,0,1974,1974,0,0,0,0,32
591,cs1711,20170808,1974,1974,1975,1975,1975,1975,1975,1,1,2,39500,30
592,cs1711,20170809,1975,1975,0,0,0,1996,1996,21,21,0,0,30
593,cs1711,20170810,1996,1996,2005,2005,1993,2004,1996,8,0,16,319380,38
594,cs1711,20170811,2004,1996,0,0,0,1990,1990,-6,-6,0,0,38
595,cs1711,20170814,1990,1990,0,0,0,1999,1999,9,9,0,0,38
596,cs1711,20170815,1999,1999,0,0,0,1999,1999,0,0,0,0,38
597,cs1711,20170816,1999,1999,0,0,0,1999,1999,0,0,0,0,38
598,cs1711,20170817,1999,1999,2012,2012,2012,2012,2012,13,13,2,40240,38
599,cs1711,20170818,2012,2012,0,0,0,2012,2012,0,0,0,0,38
600,cs1711,20170821,2012,2012,0,0,0,2012,2012,0,0,0,0,38
601,cs1711,20170822,2012,2012,0,0,0,2014,2014,2,2,0,0,38
602,cs1711,20170823,2014,2014,0,0,0,2014,2014,0,0,0,0,38
603,cs1711,20170824,2014,2014,0,0,0,2012,2012,-2,-2,0,0,38
604,cs1711,20170825,2012,2012,0,0,0,2012,2012,0,0,0,0,38
605,cs1711,20170828,2012,2012,1989,1997,1989,1997,1990,-15,-22,10,199060,36
606,cs1711,20170829,1997,1990,0,0,0,1990,1990,0,0,0,0,36
607,cs1711,20170830,1990,1990,0,0,0,1974,1974,-16,-16,0,0,36
608,cs1711,20170831,1974,1974,1984,1984,1927,1927,1956,-47,-18,60,1173960,52
609,cs1711,20170901,1927,1956,0,0,0,1956,1956,0,0,0,0,52
610,cs1711,20170904,1956,1956,0,0,0,1956,1956,0,0,0,0,52
611,cs1711,20170905,1956,1956,0,0,0,1962,1962,6,6,0,0,52
612,cs1711,20170906,1962,1962,0,0,0,1971,1971,9,9,0,0,52
613,cs1711,20170907,1971,1971,1977,1977,1977,1977,1977,6,6,2,39540,52
614,cs1711,20170908,1977,1977,1968,1968,1946,1949,1950,-28,-27,14,273080,52
615,cs1711,20170911,1949,1950,1866,1937,1865,1937,1898,-13,-52,16,303740,50
616,cs1711,20170912,1937,1898,1942,1943,1918,1925,1928,27,30,16,308480,46
617,cs1711,20170913,1925,1928,1920,1932,1920,1932,1926,4,-2,4,77040,44
618,cs1711,20170914,1932,1926,0,0,0,1926,1926,0,0,0,0,44
619,cs1711,20170915,1926,1926,0,0,0,1926,1926,0,0,0,0,44
620,cs1711,20170918,1926,1926,0,0,0,1926,1926,0,0,0,0,44
621,cs1711,20170919,1926,1926,0,0,0,1922,1922,-4,-4,0,0,44
622,cs1711,20170920,1922,1922,0,0,0,1922,1922,0,0,0,0,44
623,cs1711,20170921,1922,1922,0,0,0,1922,1922,0,0,0,0,44
624,cs1711,20170922,1922,1922,1953,1991,1944,1972,1966,50,44,76,1494680,28
625,cs1711,20170925,1972,1966,1994,1994,1965,1965,1979,-1,13,4,79180,30
626,cs1711,20170926,1965,1979,2011,2038,1980,2035,2011,56,32,24,482680,22
627,cs1711,20170927,2035,2011,2011,2035,2010,2035,2019,24,8,8,161520,20
628,cs1711,20170928,2035,2019,2020,2063,2020,2050,2039,31,20,8,163160,18
629,cs1711,20170929,2050,2039,0,0,0,2039,2039,0,0,0,0,18
630,cs1711,20171009,2039,2039,2050,2050,2033,2033,2041,-6,2,8,163320,18
631,cs1711,20171010,2033,2041,2035,2066,2035,2065,2053,24,12,10,205320,18
632,cs1711,20171011,2065,2053,2055,2070,2055,2070,2062,17,9,4,82500,18
633,cs1711,20171012,2070,2062,2058,2070,2058,2070,2064,8,2,4,82560,18
634,cs1711,20171013,2070,2064,0,0,0,2064,2064,0,0,0,0,18
635,cs1711,20171016,2064,2064,2041,2041,2041,2041,2041,-23,-23,4,81640,14
636,cs1711,20171017,2041,2041,0,0,0,2041,2041,0,0,0,0,14
637,cs1711,20171018,2041,2041,0,0,0,2041,2041,0,0,0,0,14
638,cs1711,20171019,2041,2041,0,0,0,2041,2041,0,0,0,0,14
639,cs1711,20171020,2041,2041,2020,2065,2020,2021,2029,-20,-12,22,446380,10
640,cs1711,20171023,2021,2029,0,0,0,2029,2029,0,0,0,0,10
641,cs1711,20171024,2029,2029,0,0,0,2029,2029,0,0,0,0,10
642,cs1711,20171025,2029,2029,0,0,0,2029,2029,0,0,0,0,10
643,cs1711,20171026,2029,2029,0,0,0,2029,2029,0,0,0,0,10
644,cs1711,20171027,2029,2029,0,0,0,2029,2029,0,0,0,0,10
645,cs1711,20171030,2029,2029,2029,2029,2029,2029,2029,0,0,4,81160,10
646,cs1711,20171031,2029,2029,1996,1996,1996,1996,1996,-33,-33,10,199600,4
647,cs1711,20171101,1996,1996,0,0,0,1996,1996,0,0,0,0,4
648,cs1711,20171102,1996,1996,0,0,0,1996,1996,0,0,0,0,4
649,cs1711,20171103,1996,1996,0,0,0,1996,1996,0,0,0,0,4
650,cs1711,20171106,1996,1996,0,0,0,1996,1996,0,0,0,0,4
651,cs1711,20171107,1996,1996,0,0,0,1996,1996,0,0,0,0,4
652,cs1711,20171108,1996,1996,0,0,0,1996,1996,0,0,0,0,4
653,cs1711,20171109,1996,1996,0,0,0,1996,1996,0,0,0,0,4
654,cs1711,20171110,1996,1996,0,0,0,1996,1996,0,0,0,0,4
655,cs1711,20171113,1996,1996,2115,2115,2115,2115,2115,119,119,4,84600,0
656,cs1711,20171114,2115,2115,0,0,0,2115,2115,0,0,0,0,0
657,cs1801,20170117,1947,1947,1945,1951,1901,1944,1930,-3,-17,1236,23860900,884
658,cs1801,20170118,1944,1930,1943,1980,1943,1978,1961,48,31,2022,39665120,2666
659,cs1801,20170119,1978,1961,1973,2009,1969,2007,1997,46,36,6278,125430160,7518
660,cs1801,20170120,2007,1997,2011,2011,1990,1999,1998,2,1,3522,70403660,9506
661,cs1801,20170123,1999,1998,1997,2040,1997,2012,2011,14,13,1378,27720980,10112
662,cs1801,20170124,2012,2011,2012,2029,2001,2002,2015,-9,4,2536,51106460,10514
663,cs1801,20170125,2002,2015,1998,1998,1984,1988,1990,-27,-25,758,15086700,10542
664,cs1801,20170126,1988,1990,1991,2000,1990,1998,1993,8,3,270,5381340,10554
665,cs1801,20170203,1998,1993,2000,2021,2000,2021,2015,28,22,1618,32604980,11376
666,cs1801,20170206,2021,2015,2026,2098,2026,2070,2060,55,45,7996,164778260,15694
667,cs1801,20170207,2070,2060,2075,2075,2056,2059,2066,-1,6,4394,90805140,16104
668,cs1801,20170208,2059,2066,2070,2085,2068,2077,2074,11,8,4366,90555940,17220
669,cs1801,20170209,2077,2074,2080,2090,2061,2061,2072,-13,-2,5276,109353640,17824
670,cs1801,20170210,2061,2072,2060,2073,2052,2065,2063,-7,-9,4244,87555840,18318
671,cs1801,20170213,2065,2063,2065,2080,2055,2060,2067,-3,4,2782,57517240,19440
672,cs1801,20170214,2060,2067,2058,2065,2038,2042,2048,-25,-19,4890,100178120,19574
673,cs1801,20170215,2042,2048,2033,2047,2023,2023,2036,-25,-12,4080,83097300,19262
674,cs1801,20170216,2023,2036,2031,2046,2026,2031,2038,-5,2,2100,42816300,19366
675,cs1801,20170217,2031,2038,2028,2031,2007,2020,2020,-18,-18,3218,65019560,20146
676,cs1801,20170220,2020,2020,2012,2036,2012,2036,2028,16,8,1460,29623300,20304
677,cs1801,20170221,2036,2028,2026,2055,2026,2036,2044,8,16,5848,119578840,22822
678,cs1801,20170222,2036,2044,2030,2046,2028,2043,2036,-1,-8,4396,89530460,24966
679,cs1801,20170223,2043,2036,2045,2051,2028,2032,2040,-4,4,3712,75740500,26712
680,cs1801,20170224,2032,2040,2025,2057,2019,2057,2040,17,0,4968,101348300,28494
681,cs1801,20170227,2057,2040,2055,2088,2055,2085,2078,45,38,9708,201819420,33946
682,cs1801,20170228,2085,2078,2084,2095,2070,2077,2080,-1,2,5634,117232660,36848
683,cs1801,20170301,2077,2080,2085,2088,2070,2080,2077,0,-3,2012,41802820,36720
684,cs1801,20170302,2080,2077,2088,2093,2078,2088,2086,11,9,5762,120201800,38638
685,cs1801,20170303,2088,2086,2078,2092,2071,2092,2081,6,-5,5124,106673860,39710
686,cs1801,20170306,2092,2081,2099,2121,2097,2106,2105,25,24,4988,105019120,41462
687,cs1801,20170307,2106,2105,2100,2110,2097,2103,2102,-2,-3,3376,70995220,41828
688,cs1801,20170308,2103,2102,2099,2099,2060,2071,2074,-31,-28,9418,195391900,44368
689,cs1801,20170309,2071,2074,2073,2076,2051,2069,2066,-5,-8,4590,94843600,44514
690,cs1801,20170310,2069,2066,2063,2067,2033,2041,2048,-25,-18,7012,143666540,46152
691,cs1801,20170313,2041,2048,2048,2068,2028,2063,2053,15,5,4874,100111040,47750
692,cs1801,20170314,2063,2053,2068,2087,2042,2046,2067,-7,14,7188,148599160,47538
693,cs1801,20170315,2046,2067,2058,2077,2054,2077,2065,10,-2,5426,112083740,47874
694,cs1801,20170316,2077,2065,2075,2093,2059,2067,2076,2,11,9034,187629280,48504
695,cs1801,20170317,2067,2076,2067,2071,2057,2066,2064,-10,-12,4468,92260860,49148
696,cs1801,20170320,2066,2064,2069,2103,2069,2092,2089,28,25,15370,321121280,55050
697,cs1801,20170321,2092,2089,2092,2111,2085,2108,2098,19,9,13512,283607400,57628
698,cs1801,20170322,2108,2098,2101,2139,2099,2135,2124,37,26,18950,402618600,65004
699,cs1801,20170323,2135,2124,2135,2141,2084,2090,2107,-34,-17,43530,917446880,70546
700,cs1801,20170324,2090,2107,2082,2095,2072,2078,2082,-29,-25,27112,564476300,76384
701,cs1801,20170327,2078,2082,2076,2091,2065,2068,2078,-14,-4,24482,508905800,73960
702,cs1801,20170328,2068,2078,2068,2079,2062,2071,2071,-7,-7,15456,320195300,73794
703,cs1801,20170329,2071,2071,2075,2078,2042,2047,2059,-24,-12,37938,781146260,76620
704,cs1801,20170330,2047,2059,2051,2053,2042,2049,2047,-10,-12,21082,431748340,74792
705,cs1801,20170331,2049,2047,2053,2062,2040,2049,2052,2,5,13500,277112660,76124
706,cs1801,20170405,2049,2052,2052,2065,2042,2056,2052,4,0,19806,406433480,77334
707,cs1801,20170406,2056,2052,2056,2057,2004,2031,2028,-21,-24,40538,822371180,79416
708,cs1801,20170407,2031,2028,2022,2035,1996,2000,2013,-28,-15,24810,499460880,86532
709,cs1801,20170410,2000,2013,1998,2003,1990,1996,1996,-17,-17,22336,445957220,89394
710,cs1801,20170411,1996,1996,2002,2006,1961,1966,1979,-30,-17,36822,728834660,94616
711,cs1801,20170412,1966,1979,1965,1974,1958,1967,1967,-12,-12,24770,487427660,91814
712,cs1801,20170413,1967,1967,1971,1983,1966,1980,1974,13,7,24262,479018100,91984
713,cs1801,20170414,1980,1974,1980,1996,1977,1982,1985,8,11,16386,325343560,94092
714,cs1801,20170417,1982,1985,1990,1990,1962,1974,1972,-11,-13,28830,568538600,95078
715,cs1801,20170418,1974,1972,1974,1980,1964,1967,1971,-5,-1,15706,309566240,95664
716,cs1801,20170419,1967,1971,1961,1966,1946,1957,1954,-14,-17,28426,555600560,95452
717,cs1801,20170420,1957,1954,1951,1966,1951,1965,1961,11,7,19658,385499260,97980
718,cs1801,20170421,1965,1961,1965,1988,1955,1986,1972,25,11,26008,512897280,99260
719,cs1801,20170424,1986,1972,1986,1986,1960,1964,1967,-8,-5,38988,767063620,114406
720,cs1801,20170425,1964,1967,1961,1964,1936,1940,1944,-27,-23,54212,1053921520,124828
721,cs1801,20170426,1940,1944,1940,1949,1937,1939,1942,-5,-2,28282,549431660,130910
722,cs1801,20170427,1939,1942,1937,1937,1911,1920,1919,-22,-23,50210,963967640,138922
723,cs1801,20170428,1920,1919,1922,1926,1912,1913,1917,-6,-2,23130,443621700,144306
724,cs1801,20170502,1913,1917,1913,1952,1913,1946,1935,29,18,49790,963891320,155244
725,cs1801,20170503,1946,1935,1943,1946,1930,1933,1936,-2,1,51028,988011240,170160
726,cs1801,20170504,1933,1936,1933,1953,1922,1939,1938,3,2,63632,1233209500,166906
727,cs1801,20170505,1939,1938,1933,1955,1931,1944,1945,6,7,53330,1037686400,161732
728,cs1801,20170508,1944,1945,1955,1958,1943,1948,1949,3,4,28292,551486200,160786
729,cs1801,20170509,1948,1949,1946,1948,1926,1930,1933,-19,-16,48206,932092280,167916
730,cs1801,20170510,1930,1933,1938,1938,1927,1927,1932,-6,-1,17932,346541800,168662
731,cs1801,20170511,1927,1932,1930,1943,1920,1943,1931,11,-1,48840,943349160,165354
732,cs1801,20170512,1943,1931,1937,1945,1936,1942,1940,11,9,24776,480685900,166816
733,cs1801,20170515,1942,1940,1943,1952,1920,1925,1933,-15,-7,64646,1250036160,184924
734,cs1801,20170516,1925,1933,1921,1933,1913,1929,1927,-4,-6,27790,535528260,194718
735,cs1801,20170517,1929,1927,1930,1940,1926,1935,1934,8,7,53944,1043303780,201850
736,cs1801,20170518,1935,1934,1930,1934,1920,1926,1924,-8,-10,46440,893862780,208428
737,cs1801,20170519,1926,1924,1924,1936,1923,1927,1928,3,4,26996,520602420,208990
738,cs1801,20170522,1927,1928,1927,1934,1894,1906,1908,-22,-20,77728,1483423120,212514
739,cs1801,20170523,1906,1908,1910,1914,1901,1904,1906,-4,-2,35440,675761540,216476
740,cs1801,20170524,1904,1906,1901,1922,1898,1917,1913,11,7,72238,1382484160,225416
741,cs1801,20170525,1917,1913,1915,1919,1910,1914,1914,1,1,21286,407460080,225574
742,cs1801,20170526,1914,1914,1911,1918,1907,1915,1913,1,-1,28746,550029280,223034
743,cs1801,20170531,1915,1913,1917,1919,1905,1907,1910,-6,-3,35494,678121920,222334
744,cs1801,20170601,1907,1910,1910,1931,1910,1928,1920,18,10,73746,1416572860,203782
745,cs1801,20170602,1928,1920,1926,1952,1923,1952,1939,32,19,47626,923484620,202918
746,cs1801,20170605,1952,1939,1951,1974,1947,1967,1961,28,22,80008,1569506880,203338
747,cs1801,20170606,1967,1961,1972,1972,1958,1965,1962,4,1,26498,520049520,202956
748,cs1801,20170607,1965,1962,1970,1982,1970,1974,1975,12,13,50384,995440900,207274
749,cs1801,20170608,1974,1975,1979,1980,1955,1962,1965,-13,-10,50346,989357120,206912
750,cs1801,20170609,1962,1965,1965,2002,1959,2002,1983,37,18,62798,1245659180,209712
751,cs1801,20170612,2002,1983,2002,2021,1992,2021,2003,38,20,77420,1550821660,201320
752,cs1801,20170613,2021,2003,2015,2020,2004,2007,2012,4,9,56004,1127164580,197682
753,cs1801,20170614,2007,2012,2008,2017,1992,2008,2002,-4,-10,56062,1122744560,205296
754,cs1801,20170615,2008,2002,2005,2023,1995,2011,2009,9,7,41202,827929600,208414
755,cs1801,20170616,2011,2009,2015,2021,2001,2003,2009,-6,0,43034,864608220,206096
756,cs1801,20170619,2003,2009,2001,2017,1992,1995,2004,-14,-5,54342,1089329860,205528
757,cs1801,20170620,1995,2004,1991,1995,1977,1986,1983,-18,-21,47066,933363440,210806
758,cs1801,20170621,1986,1983,1982,2003,1981,2002,1995,19,12,53866,1074887120,199282
759,cs1801,20170622,2002,1995,1998,2004,1990,1990,1997,-5,2,30324,605774400,196972
760,cs1801,20170623,1990,1997,1991,2018,1986,2012,2005,15,8,59064,1184449960,203014
761,cs1801,20170626,2012,2005,2021,2045,2017,2036,2037,31,32,47774,973164480,203762
762,cs1801,20170627,2036,2037,2040,2044,2029,2044,2038,7,1,52736,1074842080,213836
763,cs1801,20170628,2044,2038,2044,2055,2021,2022,2035,-16,-3,43668,888976800,212050
764,cs1801,20170629,2022,2035,2018,2032,2018,2020,2023,-15,-12,32896,665797160,212070
765,cs1801,20170630,2020,2023,2025,2035,2011,2019,2021,-4,-2,37668,761410400,210328
766,cs1801,20170703,2019,2021,2041,2045,2011,2012,2019,-9,-2,47190,952840120,215804
767,cs1801,20170704,2012,2019,2011,2017,1989,1992,2000,-27,-19,52866,1057754820,214956
768,cs1801,20170705,1992,2000,1995,2006,1991,2002,2000,2,0,26960,539379960,215628
769,cs1801,20170706,2002,2000,2005,2012,1983,1991,1994,-9,-6,59826,1193127020,224046
770,cs1801,20170707,1991,1994,1993,2013,1993,2013,2004,19,10,52634,1055044000,221306
771,cs1801,20170710,2013,2004,2020,2029,2003,2006,2017,2,13,48738,983304840,222976
772,cs1801,20170711,2006,2017,2011,2020,2008,2011,2013,-6,-4,42492,855466520,226934
773,cs1801,20170712,2011,2013,2015,2027,2009,2015,2017,2,4,46322,934630540,231026
774,cs1801,20170713,2015,2017,2013,2013,1992,1999,2000,-18,-17,78054,1561593880,229544
775,cs1801,20170714,1999,2000,1992,1999,1986,1996,1995,-4,-5,43646,870892240,227774
776,cs1801,20170717,1996,1995,1993,2000,1965,1999,1987,4,-8,80826,1606076040,221774
777,cs1801,20170718,1999,1987,2004,2015,1998,2002,2004,15,17,60474,1212461060,221702
778,cs1801,20170719,2002,2004,2003,2010,1988,1988,1996,-16,-8,53572,1069744120,221820
779,cs1801,20170720,1988,1996,1995,2003,1989,2000,1995,4,-1,51566,1029209020,226292
780,cs1801,20170721,2000,1995,2005,2007,1982,1984,1989,-11,-6,88746,1765999480,235396
781,cs1801,20170724,1984,1989,1974,1977,1951,1952,1961,-37,-28,90510,1775370060,251466
782,cs1801,20170725,1952,1961,1955,1965,1954,1962,1960,1,-1,71922,1409994520,265926
783,cs1801,20170726,1962,1960,1953,1961,1942,1943,1949,-17,-11,88114,1717479380,277212
784,cs1801,20170727,1943,1949,1952,1954,1946,1950,1951,1,2,58162,1134874360,286178
785,cs1801,20170728,1950,1951,1954,1960,1938,1949,1948,-2,-3,111432,2171634100,283750
786,cs1801,20170731,1949,1948,1946,1951,1932,1938,1938,-10,-10,91134,1766344520,310436
787,cs1801,20170801,1938,1938,1940,1955,1935,1938,1944,0,6,114156,2219751500,303704
788,cs1801,20170802,1938,1944,1930,1943,1928,1940,1935,-4,-9,72628,1405728160,301520
789,cs1801,20170803,1940,1935,1938,1952,1938,1943,1945,8,10,84720,1648198580,290832
790,cs1801,20170804,1943,1945,1945,1954,1943,1944,1948,-1,3,82844,1614132600,294030
791,cs1801,20170807,1944,1948,1945,1953,1912,1938,1938,-10,-10,214628,4159806200,323088
792,cs1801,20170808,1938,1938,1941,1957,1938,1952,1949,14,11,200094,3899976340,343646
793,cs1801,20170809,1952,1949,1953,1994,1953,1989,1977,40,28,366518,7248968180,362264
794,cs1801,20170810,1989,1977,1987,1996,1980,1991,1988,14,11,191058,3798842400,367300
795,cs1801,20170811,1991,1988,1978,2020,1975,2018,1995,30,7,359856,7181487060,372222
796,cs1801,20170814,2018,1995,2021,2030,2011,2016,2018,21,23,224070,4522519100,377408
797,cs1801,20170815,2016,2018,2020,2037,2008,2018,2022,0,4,326838,6611100120,382286
798,cs1801,20170816,2018,2022,2013,2026,2011,2019,2019,-3,-3,177006,3574567960,390824
799,cs1801,20170817,2019,2019,2019,2043,2019,2031,2031,12,12,233904,4752388520,425660
800,cs1801,20170818,2031,2031,2031,2035,2026,2029,2029,-2,-2,131218,2663288600,424300
801,cs1801,20170821,2029,2029,2040,2044,2015,2024,2027,-5,-2,263874,5350365160,402788
802,cs1801,20170822,2024,2027,2026,2053,2012,2046,2036,19,9,279370,5689330380,452316
803,cs1801,20170823,2046,2036,2044,2056,2031,2031,2042,-5,6,228414,4664578660,435606
804,cs1801,20170824,2031,2042,2031,2042,2026,2040,2035,-2,-7,143430,2919156300,440218
805,cs1801,20170825,2040,2035,2043,2050,2026,2034,2038,-1,3,220146,4487196640,431146
806,cs1801,20170828,2034,2038,2034,2040,2016,2023,2025,-15,-13,234206,4744099760,413566
807,cs1801,20170829,2023,2025,2023,2028,1996,1999,2008,-26,-17,269218,5408252260,386308
808,cs1801,20170830,1999,2008,1999,2002,1981,1981,1989,-27,-19,198664,3951697740,372004
809,cs1801,20170831,1981,1989,1985,1989,1973,1975,1980,-14,-9,185538,3675025740,369260
810,cs1801,20170901,1975,1980,1986,1991,1976,1977,1982,-3,2,171726,3404428520,352722
811,cs1801,20170904,1977,1982,1981,2034,1981,2026,2014,44,32,415430,8369366240,376722
812,cs1801,20170905,2026,2014,2027,2032,2019,2029,2025,15,11,174306,3530966020,384606
813,cs1801,20170906,2029,2025,2030,2047,2028,2028,2038,3,13,256424,5226926640,403760
814,cs1801,20170907,2028,2038,2034,2043,2029,2036,2035,-2,-3,151942,3093343540,411004
815,cs1801,20170908,2036,2035,2038,2043,1983,1986,2006,-49,-29,435620,8738995060,347682
816,cs1801,20170911,1986,2006,1989,1994,1978,1985,1986,-21,-20,164162,3261264780,338552
817,cs1801,20170912,1985,1986,1982,1998,1969,1982,1981,-4,-5,245810,4871578800,336638
818,cs1801,20170913,1982,1981,1984,1986,1959,1964,1967,-17,-14,288788,5680475940,341670
819,cs1801,20170914,1964,1967,1970,2000,1968,1971,1982,4,15,326758,6479366440,328754
820,cs1801,20170915,1971,1982,1977,1977,1962,1965,1968,-17,-14,151458,2981507820,327690
821,cs1801,20170918,1965,1968,1960,1977,1955,1966,1968,-2,0,187392,3689083900,326846
822,cs1801,20170919,1966,1968,1965,1974,1964,1971,1969,3,1,132188,2602912900,321064
823,cs1801,20170920,1971,1969,1969,1990,1959,1971,1979,2,10,258446,5114785240,319800
824,cs1801,20170921,1971,1979,1972,1990,1967,1987,1976,8,-3,229450,4535816240,323268
825,cs1801,20170922,1987,1976,1985,2025,1984,2010,2005,34,29,454596,9119007540,333196
826,cs1801,20170925,2010,2005,2010,2015,1994,2003,2001,-2,-4,197612,3955006300,340686
827,cs1801,20170926,2003,2001,2004,2018,1996,2007,2005,6,4,244308,4900075320,341796
828,cs1801,20170927,2007,2005,2007,2013,1992,2008,2000,3,-5,271312,5428346340,336446
829,cs1801,20170928,2008,2000,2003,2005,1970,1974,1985,-26,-15,367466,7295599760,294752
830,cs1801,20170929,1974,1985,1970,1980,1966,1976,1973,-9,-12,163952,3235150840,254194
831,cs1801,20171009,1976,1973,1965,1966,1934,1940,1947,-33,-26,293410,5713739740,307406
832,cs1801,20171010,1940,1947,1942,1946,1935,1940,1941,-7,-6,138874,2696062280,311688
833,cs1801,20171011,1940,1941,1944,1948,1935,1940,1940,-1,-1,155274,3012643140,328648
834,cs1801,20171012,1940,1940,1943,1949,1930,1943,1939,3,-1,252104,4889802480,348476
835,cs1801,20171013,1943,1939,1949,1959,1942,1946,1951,7,12,170524,3327333360,316356
836,cs1801,20171016,1946,1951,1945,1953,1936,1945,1942,-6,-9,185850,3609624320,370318
837,cs1801,20171017,1945,1942,1942,1955,1941,1950,1949,8,7,181960,3547045940,336068
838,cs1801,20171018,1950,1949,1957,1964,1948,1952,1952,3,3,124788,2436680280,335814
839,cs1801,20171019,1952,1952,1950,1960,1940,1952,1952,0,0,165214,3225770860,324848
840,cs1801,20171020,1952,1952,1950,1962,1943,1946,1953,-6,1,166548,3253065660,316110
841,cs1801,20171023,1946,1953,1936,1948,1934,1945,1943,-8,-10,141246,2745186380,329734
842,cs1801,20171024,1945,1943,1948,1954,1923,1936,1938,-7,-5,283540,5495954980,367194
843,cs1801,20171025,1936,1938,1938,1974,1937,1963,1956,25,18,316708,6195026140,317704
844,cs1801,20171026,1963,1956,1961,1970,1958,1970,1963,14,7,140860,2766264860,298028
845,cs1801,20171027,1970,1963,1967,1977,1954,1955,1965,-8,2,167782,3296994960,283104
846,cs1801,20171030,1955,1965,1957,1958,1934,1937,1940,-28,-25,201994,3920175020,304786
847,cs1801,20171031,1937,1940,1938,1947,1931,1941,1940,1,0,81802,1587500420,286652
848,cs1801,20171101,1941,1940,1941,1974,1933,1964,1961,24,21,323368,6344128300,289596
849,cs1801,20171102,1964,1961,1962,1968,1956,1962,1961,1,0,153754,3015210020,282770
850,cs1801,20171103,1962,1961,1964,1990,1962,1989,1977,28,16,266626,5272250340,311298
851,cs1801,20171106,1989,1977,1997,2005,1986,1993,1992,16,15,191076,3807847800,315650
852,cs1801,20171107,1993,1992,1995,2018,1993,2014,2003,22,11,202392,4055214800,327764
853,cs1801,20171108,2014,2003,2017,2095,2012,2061,2051,58,48,554380,11375646700,413198
854,cs1801,20171109,2061,2051,2069,2084,2052,2080,2067,29,16,339530,7020787080,392926
855,cs1801,20171110,2080,2067,2074,2096,2065,2076,2079,9,12,387304,8055338120,429184
856,cs1801,20171113,2076,2079,2081,2092,2072,2088,2081,9,2,214498,4464222880,406776
857,cs1801,20171114,2088,2081,2086,2182,2075,2164,2138,83,57,1008776,21570194920,533872
858,cs1801,20171115,2164,2138,2150,2186,2141,2160,2161,22,23,579050,12518300460,514170
859,cs1801,20171116,2160,2161,2160,2165,2131,2132,2141,-29,-20,390680,8368325280,489164
860,cs1801,20171117,2132,2141,2132,2138,2063,2073,2090,-68,-51,655040,13693210820,343656
861,cs1801,20171120,2073,2090,2083,2095,2068,2076,2080,-14,-10,270220,5622315600,348250
862,cs1801,20171121,2076,2080,2076,2088,2057,2074,2071,-6,-9,281288,5827641840,317592
863,cs1801,20171122,2074,2071,2079,2095,2073,2077,2083,6,12,214120,4460189460,319136
864,cs1801,20171123,2077,2083,2084,2091,2066,2071,2075,-12,-8,176084,3653747900,283272
865,cs1801,20171124,2071,2075,2068,2095,2055,2063,2072,-12,-3,289746,6006146640,276920
866,cs1801,20171127,2063,2072,2056,2093,2055,2071,2077,-1,5,183634,3815534440,258154
867,cs1801,20171128,2071,2077,2075,2102,2068,2076,2080,-1,3,179086,3725379180,255164
868,cs1801,20171129,2076,2080,2076,2092,2075,2077,2083,-3,3,153300,3193368060,240936
869,cs1801,20171130,2077,2083,2082,2089,2052,2052,2066,-31,-17,200564,4145492680,219618
870,cs1801,20171201,2052,2066,2050,2068,2031,2060,2047,-6,-19,235814,4828195720,198104
871,cs1801,20171204,2060,2047,2050,2092,2050,2071,2076,24,29,200088,4154492140,180634
872,cs1801,20171205,2071,2076,2065,2077,2051,2058,2063,-18,-13,122626,2529920640,128802
873,cs1801,20171206,2058,2063,2059,2075,2057,2072,2068,9,5,57990,1199538640,108950
874,cs1801,20171207,2072,2068,2066,2071,2040,2043,2050,-25,-18,52900,1084651200,85240
875,cs1801,20171208,2043,2050,2046,2052,2041,2042,2045,-8,-5,18790,384350500,78794
876,cs1801,20171211,2042,2045,2032,2053,2029,2034,2036,-11,-9,34286,698279420,66822
877,cs1801,20171212,2034,2036,2037,2041,2031,2035,2036,-1,0,16964,345437020,59850
878,cs1801,20171213,2035,2036,2026,2042,2026,2040,2035,4,-1,13176,268262460,55378
879,cs1801,20171214,2040,2035,2035,2057,2035,2043,2048,8,13,15702,321608060,49894
880,cs1801,20171215,2043,2048,2043,2049,2034,2038,2038,-10,-10,6724,137080960,48346
881,cs1801,20171218,2038,2038,2045,2065,2040,2058,2053,20,15,14906,306127880,43338
882,cs1801,20171219,2058,2053,2066,2067,2050,2052,2058,-1,5,6960,143244580,41056
883,cs1801,20171220,2052,2058,2056,2069,2042,2049,2053,-9,-5,10320,211921800,39802
884,cs1801,20171221,2049,2053,2052,2063,2043,2054,2054,1,1,9784,200963880,34992
885,cs1801,20171222,2054,2054,2057,2066,2048,2060,2056,6,2,12710,261398020,31950
886,cs1801,20171225,2060,2056,2062,2063,2041,2048,2045,-8,-11,8272,169242760,26418
887,cs1801,20171226,2048,2045,2052,2060,2040,2054,2049,9,4,3222,66043760,23748
888,cs1801,20171227,2054,2049,2065,2093,2060,2092,2076,43,27,13238,274900800,16682
889,cs1801,20171228,2092,2076,2085,2088,2078,2083,2082,7,6,3066,63837980,15278
890,cs1801,20171229,2083,2082,2086,2130,2064,2110,2090,28,8,8118,169709400,10148
891,cs1803,20170315,2067,2067,0,0,0,2067,2067,0,0,0,0,0
892,cs1803,20170316,2067,2067,2121,2123,2121,2123,2122,56,55,4,84880,4
893,cs1803,20170317,2123,2122,2119,2119,2119,2119,2119,-3,-3,2,42380,6
894,cs1803,20170320,2119,2119,0,0,0,2119,2119,0,0,0,0,6
895,cs1803,20170321,2119,2119,0,0,0,2119,2119,0,0,0,0,6
896,cs1803,20170322,2119,2119,0,0,0,2125,2125,6,6,0,0,6
897,cs1803,20170323,2125,2125,2157,2157,2094,2100,2119,-25,-6,8,169560,6
898,cs1803,20170324,2100,2119,0,0,0,2119,2119,0,0,0,0,6
899,cs1803,20170327,2119,2119,0,0,0,2119,2119,0,0,0,0,6
900,cs1803,20170328,2119,2119,0,0,0,2119,2119,0,0,0,0,6
901,cs1803,20170329,2119,2119,2090,2090,2090,2090,2090,-29,-29,2,41800,4
902,cs1803,20170330,2090,2090,0,0,0,2078,2078,-12,-12,0,0,4
903,cs1803,20170331,2078,2078,2104,2104,2090,2090,2098,12,20,8,167840,8
904,cs1803,20170405,2090,2098,2104,2104,2099,2099,2101,1,3,4,84060,8
905,cs1803,20170406,2099,2101,0,0,0,2086,2086,-15,-15,0,0,8
906,cs1803,20170407,2086,2086,2078,2078,2070,2070,2074,-16,-12,4,82960,8
907,cs1803,20170410,2070,2074,0,0,0,2070,2070,-4,-4,0,0,8
908,cs1803,20170411,2070,2070,2060,2060,2045,2045,2050,-25,-20,6,123000,8
909,cs1803,20170412,2045,2050,0,0,0,2020,2020,-30,-30,0,0,8
910,cs1803,20170413,2020,2020,0,0,0,2020,2020,0,0,0,0,8
911,cs1803,20170414,2020,2020,0,0,0,2020,2020,0,0,0,0,8
912,cs1803,20170417,2020,2020,0,0,0,2007,2007,-13,-13,0,0,8
913,cs1803,20170418,2007,2007,0,0,0,2007,2007,0,0,0,0,8
914,cs1803,20170419,2007,2007,0,0,0,2007,2007,0,0,0,0,8
915,cs1803,20170420,2007,2007,0,0,0,2007,2007,0,0,0,0,8
916,cs1803,20170421,2007,2007,0,0,0,2007,2007,0,0,0,0,8
917,cs1803,20170424,2007,2007,0,0,0,2007,2007,0,0,0,0,8
918,cs1803,20170425,2007,2007,0,0,0,2007,2007,0,0,0,0,8
919,cs1803,20170426,2007,2007,0,0,0,2007,2007,0,0,0,0,8
920,cs1803,20170427,2007,2007,0,0,0,2007,2007,0,0,0,0,8
921,cs1803,20170428,2007,2007,0,0,0,2007,2007,0,0,0,0,8
922,cs1803,20170502,2007,2007,1990,1990,1990,1990,1990,-17,-17,2,39800,10
923,cs1803,20170503,1990,1990,0,0,0,1990,1990,0,0,0,0,10
924,cs1803,20170504,1990,1990,0,0,0,1990,1990,0,0,0,0,10
925,cs1803,20170505,1990,1990,0,0,0,1990,1990,0,0,0,0,10
926,cs1803,20170508,1990,1990,0,0,0,1990,1990,0,0,0,0,10
927,cs1803,20170509,1990,1990,0,0,0,1990,1990,0,0,0,0,10
928,cs1803,20170510,1990,1990,0,0,0,1979,1979,-11,-11,0,0,10
929,cs1803,20170511,1979,1979,0,0,0,1979,1979,0,0,0,0,10
930,cs1803,20170512,1979,1979,0,0,0,1979,1979,0,0,0,0,10
931,cs1803,20170515,1979,1979,0,0,0,1979,1979,0,0,0,0,10
932,cs1803,20170516,1979,1979,0,0,0,1979,1979,0,0,0,0,10
933,cs1803,20170517,1979,1979,0,0,0,1979,1979,0,0,0,0,10
934,cs1803,20170518,1979,1979,0,0,0,1979,1979,0,0,0,0,10
935,cs1803,20170519,1979,1979,1975,1975,1939,1939,1957,-40,-22,4,78280,8
936,cs1803,20170522,1939,1957,1964,1965,1938,1940,1951,-17,-6,28,546300,8
937,cs1803,20170523,1940,1951,0,0,0,1951,1951,0,0,0,0,8
938,cs1803,20170524,1951,1951,0,0,0,1951,1951,0,0,0,0,8
939,cs1803,20170525,1951,1951,0,0,0,1951,1951,0,0,0,0,8
940,cs1803,20170526,1951,1951,0,0,0,1950,1950,-1,-1,0,0,8
941,cs1803,20170531,1950,1950,0,0,0,1950,1950,0,0,0,0,8
942,cs1803,20170601,1950,1950,0,0,0,1960,1960,10,10,0,0,8
943,cs1803,20170602,1960,1960,0,0,0,1979,1979,19,19,0,0,8
944,cs1803,20170605,1979,1979,0,0,0,1979,1979,0,0,0,0,8
945,cs1803,20170606,1979,1979,0,0,0,1979,1979,0,0,0,0,8
946,cs1803,20170607,1979,1979,0,0,0,1979,1979,0,0,0,0,8
947,cs1803,20170608,1979,1979,0,0,0,1979,1979,0,0,0,0,8
948,cs1803,20170609,1979,1979,0,0,0,1997,1997,18,18,0,0,8
949,cs1803,20170612,1997,1997,0,0,0,1997,1997,0,0,0,0,8
950,cs1803,20170613,1997,1997,0,0,0,1997,1997,0,0,0,0,8
951,cs1803,20170614,1997,1997,2003,2047,2003,2047,2025,50,28,4,81000,10
952,cs1803,20170615,2047,2025,2048,2050,2041,2049,2047,24,22,10,204760,12
953,cs1803,20170616,2049,2047,0,0,0,2047,2047,0,0,0,0,12
954,cs1803,20170619,2047,2047,0,0,0,2043,2043,-4,-4,0,0,12
955,cs1803,20170620,2043,2043,1995,2024,1995,2024,2004,-19,-39,6,120280,10
956,cs1803,20170621,2024,2004,0,0,0,2004,2004,0,0,0,0,10
957,cs1803,20170622,2004,2004,2007,2036,2007,2036,2021,32,17,4,80860,8
958,cs1803,20170623,2036,2021,0,0,0,2029,2029,8,8,0,0,8
959,cs1803,20170626,2029,2029,0,0,0,2031,2031,2,2,0,0,8
960,cs1803,20170627,2031,2031,2059,2059,2059,2059,2059,28,28,2,41180,10
961,cs1803,20170628,2059,2059,2070,2070,2070,2070,2070,11,11,2,41400,10
962,cs1803,20170629,2070,2070,2050,2050,2050,2050,2050,-20,-20,2,41000,8
963,cs1803,20170630,2050,2050,0,0,0,2050,2050,0,0,0,0,8
964,cs1803,20170703,2050,2050,0,0,0,2050,2050,0,0,0,0,8
965,cs1803,20170704,2050,2050,0,0,0,2047,2047,-3,-3,0,0,8
966,cs1803,20170705,2047,2047,0,0,0,2043,2043,-4,-4,0,0,8
967,cs1803,20170706,2043,2043,0,0,0,2043,2043,0,0,0,0,8
968,cs1803,20170707,2043,2043,0,0,0,2043,2043,0,0,0,0,8
969,cs1803,20170710,2043,2043,2043,2043,2043,2043,2043,0,0,6,122580,6
970,cs1803,20170711,2043,2043,0,0,0,2043,2043,0,0,0,0,6
971,cs1803,20170712,2043,2043,0,0,0,2043,2043,0,0,0,0,6
972,cs1803,20170713,2043,2043,0,0,0,2043,2043,0,0,0,0,6
973,cs1803,20170714,2043,2043,0,0,0,2043,2043,0,0,0,0,6
974,cs1803,20170717,2043,2043,0,0,0,2043,2043,0,0,0,0,6
975,cs1803,20170718,2043,2043,0,0,0,2043,2043,0,0,0,0,6
976,cs1803,20170719,2043,2043,0,0,0,2043,2043,0,0,0,0,6
977,cs1803,20170720,2043,2043,0,0,0,2043,2043,0,0,0,0,6
978,cs1803,20170721,2043,2043,0,0,0,2043,2043,0,0,0,0,6
979,cs1803,20170724,2043,2043,0,0,0,2043,2043,0,0,0,0,6
980,cs1803,20170725,2043,2043,0,0,0,2043,2043,0,0,0,0,6
981,cs1803,20170726,2043,2043,0,0,0,2043,2043,0,0,0,0,6
982,cs1803,20170727,2043,2043,0,0,0,2043,2043,0,0,0,0,6
983,cs1803,20170728,2043,2043,0,0,0,2043,2043,0,0,0,0,6
984,cs1803,20170731,2043,2043,0,0,0,2043,2043,0,0,0,0,6
985,cs1803,20170801,2043,2043,0,0,0,2043,2043,0,0,0,0,6
986,cs1803,20170802,2043,2043,1960,1975,1960,1964,1967,-79,-76,8,157360,6
987,cs1803,20170803,1964,1967,0,0,0,1967,1967,0,0,0,0,6
988,cs1803,20170804,1967,1967,1979,1979,1965,1965,1972,-2,5,4,78880,8
989,cs1803,20170807,1965,1972,1972,1972,1972,1972,1972,0,0,2,39440,6
990,cs1803,20170808,1972,1972,0,0,0,1983,1983,11,11,0,0,6
991,cs1803,20170809,1983,1983,0,0,0,2001,2001,18,18,0,0,6
992,cs1803,20170810,2001,2001,1990,2020,1990,2001,2003,0,2,6,120220,6
993,cs1803,20170811,2001,2003,2016,2016,2016,2016,2016,13,13,2,40320,6
994,cs1803,20170814,2016,2016,2030,2046,2030,2046,2038,30,22,4,81520,8
995,cs1803,20170815,2046,2038,2044,2044,2044,2044,2044,6,6,2,40880,6
996,cs1803,20170816,2044,2044,0,0,0,2044,2044,0,0,0,0,6
997,cs1803,20170817,2044,2044,0,0,0,2044,2044,0,0,0,0,6
998,cs1803,20170818,2044,2044,0,0,0,2044,2044,0,0,0,0,6
999,cs1803,20170821,2044,2044,2068,2068,2068,2068,2068,24,24,2,41360,6
1000,cs1803,20170822,2068,2068,2035,2055,2035,2055,2045,-13,-23,4,81800,6
1001,cs1803,20170823,2055,2045,2055,2055,2055,2055,2055,10,10,2,41100,6
1002,cs1803,20170824,2055,2055,0,0,0,2055,2055,0,0,0,0,6
1003,cs1803,20170825,2055,2055,0,0,0,2055,2055,0,0,0,0,6
1004,cs1803,20170828,2055,2055,0,0,0,2045,2045,-10,-10,0,0,6
1005,cs1803,20170829,2045,2045,0,0,0,2028,2028,-17,-17,0,0,6
1006,cs1803,20170830,2028,2028,0,0,0,2009,2009,-19,-19,0,0,6
1007,cs1803,20170831,2009,2009,0,0,0,2000,2000,-9,-9,0,0,6
1008,cs1803,20170901,2000,2000,0,0,0,2000,2000,0,0,0,0,6
1009,cs1803,20170904,2000,2000,0,0,0,2032,2032,32,32,0,0,6
1010,cs1803,20170905,2032,2032,0,0,0,2032,2032,0,0,0,0,6
1011,cs1803,20170906,2032,2032,0,0,0,2032,2032,0,0,0,0,6
1012,cs1803,20170907,2032,2032,0,0,0,2030,2030,-2,-2,0,0,6
1013,cs1803,20170908,2030,2030,0,0,0,2002,2002,-28,-28,0,0,6
1014,cs1803,20170911,2002,2002,0,0,0,2002,2002,0,0,0,0,6
1015,cs1803,20170912,2002,2002,0,0,0,2002,2002,0,0,0,0,6
1016,cs1803,20170913,2002,2002,1974,2000,1967,1967,1982,-35,-20,14,277600,6
1017,cs1803,20170914,1967,1982,1993,2005,1993,2005,1999,23,17,4,79960,6
1018,cs1803,20170915,2005,1999,1978,2000,1972,1972,1983,-27,-16,38,753740,6
1019,cs1803,20170918,1972,1983,1983,2000,1978,1983,1986,0,3,158,3139160,8
1020,cs1803,20170919,1983,1986,1988,2000,1980,1982,1988,-4,2,208,4135520,8
1021,cs1803,20170920,1982,1988,0,0,0,1987,1987,-1,-1,0,0,8
1022,cs1803,20170921,1987,1987,1983,1987,1983,1987,1985,0,-2,6,119120,8
1023,cs1803,20170922,1987,1985,1990,2014,1990,2014,2004,29,19,6,120280,10
1024,cs1803,20170925,2014,2004,2000,2016,1995,2016,2008,12,4,74,1486500,8
1025,cs1803,20170926,2016,2008,2015,2024,2015,2024,2019,16,11,4,80780,8
1026,cs1803,20170927,2024,2019,2021,2021,2021,2021,2021,2,2,2,40420,6
1027,cs1803,20170928,2021,2021,2010,2010,1986,1986,1998,-35,-23,4,79920,8
1028,cs1803,20170929,1986,1998,1998,1998,1998,1998,1998,0,0,2,39960,6
1029,cs1803,20171009,1998,1998,0,0,0,1998,1998,0,0,0,0,6
1030,cs1803,20171010,1998,1998,0,0,0,1992,1992,-6,-6,0,0,6
1031,cs1803,20171011,1992,1992,0,0,0,1991,1991,-1,-1,0,0,6
1032,cs1803,20171012,1991,1991,0,0,0,1990,1990,-1,-1,0,0,6
1033,cs1803,20171013,1990,1990,0,0,0,1990,1990,0,0,0,0,6
1034,cs1803,20171016,1990,1990,0,0,0,1990,1990,0,0,0,0,6
1035,cs1803,20171017,1990,1990,0,0,0,1990,1990,0,0,0,0,6
1036,cs1803,20171018,1990,1990,0,0,0,1990,1990,0,0,0,0,6
1037,cs1803,20171019,1990,1990,0,0,0,1990,1990,0,0,0,0,6
1038,cs1803,20171020,1990,1990,0,0,0,1990,1990,0,0,0,0,6
1039,cs1803,20171023,1990,1990,0,0,0,1980,1980,-10,-10,0,0,6
1040,cs1803,20171024,1980,1980,0,0,0,1980,1980,0,0,0,0,6
1041,cs1803,20171025,1980,1980,0,0,0,1980,1980,0,0,0,0,6
1042,cs1803,20171026,1980,1980,0,0,0,1980,1980,0,0,0,0,6
1043,cs1803,20171027,1980,1980,0,0,0,1973,1973,-7,-7,0,0,6
1044,cs1803,20171030,1973,1973,0,0,0,1955,1955,-18,-18,0,0,6
1045,cs1803,20171031,1955,1955,0,0,0,1955,1955,0,0,0,0,6
1046,cs1803,20171101,1955,1955,0,0,0,1976,1976,21,21,0,0,6
1047,cs1803,20171102,1976,1976,0,0,0,1976,1976,0,0,0,0,6
1048,cs1803,20171103,1976,1976,0,0,0,1992,1992,16,16,0,0,6
1049,cs1803,20171106,1992,1992,0,0,0,1995,1995,3,3,0,0,6
1050,cs1803,20171107,1995,1995,0,0,0,2008,2008,13,13,0,0,6
1051,cs1803,20171108,2008,2008,2028,2066,2022,2066,2038,58,30,6,122320,12
1052,cs1803,20171109,2066,2038,2084,2084,2045,2076,2062,38,24,18,371320,12
1053,cs1803,20171110,2076,2062,2078,2088,2053,2065,2070,3,8,18,372700,12
1054,cs1803,20171113,2065,2070,2070,2092,2049,2092,2073,22,3,22,456180,16
1055,cs1803,20171114,2092,2073,2085,2149,2085,2149,2114,76,41,38,803320,18
1056,cs1803,20171115,2149,2114,2214,2214,2130,2156,2149,42,35,14,300880,16
1057,cs1803,20171116,2156,2149,2129,2135,2118,2118,2127,-31,-22,6,127640,14
1058,cs1803,20171117,2118,2127,2083,2103,2052,2061,2077,-66,-50,16,332380,10
1059,cs1803,20171120,2061,2077,0,0,0,2077,2077,0,0,0,0,10
1060,cs1803,20171121,2077,2077,2055,2087,2055,2060,2067,-17,-10,6,124040,8
1061,cs1803,20171122,2060,2067,0,0,0,2067,2067,0,0,0,0,8
1062,cs1803,20171123,2067,2067,2070,2073,2064,2073,2069,6,2,6,124140,8
1063,cs1803,20171124,2073,2069,2083,2083,2083,2083,2083,14,14,2,41660,6
1064,cs1803,20171127,2083,2083,0,0,0,2083,2083,0,0,0,0,6
1065,cs1803,20171128,2083,2083,2060,2091,2060,2091,2075,8,-8,4,83020,6
1066,cs1803,20171129,2091,2075,0,0,0,2075,2075,0,0,0,0,6
1067,cs1803,20171130,2075,2075,2080,2080,2058,2058,2065,-17,-10,12,247900,4
1068,cs1803,20171201,2058,2065,2066,2066,2066,2066,2066,1,1,2,41320,2
1069,cs1803,20171204,2066,2066,2110,2110,2081,2081,2097,15,31,6,125820,2
1070,cs1803,20171205,2081,2097,0,0,0,2096,2096,-1,-1,0,0,2
1071,cs1803,20171206,2096,2096,0,0,0,2096,2096,0,0,0,0,2
1072,cs1803,20171207,2096,2096,0,0,0,2078,2078,-18,-18,0,0,2
1073,cs1803,20171208,2078,2078,0,0,0,2078,2078,0,0,0,0,2
1074,cs1803,20171211,2078,2078,2087,2087,2076,2080,2081,2,3,6,124860,8
1075,cs1803,20171212,2080,2081,0,0,0,2081,2081,0,0,0,0,8
1076,cs1803,20171213,2081,2081,0,0,0,2081,2081,0,0,0,0,8
1077,cs1803,20171214,2081,2081,0,0,0,2081,2081,0,0,0,0,8
1078,cs1803,20171215,2081,2081,2061,2107,2061,2107,2084,26,3,4,83360,8
1079,cs1803,20171218,2107,2084,2118,2118,2118,2118,2118,34,34,2,42360,8
1080,cs1803,20171219,2118,2118,2118,2119,2118,2119,2118,1,0,4,84740,8
1081,cs1803,20171220,2119,2118,2147,2147,2101,2101,2124,-17,6,4,84960,10
1082,cs1803,20171221,2101,2124,2114,2149,2113,2149,2131,25,7,8,170500,10
1083,cs1803,20171222,2149,2131,0,0,0,2131,2131,0,0,0,0,10
1084,cs1803,20171225,2131,2131,0,0,0,2120,2120,-11,-11,0,0,10
1085,cs1803,20171226,2120,2120,0,0,0,2120,2120,0,0,0,0,10
1086,cs1803,20171227,2120,2120,0,0,0,2113,2113,-7,-7,0,0,10
1087,cs1803,20171228,2113,2113,2110,2111,2110,2111,2110,-2,-3,4,84420,12
1088,cs1803,20171229,2111,2110,0,0,0,2110,2110,0,0,0,0,12
1089,cs1805,20170516,1979,1979,1945,1974,1945,1974,1964,-5,-15,1138,22351620,962
1090,cs1805,20170517,1974,1964,2015,2015,1977,1981,1981,17,17,398,7888280,1258
1091,cs1805,20170518,1981,1981,1979,1982,1968,1972,1971,-9,-10,646,12735320,1472
1092,cs1805,20170519,1972,1971,1968,1981,1968,1974,1976,3,5,496,9802480,1750
1093,cs1805,20170522,1974,1976,1978,1989,1966,1979,1972,3,-4,1750,34524720,2522
1094,cs1805,20170523,1979,1972,1977,1981,1971,1973,1975,1,3,298,5886600,2680
1095,cs1805,20170524,1973,1975,1970,1986,1965,1977,1977,2,2,238,4707160,2674
1096,cs1805,20170525,1977,1977,1986,1999,1975,1982,1981,5,4,204,4042140,2686
1097,cs1805,20170526,1982,1981,1977,1982,1973,1982,1977,1,-4,628,12418120,2766
1098,cs1805,20170531,1982,1977,1984,1984,1975,1977,1978,0,1,320,6331600,2960
1099,cs1805,20170601,1977,1978,1980,1994,1977,1990,1984,12,6,988,19609880,3234
1100,cs1805,20170602,1990,1984,1986,2003,1986,2001,1994,17,10,456,9096900,3284
1101,cs1805,20170605,2001,1994,2006,2019,2000,2015,2010,21,16,962,19338800,3628
1102,cs1805,20170606,2015,2010,2014,2015,2007,2011,2010,1,0,596,11984220,3670
1103,cs1805,20170607,2011,2010,2016,2026,2014,2016,2020,6,10,436,8809520,3664
1104,cs1805,20170608,2016,2020,2021,2023,2006,2011,2012,-9,-8,718,14449360,3662
1105,cs1805,20170609,2011,2012,2013,2047,2011,2046,2035,34,23,1100,22389640,3888
1106,cs1805,20170612,2046,2035,2047,2065,2042,2064,2051,29,16,946,19410840,4056
1107,cs1805,20170613,2064,2051,2064,2065,2051,2051,2056,0,5,650,13369300,4038
1108,cs1805,20170614,2051,2056,2055,2061,2043,2055,2050,-1,-6,596,12221520,4066
1109,cs1805,20170615,2055,2050,2055,2064,2042,2056,2054,6,4,398,8176720,3976
1110,cs1805,20170616,2056,2054,2056,2151,2048,2052,2062,-2,8,618,12744180,3984
1111,cs1805,20170619,2052,2062,2052,2061,2045,2046,2053,-16,-9,760,15608860,4474
1112,cs1805,20170620,2046,2053,2044,2045,2027,2033,2032,-20,-21,1028,20895060,4856
1113,cs1805,20170621,2033,2032,2030,2051,2030,2047,2044,15,12,940,19213620,4864
1114,cs1805,20170622,2047,2044,2044,2049,2040,2043,2043,-1,-1,512,10463000,5278
1115,cs1805,20170623,2043,2043,2050,2060,2048,2056,2056,13,13,892,18345740,5170
1116,cs1805,20170626,2056,2056,2059,2081,2059,2072,2074,16,18,1032,21413520,5132
1117,cs1805,20170627,2072,2074,2069,2075,2062,2073,2070,-1,-4,520,10769140,5100
1118,cs1805,20170628,2073,2070,2079,2085,2056,2056,2070,-14,0,996,20621360,5134
1119,cs1805,20170629,2056,2070,2061,2063,2055,2056,2059,-14,-11,480,9886380,5194
1120,cs1805,20170630,2056,2059,2063,2066,2048,2053,2055,-6,-4,410,8426520,5066
1121,cs1805,20170703,2053,2055,2078,2078,2049,2051,2054,-4,-1,476,9778900,5122
1122,cs1805,20170704,2051,2054,2049,2050,2035,2036,2041,-18,-13,676,13797500,5334
1123,cs1805,20170705,2036,2041,2030,2046,2030,2038,2039,-3,-2,592,12075860,5110
1124,cs1805,20170706,2038,2039,2047,2048,2026,2033,2031,-6,-8,772,15685960,5442
1125,cs1805,20170707,2033,2031,2045,2048,2038,2048,2044,17,13,654,13369400,5464
1126,cs1805,20170710,2048,2044,2050,2062,2040,2041,2052,-3,8,674,13836320,5598
1127,cs1805,20170711,2041,2052,2048,2054,2044,2048,2049,-4,-3,364,7458920,5610
1128,cs1805,20170712,2048,2049,2053,2053,2043,2046,2048,-3,-1,944,19339220,5564
1129,cs1805,20170713,2046,2048,2039,2044,2025,2029,2030,-19,-18,3210,65187720,7812
1130,cs1805,20170714,2029,2030,2022,2030,2019,2028,2026,-2,-4,364,7376600,7820
1131,cs1805,20170717,2028,2026,2028,2032,2010,2032,2022,6,-4,1448,29281300,8308
1132,cs1805,20170718,2032,2022,2036,2040,2025,2025,2032,3,10,2260,45935400,7970
1133,cs1805,20170719,2025,2032,2027,2032,2020,2022,2023,-10,-9,960,19425100,8128
1134,cs1805,20170720,2022,2023,2036,2036,2020,2027,2027,4,4,358,7258100,8178
1135,cs1805,20170721,2027,2027,2022,2033,2019,2022,2022,-5,-5,1158,23425080,8750
1136,cs1805,20170724,2022,2022,2012,2015,1998,2001,2005,-21,-17,4064,81501900,10992
1137,cs1805,20170725,2001,2005,2001,2010,2001,2008,2005,3,0,1212,24312480,11040
1138,cs1805,20170726,2008,2005,2000,2007,1995,1995,1998,-10,-7,1860,37176160,11840
1139,cs1805,20170727,1995,1998,2000,2005,1998,2002,2001,4,3,544,10887860,11796
1140,cs1805,20170728,2002,2001,2002,2008,1994,2003,2002,2,1,2746,54990220,12844
1141,cs1805,20170731,2003,2002,1997,2002,1990,1994,1993,-8,-9,3104,61888740,15080
1142,cs1805,20170801,1994,1993,1994,2002,1993,1996,1997,3,4,2372,47386500,15106
1143,cs1805,20170802,1996,1997,1990,1994,1984,1988,1987,-9,-10,3014,59914060,15618
1144,cs1805,20170803,1988,1987,1990,1998,1988,1991,1992,4,5,2566,51116700,15312
1145,cs1805,20170804,1991,1992,1990,2000,1990,1992,1995,0,3,3154,62949820,15162
1146,cs1805,20170807,1992,1995,1992,2000,1964,1988,1987,-7,-8,2774,55121120,15700
1147,cs1805,20170808,1988,1987,1993,1997,1989,1991,1992,4,5,4150,82684880,16390
1148,cs1805,20170809,1991,1992,1998,2032,1998,2031,2013,39,21,7884,158770120,18596
1149,cs1805,20170810,2031,2013,2031,2034,2020,2032,2026,19,13,4630,93847440,17962
1150,cs1805,20170811,2032,2026,2013,2051,2013,2051,2030,25,4,5898,119784140,16218
1151,cs1805,20170814,2051,2030,2053,2080,2042,2043,2049,13,19,4364,89457240,16138
1152,cs1805,20170815,2043,2049,2043,2062,2037,2048,2048,-1,-1,5252,107597900,17130
1153,cs1805,20170816,2048,2048,2048,2055,2040,2048,2048,0,0,2842,58222900,16312
1154,cs1805,20170817,2048,2048,2055,2068,2048,2060,2059,12,11,4362,89832820,16926
1155,cs1805,20170818,2060,2059,2057,2067,2057,2064,2061,5,2,2362,48689900,16366
1156,cs1805,20170821,2064,2061,2065,2077,2051,2058,2063,-3,2,4950,102142100,14744
1157,cs1805,20170822,2058,2063,2059,2080,2050,2074,2067,11,4,4580,94676000,14678
1158,cs1805,20170823,2074,2067,2069,2080,2056,2056,2069,-11,2,3000,62094540,15208
1159,cs1805,20170824,2056,2069,2053,2066,2053,2064,2060,-5,-9,2050,42241960,15812
1160,cs1805,20170825,2064,2060,2062,2071,2050,2054,2060,-6,0,3022,62255120,16936
1161,cs1805,20170828,2054,2060,2059,2060,2043,2050,2050,-10,-10,3288,67405680,17360
1162,cs1805,20170829,2050,2050,2050,2054,2026,2027,2036,-23,-14,5360,109159140,17776
1163,cs1805,20170830,2027,2036,2027,2027,2011,2012,2017,-24,-19,7300,147253080,18810
1164,cs1805,20170831,2012,2017,2014,2017,2007,2007,2010,-10,-7,4698,94465540,19188
1165,cs1805,20170901,2007,2010,2019,2026,2012,2013,2020,3,10,8716,176138200,22686
1166,cs1805,20170904,2013,2020,2017,2067,2016,2059,2047,39,27,13266,271636180,21234
1167,cs1805,20170905,2059,2047,2065,2067,2048,2052,2055,5,8,14872,305713180,24790
1168,cs1805,20170906,2052,2055,2053,2069,2053,2055,2061,0,6,11544,237931720,25926
1169,cs1805,20170907,2055,2061,2056,2068,2055,2061,2061,0,0,5480,112949380,26544
1170,cs1805,20170908,2061,2061,2058,2066,2010,2013,2030,-48,-31,15162,307842160,27076
1171,cs1805,20170911,2013,2030,2015,2021,2005,2014,2014,-16,-16,7156,144191860,28644
1172,cs1805,20170912,2014,2014,2018,2024,2002,2012,2010,-2,-4,9026,181512360,30744
1173,cs1805,20170913,2012,2010,2013,2015,1994,2002,2002,-8,-8,22890,458429280,43106
1174,cs1805,20170914,2002,2002,2006,2029,2005,2007,2015,5,13,19906,401251420,45222
1175,cs1805,20170915,2007,2015,2011,2012,2001,2004,2006,-11,-9,10826,217244400,47032
1176,cs1805,20170918,2004,2006,2005,2009,1995,2003,2004,-3,-2,8322,166816280,47712
1177,cs1805,20170919,2003,2004,2005,2020,2003,2008,2008,4,4,10984,220644520,47886
1178,cs1805,20170920,2008,2008,2008,2021,1997,2005,2012,-3,4,21750,437622620,47358
1179,cs1805,20170921,2005,2012,2005,2019,2004,2016,2009,4,-3,16274,326958300,46164
1180,cs1805,20170922,2016,2009,2010,2046,2010,2028,2032,19,23,26940,547521700,41066
1181,cs1805,20170925,2028,2032,2028,2034,2020,2028,2024,-4,-8,9798,198403920,40278
1182,cs1805,20170926,2028,2024,2024,2043,2023,2032,2031,8,7,7522,152846820,40754
1183,cs1805,20170927,2032,2031,2032,2041,2023,2037,2030,6,-1,12542,254710780,41348
1184,cs1805,20170928,2037,2030,2035,2035,2004,2008,2017,-22,-13,16280,328371640,38212
1185,cs1805,20170929,2008,2017,2005,2013,2002,2010,2008,-7,-9,8462,169935000,38972
1186,cs1805,20171009,2010,2008,2001,2003,1976,1983,1987,-25,-21,16404,325953240,43642
1187,cs1805,20171010,1983,1987,1985,1990,1981,1984,1986,-3,-1,9638,191472880,47746
1188,cs1805,20171011,1984,1986,1984,1991,1984,1988,1986,2,0,9280,184375300,48960
1189,cs1805,20171012,1988,1986,1988,1993,1982,1990,1987,4,1,12154,241528440,48066
1190,cs1805,20171013,1990,1987,1999,2002,1989,1991,1995,4,8,9514,189820160,45940
1191,cs1805,20171016,1991,1995,1994,1998,1986,1992,1991,-3,-4,10626,211571740,48030
1192,cs1805,20171017,1992,1991,1990,1999,1989,1996,1996,5,5,10336,206320540,46698
1193,cs1805,20171018,1996,1996,1999,2008,1994,1997,1997,1,1,6188,123600280,46278
1194,cs1805,20171019,1997,1997,1994,2002,1985,1994,1996,-3,-1,17042,340201780,48648
1195,cs1805,20171020,1994,1996,1994,2000,1989,1990,1994,-6,-2,16372,326549620,53428
1196,cs1805,20171023,1990,1994,1988,1991,1981,1985,1985,-9,-9,11246,223305200,56288
1197,cs1805,20171024,1985,1985,1990,1995,1970,1976,1978,-9,-7,26548,525295200,66258
1198,cs1805,20171025,1976,1978,1979,2007,1979,2001,1993,23,15,27510,548345720,61654
1199,cs1805,20171026,2001,1993,2000,2008,1995,2007,2000,14,7,18928,378662420,56344
1200,cs1805,20171027,2007,2000,2012,2012,1992,1992,2002,-8,2,17944,359296780,58052
1201,cs1805,20171030,1992,2002,2000,2000,1977,1979,1982,-23,-20,26080,516999900,64668
1202,cs1805,20171031,1979,1982,1979,1986,1976,1982,1982,0,0,7014,139064300,65102
1203,cs1805,20171101,1982,1982,1979,2009,1979,2001,1999,19,17,42010,840192920,70462
1204,cs1805,20171102,2001,1999,2002,2006,1997,2002,2001,3,2,12256,245274580,69998
1205,cs1805,20171103,2002,2001,2002,2024,2002,2024,2014,23,13,33204,668816900,75612
1206,cs1805,20171106,2024,2014,2022,2030,2015,2022,2020,8,6,20820,420760960,81740
1207,cs1805,20171107,2022,2020,2023,2028,2011,2025,2018,5,-2,33746,681186440,88112
1208,cs1805,20171108,2025,2018,2027,2059,2017,2045,2035,27,17,92412,1880757080,110426
1209,cs1805,20171109,2045,2035,2043,2049,2028,2044,2036,9,1,47448,966353300,112762
1210,cs1805,20171110,2044,2036,2042,2052,2029,2050,2038,14,2,66536,1356547780,123754
1211,cs1805,20171113,2050,2038,2051,2065,2045,2057,2054,19,16,65688,1349834380,142940
1212,cs1805,20171114,2057,2054,2056,2115,2052,2096,2083,42,29,161152,3358093960,181154
1213,cs1805,20171115,2096,2083,2080,2102,2068,2088,2083,5,0,95698,1994307500,184090
1214,cs1805,20171116,2088,2083,2090,2096,2073,2076,2081,-7,-2,55024,1145590480,191828
1215,cs1805,20171117,2076,2081,2072,2078,2050,2055,2062,-26,-19,86992,1794606300,187582
1216,cs1805,20171120,2055,2062,2060,2073,2057,2070,2067,8,5,56492,1167963060,201902
1217,cs1805,20171121,2070,2067,2076,2085,2063,2072,2070,5,3,65276,1351820100,198936
1218,cs1805,20171122,2072,2070,2075,2087,2073,2075,2078,5,8,46524,967187220,200758
1219,cs1805,20171123,2075,2078,2085,2086,2070,2072,2076,-6,-2,51364,1066381060,200076
1220,cs1805,20171124,2072,2076,2075,2090,2064,2069,2076,-7,0,72522,1505913740,203700
1221,cs1805,20171127,2069,2076,2074,2084,2071,2077,2079,1,3,52488,1091362240,210352
1222,cs1805,20171128,2077,2079,2075,2096,2072,2082,2083,3,4,74696,1556243780,212882
1223,cs1805,20171129,2082,2083,2085,2098,2082,2086,2088,3,5,81950,1711798960,218544
1224,cs1805,20171130,2086,2088,2087,2095,2070,2071,2079,-17,-9,86948,1808314960,213182
1225,cs1805,20171201,2071,2079,2070,2073,2052,2068,2062,-11,-17,113616,2343125480,215136
1226,cs1805,20171204,2068,2062,2073,2114,2069,2106,2097,44,35,214328,4495404960,277334
1227,cs1805,20171205,2106,2097,2100,2128,2086,2106,2110,9,13,319624,6745885960,328018
1228,cs1805,20171206,2106,2110,2108,2134,2105,2130,2122,20,12,273654,5808050600,384758
1229,cs1805,20171207,2130,2122,2125,2129,2081,2091,2100,-31,-22,322722,6777241080,331818
1230,cs1805,20171208,2091,2100,2093,2098,2084,2087,2089,-13,-11,113402,2369976760,327088
1231,cs1805,20171211,2087,2089,2088,2102,2064,2066,2077,-23,-12,275010,5713776400,330764
1232,cs1805,20171212,2066,2077,2071,2078,2062,2068,2071,-9,-6,179250,3712407660,325634
1233,cs1805,20171213,2068,2071,2066,2086,2065,2084,2076,13,5,133764,2777828620,321170
1234,cs1805,20171214,2084,2076,2085,2118,2084,2099,2103,23,27,296658,6241192640,362796
1235,cs1805,20171215,2099,2103,2095,2104,2087,2101,2095,-2,-8,137202,2875640900,339854
1236,cs1805,20171218,2101,2095,2103,2147,2103,2146,2132,51,37,286470,6107635200,391974
1237,cs1805,20171219,2146,2132,2150,2157,2133,2134,2143,2,11,185172,3969258080,391498
1238,cs1805,20171220,2134,2143,2138,2150,2128,2142,2138,-1,-5,150370,3216208200,374718
1239,cs1805,20171221,2142,2138,2145,2154,2136,2141,2144,3,6,147548,3163553120,380768
1240,cs1805,20171222,2141,2144,2144,2151,2124,2138,2134,-6,-10,182272,3889940220,367012
1241,cs1805,20171225,2138,2134,2138,2140,2092,2107,2109,-27,-25,263356,5555553480,354596
1242,cs1805,20171226,2107,2109,2105,2120,2100,2117,2112,8,3,115082,2431292400,339516
1243,cs1805,20171227,2117,2112,2118,2131,2113,2123,2121,11,9,153458,3255445420,329870
1244,cs1805,20171228,2123,2121,2124,2133,2113,2120,2119,-1,-2,115238,2442144660,330404
1245,cs1805,20171229,2120,2119,2122,2130,2115,2123,2122,4,3,107298,2277085960,322860
1246,cs1807,20170717,2026,2026,1990,2060,1990,2060,2025,34,-1,4,81000,0
1247,cs1807,20170718,2060,2025,0,0,0,2025,2025,0,0,0,0,0
1248,cs1807,20170719,2025,2025,0,0,0,2025,2025,0,0,0,0,0
1249,cs1807,20170720,2025,2025,0,0,0,2029,2029,4,4,0,0,0
1250,cs1807,20170721,2029,2029,0,0,0,2029,2029,0,0,0,0,0
1251,cs1807,20170724,2029,2029,0,0,0,2023,2023,-6,-6,0,0,0
1252,cs1807,20170725,2023,2023,0,0,0,2023,2023,0,0,0,0,0
1253,cs1807,20170726,2023,2023,0,0,0,2016,2016,-7,-7,0,0,0
1254,cs1807,20170727,2016,2016,2041,2041,2001,2001,2021,-15,5,4,80840,0
1255,cs1807,20170728,2001,2021,0,0,0,2021,2021,0,0,0,0,0
1256,cs1807,20170731,2021,2021,0,0,0,2021,2021,0,0,0,0,0
1257,cs1807,20170801,2021,2021,0,0,0,2025,2025,4,4,0,0,0
1258,cs1807,20170802,2025,2025,0,0,0,1997,1997,-28,-28,0,0,0
1259,cs1807,20170803,1997,1997,0,0,0,1997,1997,0,0,0,0,0
1260,cs1807,20170804,1997,1997,0,0,0,1997,1997,0,0,0,0,0
1261,cs1807,20170807,1997,1997,0,0,0,1997,1997,0,0,0,0,0
1262,cs1807,20170808,1997,1997,0,0,0,1997,1997,0,0,0,0,0
1263,cs1807,20170809,1997,1997,0,0,0,2018,2018,21,21,0,0,0
1264,cs1807,20170810,2018,2018,0,0,0,2018,2018,0,0,0,0,0
1265,cs1807,20170811,2018,2018,0,0,0,2018,2018,0,0,0,0,0
1266,cs1807,20170814,2018,2018,0,0,0,2018,2018,0,0,0,0,0
1267,cs1807,20170815,2018,2018,0,0,0,2018,2018,0,0,0,0,0
1268,cs1807,20170816,2018,2018,2047,2047,2047,2047,2047,29,29,2,40940,2
1269,cs1807,20170817,2047,2047,2100,2100,2100,2100,2100,53,53,2,42000,0
1270,cs1807,20170818,2100,2100,0,0,0,2091,2091,-9,-9,0,0,0
1271,cs1807,20170821,2091,2091,0,0,0,2093,2093,2,2,0,0,0
1272,cs1807,20170822,2093,2093,0,0,0,2093,2093,0,0,0,0,0
1273,cs1807,20170823,2093,2093,0,0,0,2095,2095,2,2,0,0,0
1274,cs1807,20170824,2095,2095,0,0,0,2083,2083,-12,-12,0,0,0
1275,cs1807,20170825,2083,2083,0,0,0,2083,2083,0,0,0,0,0
1276,cs1807,20170828,2083,2083,0,0,0,2073,2073,-10,-10,0,0,0
1277,cs1807,20170829,2073,2073,0,0,0,2059,2059,-14,-14,0,0,0
1278,cs1807,20170830,2059,2059,0,0,0,2040,2040,-19,-19,0,0,0
1279,cs1807,20170831,2040,2040,0,0,0,2033,2033,-7,-7,0,0,0
1280,cs1807,20170901,2033,2033,0,0,0,2033,2033,0,0,0,0,0
1281,cs1807,20170904,2033,2033,0,0,0,2033,2033,0,0,0,0,0
1282,cs1807,20170905,2033,2033,0,0,0,2033,2033,0,0,0,0,0
1283,cs1807,20170906,2033,2033,0,0,0,2033,2033,0,0,0,0,0
1284,cs1807,20170907,2033,2033,0,0,0,2033,2033,0,0,0,0,0
1285,cs1807,20170908,2033,2033,0,0,0,2003,2003,-30,-30,0,0,0
1286,cs1807,20170911,2003,2003,0,0,0,2003,2003,0,0,0,0,0
1287,cs1807,20170912,2003,2003,0,0,0,2003,2003,0,0,0,0,0
1288,cs1807,20170913,2003,2003,0,0,0,2003,2003,0,0,0,0,0
1289,cs1807,20170914,2003,2003,0,0,0,2003,2003,0,0,0,0,0
1290,cs1807,20170915,2003,2003,0,0,0,2003,2003,0,0,0,0,0
1291,cs1807,20170918,2003,2003,0,0,0,2003,2003,0,0,0,0,0
1292,cs1807,20170919,2003,2003,2042,2042,2013,2013,2027,10,24,4,81100,0
1293,cs1807,20170920,2013,2027,0,0,0,2027,2027,0,0,0,0,0
1294,cs1807,20170921,2027,2027,0,0,0,2027,2027,0,0,0,0,0
1295,cs1807,20170922,2027,2027,0,0,0,2027,2027,0,0,0,0,0
1296,cs1807,20170925,2027,2027,0,0,0,2020,2020,-7,-7,0,0,0
1297,cs1807,20170926,2020,2020,2058,2058,2033,2033,2045,13,25,4,81820,0
1298,cs1807,20170927,2033,2045,0,0,0,2045,2045,0,0,0,0,0
1299,cs1807,20170928,2045,2045,0,0,0,2032,2032,-13,-13,0,0,0
1300,cs1807,20170929,2032,2032,0,0,0,2032,2032,0,0,0,0,0
1301,cs1807,20171009,2032,2032,0,0,0,2011,2011,-21,-21,0,0,0
1302,cs1807,20171010,2011,2011,0,0,0,2010,2010,-1,-1,0,0,0
1303,cs1807,20171011,2010,2010,0,0,0,2010,2010,0,0,0,0,0
1304,cs1807,20171012,2010,2010,0,0,0,2010,2010,0,0,0,0,0
1305,cs1807,20171013,2010,2010,0,0,0,2010,2010,0,0,0,0,0
1306,cs1807,20171016,2010,2010,0,0,0,2010,2010,0,0,0,0,0
1307,cs1807,20171017,2010,2010,0,0,0,2010,2010,0,0,0,0,0
1308,cs1807,20171018,2010,2010,0,0,0,2010,2010,0,0,0,0,0
1309,cs1807,20171019,2010,2010,0,0,0,2010,2010,0,0,0,0,0
1310,cs1807,20171020,2010,2010,0,0,0,2010,2010,0,0,0,0,0
1311,cs1807,20171023,2010,2010,0,0,0,2010,2010,0,0,0,0,0
1312,cs1807,20171024,2010,2010,2020,2020,2020,2020,2020,10,10,2,40400,2
1313,cs1807,20171025,2020,2020,0,0,0,2020,2020,0,0,0,0,2
1314,cs1807,20171026,2020,2020,0,0,0,2020,2020,0,0,0,0,2
1315,cs1807,20171027,2020,2020,0,0,0,2020,2020,0,0,0,0,2
1316,cs1807,20171030,2020,2020,0,0,0,2000,2000,-20,-20,0,0,2
1317,cs1807,20171031,2000,2000,0,0,0,2000,2000,0,0,0,0,2
1318,cs1807,20171101,2000,2000,0,0,0,2017,2017,17,17,0,0,2
1319,cs1807,20171102,2017,2017,0,0,0,2017,2017,0,0,0,0,2
1320,cs1807,20171103,2017,2017,0,0,0,2017,2017,0,0,0,0,2
1321,cs1807,20171106,2017,2017,0,0,0,2017,2017,0,0,0,0,2
1322,cs1807,20171107,2017,2017,0,0,0,2016,2016,-1,-1,0,0,2
1323,cs1807,20171108,2016,2016,2025,2064,2025,2064,2038,48,22,6,122280,4
1324,cs1807,20171109,2064,2038,2058,2058,2058,2058,2058,20,20,2,41160,4
1325,cs1807,20171110,2058,2058,2060,2072,2060,2064,2064,6,6,16,330340,4
1326,cs1807,20171113,2064,2064,0,0,0,2080,2080,16,16,0,0,4
1327,cs1807,20171114,2080,2080,0,0,0,2109,2109,29,29,0,0,4
1328,cs1807,20171115,2109,2109,0,0,0,2109,2109,0,0,0,0,4
1329,cs1807,20171116,2109,2109,0,0,0,2107,2107,-2,-2,0,0,4
1330,cs1807,20171117,2107,2107,2067,2067,2067,2067,2067,-40,-40,2,41340,4
1331,cs1807,20171120,2067,2067,2082,2082,2082,2082,2082,15,15,2,41640,4
1332,cs1807,20171121,2082,2082,0,0,0,2082,2082,0,0,0,0,4
1333,cs1807,20171122,2082,2082,0,0,0,2082,2082,0,0,0,0,4
1334,cs1807,20171123,2082,2082,0,0,0,2082,2082,0,0,0,0,4
1335,cs1807,20171124,2082,2082,0,0,0,2082,2082,0,0,0,0,4
1336,cs1807,20171127,2082,2082,0,0,0,2082,2082,0,0,0,0,4
1337,cs1807,20171128,2082,2082,0,0,0,2082,2082,0,0,0,0,4
1338,cs1807,20171129,2082,2082,0,0,0,2082,2082,0,0,0,0,4
1339,cs1807,20171130,2082,2082,0,0,0,2082,2082,0,0,0,0,4
1340,cs1807,20171201,2082,2082,0,0,0,2082,2082,0,0,0,0,4
1341,cs1807,20171204,2082,2082,2119,2124,2117,2124,2120,42,38,6,127200,2
1342,cs1807,20171205,2124,2120,0,0,0,2120,2120,0,0,0,0,2
1343,cs1807,20171206,2120,2120,0,0,0,2132,2132,12,12,0,0,2
1344,cs1807,20171207,2132,2132,0,0,0,2110,2110,-22,-22,0,0,2
1345,cs1807,20171208,2110,2110,2121,2121,2114,2119,2118,9,8,8,169500,4
1346,cs1807,20171211,2119,2118,2102,2102,2102,2102,2102,-16,-16,2,42040,6
1347,cs1807,20171212,2102,2102,0,0,0,2102,2102,0,0,0,0,6
1348,cs1807,20171213,2102,2102,0,0,0,2102,2102,0,0,0,0,6
1349,cs1807,20171214,2102,2102,0,0,0,2102,2102,0,0,0,0,6
1350,cs1807,20171215,2102,2102,0,0,0,2102,2102,0,0,0,0,6
1351,cs1807,20171218,2102,2102,2141,2141,2141,2141,2141,39,39,2,42820,6
1352,cs1807,20171219,2141,2141,2200,2200,2200,2200,2200,59,59,2,44000,6
1353,cs1807,20171220,2200,2200,2151,2160,2151,2160,2155,-40,-45,4,86220,6
1354,cs1807,20171221,2160,2155,0,0,0,2159,2159,4,4,0,0,6
1355,cs1807,20171222,2159,2159,0,0,0,2159,2159,0,0,0,0,6
1356,cs1807,20171225,2159,2159,0,0,0,2134,2134,-25,-25,0,0,6
1357,cs1807,20171226,2134,2134,0,0,0,2134,2134,0,0,0,0,6
1358,cs1807,20171227,2134,2134,0,0,0,2134,2134,0,0,0,0,6
1359,cs1807,20171228,2134,2134,2151,2157,2150,2157,2153,23,19,8,172280,14
1360,cs1807,20171229,2157,2153,0,0,0,2153,2153,0,0,0,0,14
1361,cs1809,20170915,2003,2003,2046,2085,2046,2081,2078,78,75,810,16836080,600
1362,cs1809,20170918,2081,2078,2079,2083,2072,2075,2080,-3,2,1182,24589240,1282
1363,cs1809,20170919,2075,2080,2078,2083,2076,2082,2080,2,0,210,4368260,1398
1364,cs1809,20170920,2082,2080,2082,2091,2075,2078,2085,-2,5,664,13845720,1708
1365,cs1809,20170921,2078,2085,2080,2087,2075,2087,2081,2,-4,94,1956380,1736
1366,cs1809,20170922,2087,2081,2088,2100,2084,2086,2091,5,10,1156,24178780,1926
1367,cs1809,20170925,2086,2091,2092,2092,2083,2089,2087,-2,-4,340,7097100,2096
1368,cs1809,20170926,2089,2087,2092,2099,2085,2094,2092,7,5,366,7658480,2280
1369,cs1809,20170927,2094,2092,2091,2098,2086,2097,2091,5,-1,768,16064980,2394
1370,cs1809,20170928,2097,2091,2088,2092,2080,2086,2084,-5,-7,1290,26889040,2122
1371,cs1809,20170929,2086,2084,2084,2088,2081,2086,2084,2,0,218,4543680,2094
1372,cs1809,20171009,2086,2084,2084,2084,2069,2070,2077,-14,-7,1052,21851000,2136
1373,cs1809,20171010,2070,2077,2073,2078,2071,2075,2076,-2,-1,296,6145920,2062
1374,cs1809,20171011,2075,2076,2078,2081,2073,2075,2076,-1,0,390,8096900,2136
1375,cs1809,20171012,2075,2076,2074,2079,2073,2076,2074,0,-2,290,6016340,2274
1376,cs1809,20171013,2076,2074,2074,2087,2074,2076,2081,2,7,466,9700480,2312
1377,cs1809,20171016,2076,2081,2085,2085,2076,2083,2080,2,-1,162,3370420,2366
1378,cs1809,20171017,2083,2080,2082,2092,2063,2082,2082,2,2,2162,45023360,2472
1379,cs1809,20171018,2082,2082,2088,2090,2083,2086,2085,4,3,190,3962180,2552
1380,cs1809,20171019,2086,2085,2080,2088,2078,2083,2081,-2,-4,244,5079560,2540
1381,cs1809,20171020,2083,2081,2086,2090,2075,2075,2084,-6,3,1398,29134400,2748
1382,cs1809,20171023,2075,2084,2077,2078,2068,2075,2074,-9,-10,342,7094780,2786
1383,cs1809,20171024,2075,2074,2077,2080,2064,2068,2072,-6,-2,566,11729960,2974
1384,cs1809,20171025,2068,2072,2071,2092,2071,2089,2082,17,10,346,7206440,2920
1385,cs1809,20171026,2089,2082,2082,2091,2082,2091,2086,9,4,276,5759680,2920
1386,cs1809,20171027,2091,2086,2091,2092,2078,2081,2085,-5,-1,506,10553940,2990
1387,cs1809,20171030,2081,2085,2079,2079,2060,2069,2068,-16,-17,624,12904660,3068
1388,cs1809,20171031,2069,2068,2064,2070,2051,2070,2064,2,-4,398,8216720,3078
1389,cs1809,20171101,2070,2064,2070,2089,2070,2078,2081,14,17,1136,23643140,3358
1390,cs1809,20171102,2078,2081,2087,2089,2076,2080,2080,-1,-1,618,12856140,3644
1391,cs1809,20171103,2080,2080,2087,2090,2045,2090,2073,10,-7,2504,51910380,4786
1392,cs1809,20171106,2090,2073,2082,2094,2082,2092,2088,19,15,1558,32533220,5314
1393,cs1809,20171107,2092,2088,2085,2094,2080,2090,2086,2,-2,1392,29045040,5158
1394,cs1809,20171108,2090,2086,2090,2116,2086,2109,2098,23,12,4596,96450980,7728
1395,cs1809,20171109,2109,2098,2109,2112,2092,2106,2098,8,0,2718,57041960,8514
1396,cs1809,20171110,2106,2098,2096,2109,2089,2107,2098,9,0,3922,82296380,10502
1397,cs1809,20171113,2107,2098,2104,2122,2104,2121,2116,23,18,3534,74814620,12034
1398,cs1809,20171114,2121,2116,2116,2164,2114,2147,2136,31,20,8794,187857700,14980
1399,cs1809,20171115,2147,2136,2140,2156,2123,2148,2142,12,6,8006,171500100,15670
1400,cs1809,20171116,2148,2142,2145,2166,2133,2136,2140,-6,-2,4856,103947000,17548
1401,cs1809,20171117,2136,2140,2132,2137,2114,2116,2121,-24,-19,5178,109876480,17120
1402,cs1809,20171120,2116,2121,2126,2133,2118,2131,2129,10,8,2104,44795800,17156
1403,cs1809,20171121,2131,2129,2131,2144,2127,2136,2134,7,5,2230,47593740,17528
1404,cs1809,20171122,2136,2134,2118,2150,2118,2141,2143,7,9,2706,57991380,17916
1405,cs1809,20171123,2141,2143,2142,2148,2134,2139,2140,-4,-3,2504,53604680,17528
1406,cs1809,20171124,2139,2140,2138,2152,2130,2135,2140,-5,0,3852,82455860,18466
1407,cs1809,20171127,2135,2140,2135,2145,2133,2140,2141,0,1,1684,36058160,18716
1408,cs1809,20171128,2140,2141,2140,2154,2136,2144,2143,3,2,2514,53897360,19092
1409,cs1809,20171129,2144,2143,2143,2158,2143,2149,2150,6,7,2112,45412900,19132
1410,cs1809,20171130,2149,2150,2149,2158,2140,2140,2146,-10,-4,3034,65135620,19540
1411,cs1809,20171201,2140,2146,2138,2139,2122,2137,2129,-9,-17,5098,108583820,21040
1412,cs1809,20171204,2137,2129,2137,2165,2137,2162,2153,33,24,8760,188628660,23652
1413,cs1809,20171205,2162,2153,2157,2180,2150,2159,2168,6,15,11470,248783520,26318
1414,cs1809,20171206,2159,2168,2156,2180,2156,2175,2172,7,4,9328,202607320,30568
1415,cs1809,20171207,2175,2172,2169,2177,2138,2143,2155,-29,-17,8132,175246380,29648
1416,cs1809,20171208,2143,2155,2143,2149,2141,2145,2144,-10,-11,3752,80466260,30484
1417,cs1809,20171211,2145,2144,2145,2153,2124,2128,2134,-16,-10,6902,147323900,30098
1418,cs1809,20171212,2128,2134,2128,2135,2126,2130,2131,-4,-3,2880,61375800,30498
1419,cs1809,20171213,2130,2131,2130,2145,2127,2144,2138,13,7,2366,50592400,30820
1420,cs1809,20171214,2144,2138,2139,2164,2139,2151,2156,13,18,14278,307853580,35810
1421,cs1809,20171215,2151,2156,2159,2159,2145,2152,2151,-4,-5,8500,182904560,37862
1422,cs1809,20171218,2152,2151,2157,2188,2156,2186,2176,35,25,30240,658222040,54856
1423,cs1809,20171219,2186,2176,2193,2196,2174,2177,2184,1,8,14448,315655580,56318
1424,cs1809,20171220,2177,2184,2180,2190,2171,2180,2181,-4,-3,16434,358557960,61390
1425,cs1809,20171221,2180,2181,2180,2193,2179,2184,2184,3,3,9732,212627180,62102
1426,cs1809,20171222,2184,2184,2184,2189,2172,2180,2178,-4,-6,17358,378184960,60488
1427,cs1809,20171225,2180,2178,2180,2181,2154,2161,2162,-17,-16,20394,441042280,62204
1428,cs1809,20171226,2161,2162,2162,2169,2157,2161,2163,-1,1,15892,343896200,66356
1429,cs1809,20171227,2161,2163,2162,2175,2158,2172,2168,9,5,19044,412994540,65868
1430,cs1809,20171228,2172,2168,2175,2179,2163,2170,2168,2,0,6912,149909520,67590
1431,cs1809,20171229,2170,2168,2169,2175,2166,2169,2169,1,1,6810,147769840,68468
1432,cs1811,20171115,2136,2136,0,0,0,2136,2136,0,0,0,0,0
1433,cs1811,20171116,2136,2136,0,0,0,2136,2136,0,0,0,0,0
1434,cs1811,20171117,2136,2136,0,0,0,2136,2136,0,0,0,0,0
1435,cs1811,20171120,2136,2136,0,0,0,2136,2136,0,0,0,0,0
1436,cs1811,20171121,2136,2136,0,0,0,2136,2136,0,0,0,0,0
1437,cs1811,20171122,2136,2136,0,0,0,2136,2136,0,0,0,0,0
1438,cs1811,20171123,2136,2136,0,0,0,2136,2136,0,0,0,0,0
1439,cs1811,20171124,2136,2136,0,0,0,2136,2136,0,0,0,0,0
1440,cs1811,20171127,2136,2136,0,0,0,2136,2136,0,0,0,0,0
1441,cs1811,20171128,2136,2136,0,0,0,2136,2136,0,0,0,0,0
1442,cs1811,20171129,2136,2136,0,0,0,2136,2136,0,0,0,0,0
1443,cs1811,20171130,2136,2136,0,0,0,2136,2136,0,0,0,0,0
1444,cs1811,20171201,2136,2136,0,0,0,2136,2136,0,0,0,0,0
1445,cs1811,20171204,2136,2136,0,0,0,2136,2136,0,0,0,0,0
1446,cs1811,20171205,2136,2136,2206,2206,2206,2206,2206,70,70,2,44120,2
1447,cs1811,20171206,2206,2206,0,0,0,2206,2206,0,0,0,0,2
1448,cs1811,20171207,2206,2206,0,0,0,2189,2189,-17,-17,0,0,2
1449,cs1811,20171208,2189,2189,0,0,0,2178,2178,-11,-11,0,0,2
1450,cs1811,20171211,2178,2178,2100,2100,2100,2100,2100,-78,-78,2,42000,4
1451,cs1811,20171212,2100,2100,0,0,0,2101,2101,1,1,0,0,4
1452,cs1811,20171213,2101,2101,0,0,0,2107,2107,6,6,0,0,4
1453,cs1811,20171214,2107,2107,0,0,0,2124,2124,17,17,0,0,4
1454,cs1811,20171215,2124,2124,0,0,0,2120,2120,-4,-4,0,0,4
1455,cs1811,20171218,2120,2120,0,0,0,2144,2144,24,24,0,0,4
1456,cs1811,20171219,2144,2144,0,0,0,2144,2144,0,0,0,0,4
1457,cs1811,20171220,2144,2144,0,0,0,2144,2144,0,0,0,0,4
1458,cs1811,20171221,2144,2144,0,0,0,2146,2146,2,2,0,0,4
1459,cs1811,20171222,2146,2146,0,0,0,2141,2141,-5,-5,0,0,4
1460,cs1811,20171225,2141,2141,0,0,0,2141,2141,0,0,0,0,4
1461,cs1811,20171226,2141,2141,0,0,0,2141,2141,0,0,0,0,4
1462,cs1811,20171227,2141,2141,0,0,0,2141,2141,0,0,0,0,4
1463,cs1811,20171228,2141,2141,0,0,0,2141,2141,0,0,0,0,4
1464,cs1811,20171229,2141,2141,0,0,0,2141,2141,0,0,0,0,4
